date,district,total_active_cases_till_yesterday,new_cases_today,discharged_cases_today,deaths_today,total_active_cases_including_today,total_indegenous_cases_till_yesterday,indegenous_cases_today,total_imported_cases_till_yesterday,imported_cases_today,total_cases_till_today,total_cases_discharged,total_deaths
23-07-2020,ariyalur,134,48,24,0,158,695,48,16,0,759,598,3
23-07-2020,chengalpattu,2542,375,245,4,2668,10508,375,5,0,10888,8006,214
23-07-2020,chennai,13947,1336,1703,11,13569,89542,1336,22,0,90900,75384,1947
23-07-2020,coimbatore,1236,238,198,6,1270,2501,238,38,0,2777,1479,28
23-07-2020,cuddalore,517,79,40,3,553,1828,76,163,3,2070,1496,21
23-07-2020,dharmapuri,244,19,6,0,257,347,14,139,5,505,246,2
23-07-2020,dindigul,898,107,68,6,931,1762,107,61,0,1930,971,28
23-07-2020,erode,120,20,5,0,135,503,19,16,1,539,396,8
23-07-2020,kallakurichi,670,134,72,0,732,2121,132,396,2,2651,1903,16
23-07-2020,kancheepuram,2554,330,231,5,2648,5677,330,3,0,6010,3282,80
23-07-2020,kanyakumari,1725,137,0,2,1860,2635,137,86,0,2858,976,22
23-07-2020,karur,105,27,4,0,128,252,27,44,0,323,186,9
23-07-2020,krishnagiri,243,31,18,1,255,455,27,65,4,551,283,13
23-07-2020,madurai,3020,274,450,8,2836,8581,274,129,0,8984,5965,183
23-07-2020,nagapattinam,194,4,3,0,195,419,3,61,1,484,288,1
23-07-2020,namakkal,194,40,19,1,214,349,38,43,2,432,215,3
23-07-2020,nilgiris,247,59,92,0,214,522,59,6,0,587,371,2
23-07-2020,perambalur,58,7,9,1,55,246,7,2,0,255,197,3
23-07-2020,pudukottai,610,111,76,0,645,1163,109,25,2,1299,637,17
23-07-2020,ramanathapuram,768,100,105,0,763,2559,100,133,0,2792,1976,53
23-07-2020,ranipet,1284,214,37,1,1460,2739,214,48,0,3001,1520,21
23-07-2020,salem,846,47,177,1,715,2224,42,338,5,2609,1874,20
23-07-2020,sivagangai,888,64,30,1,921,1701,64,59,0,1824,872,31
23-07-2020,tenkasi,891,68,0,4,955,1296,68,48,0,1412,450,7
23-07-2020,thanjavur,762,122,44,1,839,1401,122,19,0,1542,686,17
23-07-2020,theni,1307,188,71,3,1421,2873,188,26,0,3087,1625,41
23-07-2020,thirupathur,198,74,15,0,257,569,68,85,6,728,465,6
23-07-2020,thiruvallur,3738,416,254,8,3892,10203,416,8,0,10627,6547,188
23-07-2020,thiruvannamalai,1916,193,86,3,2020,4103,192,341,1,4637,2575,42
23-07-2020,thiruvarur,374,1,20,0,355,1023,1,37,0,1061,705,1
23-07-2020,thoothukudi,2232,415,175,0,2472,4034,415,207,0,4656,2158,26
23-07-2020,tirunelveli,1080,246,5,3,1318,2577,246,396,0,3219,1886,15
23-07-2020,tiruppur,277,33,15,1,294,559,33,8,0,600,300,6
23-07-2020,trichy,1307,190,146,6,1345,2673,190,9,0,2872,1477,50
23-07-2020,vellore,1439,117,243,3,1310,4321,116,34,1,4472,3123,39
23-07-2020,villupuram,710,112,70,2,750,2374,112,127,0,2613,1832,31
23-07-2020,virudhunagar,2072,480,312,3,2237,4184,480,103,0,4767,2493,37
23-07-2020,airport surveillance (international),307,9,99,0,217,0,0,742,9,751,533,1
23-07-2020,airport surveillance (domestic),97,7,41,0,63,0,0,461,7,468,405,0
23-07-2020,railway surveillance,14,0,2,0,12,0,0,424,0,424,412,0
24-07-2020,ariyalur,158,37,34,1,160,743,37,16,0,796,632,4
24-07-2020,chengalpattu,2669,419,218,4,2866,10884,419,5,0,11308,8224,218
24-07-2020,chennai,13576,1299,1110,22,13743,90885,1299,22,0,92206,76494,1969
24-07-2020,coimbatore,1270,189,180,4,1275,2739,189,38,0,2966,1659,32
24-07-2020,cuddalore,554,91,36,0,609,1905,91,166,0,2162,1532,21
24-07-2020,dharmapuri,257,36,7,0,286,361,29,144,7,541,253,2
24-07-2020,dindigul,933,80,479,3,531,1871,80,61,0,2012,1450,31
24-07-2020,erode,135,25,20,0,140,522,24,17,1,564,416,8
24-07-2020,kallakurichi,735,179,100,0,814,2256,179,398,0,2833,2003,16
24-07-2020,kancheepuram,2650,349,609,4,2386,6009,349,3,0,6361,3891,84
24-07-2020,kanyakumari,1860,266,347,5,1774,2772,266,86,0,3124,1323,27
24-07-2020,karur,128,5,3,0,130,279,5,44,0,328,189,9
24-07-2020,krishnagiri,255,82,31,1,305,482,72,69,10,633,314,14
24-07-2020,madurai,2828,326,483,10,2661,8847,326,129,0,9302,6448,193
24-07-2020,nagapattinam,188,46,13,1,220,415,45,62,1,523,301,2
24-07-2020,namakkal,213,28,8,1,232,386,27,45,1,459,223,4
24-07-2020,nilgiris,214,34,51,0,197,581,34,6,0,621,422,2
24-07-2020,perambalur,55,16,7,0,64,253,16,2,0,271,204,3
24-07-2020,pudukottai,645,95,136,1,603,1272,95,27,0,1394,773,18
24-07-2020,ramanathapuram,764,72,41,0,795,2660,72,133,0,2865,2017,53
24-07-2020,ranipet,1460,222,0,3,1679,2953,222,48,0,3223,1520,24
24-07-2020,salem,716,122,64,1,773,2267,121,343,1,2732,1938,21
24-07-2020,sivagangai,921,82,110,1,892,1765,82,59,0,1906,982,32
24-07-2020,tenkasi,956,93,0,2,1047,1365,93,48,0,1506,450,9
24-07-2020,thanjavur,841,186,250,0,777,1525,186,19,0,1730,936,17
24-07-2020,theni,1421,234,69,2,1584,3061,234,26,0,3321,1694,43
24-07-2020,thirupathur,251,56,18,1,288,631,55,91,1,778,483,7
24-07-2020,thiruvallur,3895,378,144,5,4124,10622,378,8,0,11008,6691,193
24-07-2020,thiruvannamalai,2030,134,315,2,1847,4305,134,342,0,4781,2890,44
24-07-2020,thiruvarur,354,96,6,0,444,1023,96,37,0,1156,711,1
24-07-2020,thoothukudi,2474,313,432,1,2354,4451,308,207,5,4971,2590,27
24-07-2020,tirunelveli,1315,171,23,4,1459,2820,170,396,1,3387,1909,19
24-07-2020,tiruppur,293,18,25,1,285,591,18,8,0,617,325,7
24-07-2020,trichy,1345,217,286,1,1275,2863,217,9,0,3089,1763,51
24-07-2020,vellore,1310,174,229,1,1254,4437,174,35,0,4646,3352,40
24-07-2020,villupuram,739,164,153,0,750,2475,164,127,0,2766,1985,31
24-07-2020,virudhunagar,2239,424,454,6,2203,4666,423,103,1,5193,2947,43
24-07-2020,airport surveillance (international),217,18,10,0,225,0,0,751,18,769,543,1
24-07-2020,airport surveillance (domestic),63,9,3,0,69,0,0,468,9,477,408,0
24-07-2020,railway surveillance,12,0,0,0,12,0,0,424,0,424,412,0
25-07-2020,ariyalur,160,4,29,0,135,780,4,16,0,800,661,4
25-07-2020,chengalpattu,2873,449,563,4,2755,11310,449,5,0,11764,8787,222
25-07-2020,chennai,13745,1329,1131,20,13923,92186,1329,22,0,93537,77625,1989
25-07-2020,coimbatore,1276,270,167,6,1373,2929,270,38,0,3237,1826,38
25-07-2020,cuddalore,608,89,38,0,659,1995,89,166,0,2250,1570,21
25-07-2020,dharmapuri,285,30,25,0,290,389,28,151,2,570,278,2
25-07-2020,dindigul,534,100,153,3,478,1954,99,61,1,2115,1603,34
25-07-2020,erode,140,22,17,0,145,546,18,18,4,586,433,8
25-07-2020,kallakurichi,815,104,39,3,877,2436,101,398,3,2938,2042,19
25-07-2020,kancheepuram,2379,442,382,2,2437,6351,442,3,0,6796,4273,86
25-07-2020,kanyakumari,1774,269,397,2,1644,3038,269,86,0,3393,1720,29
25-07-2020,karur,127,27,8,0,146,281,27,44,0,352,197,9
25-07-2020,krishnagiri,305,31,14,0,322,554,26,79,5,664,328,14
25-07-2020,madurai,2653,301,946,9,1999,9165,301,129,0,9595,7394,202
25-07-2020,nagapattinam,220,10,1,0,229,460,10,63,0,533,302,2
25-07-2020,namakkal,232,51,11,0,272,413,50,46,1,510,234,4
25-07-2020,nilgiris,197,40,47,0,190,615,40,6,0,661,469,2
25-07-2020,perambalur,64,25,5,0,84,269,25,2,0,296,209,3
25-07-2020,pudukottai,603,110,124,2,587,1367,110,27,0,1504,897,20
25-07-2020,ramanathapuram,795,86,12,2,867,2732,86,133,0,2951,2029,55
25-07-2020,ranipet,1679,244,95,0,1828,3175,243,48,1,3467,1615,24
25-07-2020,salem,774,112,107,1,778,2389,108,344,4,2845,2045,22
25-07-2020,sivagangai,893,84,177,1,799,1848,83,59,1,1991,1159,33
25-07-2020,tenkasi,1049,99,387,1,760,1460,99,48,0,1607,837,10
25-07-2020,thanjavur,777,162,7,0,932,1711,162,19,0,1892,943,17
25-07-2020,theni,1584,235,246,3,1570,3295,229,26,6,3556,1940,46
25-07-2020,thirupathur,288,86,24,1,349,686,76,92,10,864,507,8
25-07-2020,thiruvallur,4126,385,682,6,3823,11002,385,8,0,11395,7373,199
25-07-2020,thiruvannamalai,1847,152,322,4,1673,4439,151,342,1,4933,3212,48
25-07-2020,thiruvarur,444,100,40,0,504,1119,100,37,0,1256,751,1
25-07-2020,thoothukudi,2357,317,307,1,2366,4762,316,212,1,5291,2897,28
25-07-2020,tirunelveli,1455,212,207,2,1458,2986,210,397,2,3595,2116,21
25-07-2020,tiruppur,285,51,30,0,306,609,51,8,0,668,355,7
25-07-2020,trichy,1276,199,333,6,1136,3081,199,9,0,3289,2096,57
25-07-2020,vellore,1250,212,330,0,1132,4607,212,35,0,4854,3682,40
25-07-2020,villupuram,750,157,115,1,791,2639,153,127,4,2923,2100,32
25-07-2020,virudhunagar,2207,376,217,9,2357,5093,376,104,0,5573,3164,52
25-07-2020,airport surveillance (international),225,11,18,0,218,0,0,769,11,780,561,1
25-07-2020,airport surveillance (domestic),69,5,5,0,69,0,0,477,5,482,413,0
25-07-2020,railway surveillance,12,0,0,0,12,0,0,424,0,424,412,0
26-07-2020,ariyalur,135,27,33,0,129,784,27,16,0,827,694,4
26-07-2020,chengalpattu,2756,501,111,5,3141,11760,501,5,0,12266,8898,227
26-07-2020,chennai,13930,1155,1315,26,13744,93518,1155,22,0,94695,78940,2011
26-07-2020,coimbatore,1375,220,103,1,1491,3201,220,38,0,3459,1929,39
26-07-2020,cuddalore,659,165,25,0,799,2084,163,166,2,2415,1595,21
26-07-2020,dharmapuri,289,131,23,1,396,416,118,153,13,700,301,3
26-07-2020,dindigul,477,203,80,0,600,2053,203,62,0,2318,1683,35
26-07-2020,erode,143,34,10,0,167,562,34,22,0,618,443,8
26-07-2020,kallakurichi,879,125,69,0,935,2539,123,401,2,3065,2111,19
26-07-2020,kancheepuram,2439,363,159,3,2640,6795,363,3,0,7161,4432,89
26-07-2020,kanyakumari,1646,215,77,3,1781,3309,212,86,3,3610,1797,32
26-07-2020,karur,146,12,0,0,158,308,12,44,0,364,197,9
26-07-2020,krishnagiri,323,51,9,0,365,581,47,84,4,716,337,14
26-07-2020,madurai,2000,209,249,8,1952,9467,209,129,0,9805,7643,210
26-07-2020,nagapattinam,225,36,12,1,248,466,35,63,1,565,314,3
26-07-2020,namakkal,273,9,10,1,271,464,9,47,0,520,244,5
26-07-2020,nilgiris,190,31,11,0,210,655,25,6,6,692,480,2
26-07-2020,perambalur,84,26,8,0,102,294,26,2,0,322,217,3
26-07-2020,pudukottai,587,113,34,1,665,1477,113,27,0,1617,931,21
26-07-2020,ramanathapuram,867,89,159,2,795,2818,89,133,0,3040,2188,57
26-07-2020,ranipet,1827,367,189,3,2002,3418,367,49,0,3834,1804,28
26-07-2020,salem,772,162,39,1,894,2491,158,348,4,3001,2084,23
26-07-2020,sivagangai,799,88,256,0,631,1931,88,60,0,2079,1415,33
26-07-2020,tenkasi,762,73,32,2,801,1561,73,48,0,1682,869,12
26-07-2020,thanjavur,932,153,121,1,963,1873,153,19,0,2045,1064,18
26-07-2020,theni,1570,217,44,2,1741,3524,216,32,1,3773,1984,48
26-07-2020,thirupathur,348,44,21,1,370,761,44,102,0,907,528,9
26-07-2020,thiruvallur,3820,480,524,5,3771,11388,480,8,0,11876,7897,208
26-07-2020,thiruvannamalai,1673,176,681,3,1165,4590,176,343,0,5109,3893,51
26-07-2020,thiruvarur,504,93,27,0,570,1219,93,37,0,1349,778,1
26-07-2020,thoothukudi,2369,248,302,1,2314,5081,248,213,0,5542,3199,29
26-07-2020,tirunelveli,1450,186,231,4,1401,3188,186,399,0,3773,2347,25
26-07-2020,tiruppur,307,32,25,0,314,660,32,8,0,700,380,6
26-07-2020,trichy,1136,131,65,1,1201,3280,131,9,0,3420,2161,58
26-07-2020,vellore,1133,196,154,4,1171,4819,196,35,0,5050,3836,43
26-07-2020,villupuram,791,208,123,0,876,2792,201,131,7,3131,2223,32
26-07-2020,virudhunagar,2358,385,126,5,2612,5470,385,104,0,5959,3290,57
26-07-2020,airport surveillance (international),218,7,10,0,215,0,0,780,7,787,571,1
26-07-2020,airport surveillance (domestic),69,24,2,0,91,0,0,482,24,506,415,0
26-07-2020,railway surveillance,12,1,2,0,11,0,0,424,1,425,414,0
28-07-2020,ariyalur,152,17,2,0,167,860,16,16,1,893,722,4
28-07-2020,chengalpattu,3570,365,249,6,3680,12978,365,5,0,13348,9429,239
28-07-2020,chennai,12538,1107,769,24,12852,95309,1107,22,0,96438,81530,2056
28-07-2020,coimbatore,1606,273,296,2,1581,3741,273,38,0,4052,2427,44
28-07-2020,cuddalore,876,142,15,1,1002,2356,140,170,2,2668,1644,22
28-07-2020,dharmapuri,371,8,69,0,310,561,6,171,2,740,427,3
28-07-2020,dindigul,724,114,51,1,786,2390,113,62,1,2566,1743,37
28-07-2020,erode,184,11,3,0,192,623,11,22,0,656,456,8
28-07-2020,kallakurichi,1092,195,100,1,1186,2900,195,403,0,3498,2290,22
28-07-2020,kancheepuram,3158,223,311,6,3064,7791,223,3,0,8017,4853,100
28-07-2020,kanyakumari,1854,223,0,1,2076,3761,223,89,0,4073,1964,33
28-07-2020,karur,158,17,19,0,156,327,17,44,0,388,223,9
28-07-2020,krishnagiri,418,39,21,0,436,685,38,93,1,817,367,14
28-07-2020,madurai,2021,346,73,6,2288,9917,345,129,1,10392,7882,222
28-07-2020,nagapattinam,257,15,9,0,263,522,15,64,0,601,334,4
28-07-2020,namakkal,283,23,29,0,277,505,23,48,0,576,294,5
28-07-2020,nilgiris,208,2,50,0,160,711,2,13,0,726,564,2
28-07-2020,perambalur,113,25,8,0,130,341,25,2,0,368,235,3
28-07-2020,pudukottai,691,128,63,0,756,1689,127,27,1,1844,1067,21
28-07-2020,ramanathapuram,790,38,47,0,781,2961,38,133,0,3132,2292,59
28-07-2020,ranipet,1878,198,418,0,1658,4059,198,49,0,4306,2619,29
28-07-2020,salem,975,124,63,2,1034,2833,120,352,4,3309,2248,27
28-07-2020,sivagangai,502,59,71,3,487,2063,59,60,0,2182,1657,38
28-07-2020,tenkasi,910,50,68,0,892,1746,50,48,0,1844,937,15
28-07-2020,thanjavur,964,209,171,2,1000,2138,209,19,0,2366,1346,20
28-07-2020,theni,1963,283,213,2,2031,4021,282,33,1,4337,2255,51
28-07-2020,thirupathur,402,57,38,1,420,853,56,103,1,1013,582,11
28-07-2020,thiruvallur,3998,486,303,8,4173,12312,486,8,0,12806,8411,222
28-07-2020,thiruvannamalai,1432,268,16,2,1682,5028,266,348,2,5644,3909,53
28-07-2020,thiruvarur,577,132,88,4,617,1379,132,37,0,1548,926,5
28-07-2020,thoothukudi,2440,381,319,7,2495,5684,380,213,1,6278,3747,36
28-07-2020,tirunelveli,1438,387,87,0,1738,3558,385,405,2,4350,2587,25
28-07-2020,tiruppur,345,18,56,1,306,731,18,8,0,757,443,8
28-07-2020,trichy,1313,149,63,1,1398,3597,149,9,0,3755,2297,60
28-07-2020,vellore,1193,151,53,0,1291,5199,148,35,3,5385,4045,49
28-07-2020,villupuram,963,91,81,1,972,3132,91,138,0,3361,2356,33
28-07-2020,virudhunagar,2326,577,413,6,2484,6203,577,104,0,6884,4331,69
28-07-2020,airport surveillance (international),135,9,2,0,142,0,0,790,9,799,656,1
28-07-2020,airport surveillance (domestic),76,32,0,0,108,0,0,514,32,546,438,0
28-07-2020,railway surveillance,2,0,0,0,2,0,0,425,0,425,423,0
29-07-2020,ariyalur,167,4,12,1,158,876,4,17,0,897,734,5
29-07-2020,chengalpattu,3633,540,471,3,3699,13296,540,5,0,13841,9900,242
29-07-2020,chennai,12873,1117,1234,21,12735,96436,1117,22,0,97575,82764,2076
29-07-2020,coimbatore,1584,289,184,2,1687,4017,289,38,0,4344,2611,46
29-07-2020,cuddalore,1001,120,74,2,1045,2496,119,172,1,2788,1718,25
29-07-2020,dharmapuri,297,23,38,0,282,554,20,173,3,750,465,3
29-07-2020,dindigul,787,55,149,6,687,2504,55,63,0,2622,1892,43
29-07-2020,erode,193,23,15,1,200,635,23,22,0,680,471,9
29-07-2020,kallakurichi,1188,133,154,0,1167,3097,133,403,0,3633,2444,22
29-07-2020,kancheepuram,3095,373,267,5,3196,8046,373,3,0,8422,5120,106
29-07-2020,kanyakumari,2076,202,335,0,1943,3984,202,89,0,4275,2299,33
29-07-2020,karur,156,43,28,0,171,344,43,44,0,431,251,9
29-07-2020,krishnagiri,439,104,27,0,516,726,94,94,10,924,394,14
29-07-2020,madurai,2289,225,113,9,2392,10263,225,130,0,10618,7995,231
29-07-2020,nagapattinam,264,55,26,3,290,538,55,64,0,657,360,7
29-07-2020,namakkal,280,25,11,0,294,531,23,48,2,604,305,5
29-07-2020,nilgiris,158,11,17,0,152,711,11,13,0,735,581,2
29-07-2020,perambalur,130,27,1,0,156,366,27,2,0,395,236,3
29-07-2020,pudukottai,757,81,43,1,794,1817,80,28,1,1926,1110,22
29-07-2020,ramanathapuram,783,35,118,1,699,3001,35,133,0,3169,2410,60
29-07-2020,ranipet,1661,182,183,0,1660,4260,182,49,0,4491,2802,29
29-07-2020,salem,1030,123,65,0,1088,2949,122,356,1,3428,2313,27
29-07-2020,sivagangai,483,48,69,3,459,2118,48,60,0,2226,1726,41
29-07-2020,tenkasi,895,64,7,1,951,1799,64,48,0,1911,944,16
29-07-2020,thanjavur,1001,188,114,1,1074,2347,188,19,0,2554,1460,20
29-07-2020,theni,2031,131,215,2,1945,4303,131,34,0,4468,2470,53
29-07-2020,thirupathur,418,41,59,0,400,907,39,104,2,1052,641,11
29-07-2020,thiruvallur,4169,382,461,4,4086,12794,382,8,0,13184,8872,226
29-07-2020,thiruvannamalai,1684,177,93,2,1766,5296,177,350,0,5823,4002,55
29-07-2020,thiruvarur,618,112,26,1,703,1512,112,37,0,1661,952,6
29-07-2020,thoothukudi,2492,316,377,2,2429,6061,316,214,0,6591,4124,38
29-07-2020,tirunelveli,1735,382,158,2,1957,3940,379,407,3,4729,2745,27
29-07-2020,tiruppur,307,37,29,0,315,750,37,8,0,795,472,8
29-07-2020,trichy,1396,136,123,0,1409,3744,136,9,0,3889,2420,60
29-07-2020,vellore,1293,105,146,4,1248,5349,105,38,0,5492,4191,53
29-07-2020,villupuram,972,138,148,0,962,3223,137,138,1,3499,2504,33
29-07-2020,virudhunagar,2486,370,333,5,2518,6782,370,104,0,7256,4664,74
29-07-2020,airport surveillance (international),142,6,3,0,145,0,0,799,6,805,659,1
29-07-2020,airport surveillance (domestic),108,3,1,0,110,0,0,546,3,549,439,0
29-07-2020,railway surveillance,2,0,0,0,2,0,0,425,0,425,423,0
30-07-2020,ariyalur,158,17,0,1,174,880,17,17,0,914,734,6
30-07-2020,chengalpattu,3701,354,580,4,3471,13838,354,5,0,14197,10480,246
30-07-2020,chennai,12754,1175,1126,18,12785,97570,1175,22,0,98767,83890,2092
30-07-2020,coimbatore,1687,303,257,4,1729,4306,303,38,0,4647,2868,50
30-07-2020,cuddalore,1045,141,115,4,1067,2615,141,173,0,2929,1833,29
30-07-2020,dharmapuri,281,16,7,0,290,573,15,176,1,765,472,3
30-07-2020,dindigul,687,138,78,3,744,2559,138,63,0,2760,1970,46
30-07-2020,erode,198,12,33,0,177,656,12,22,0,690,504,9
30-07-2020,kallakurichi,1167,93,28,0,1232,3230,93,403,0,3726,2472,22
30-07-2020,kancheepuram,3202,175,263,3,3111,8426,175,3,0,8604,5383,110
30-07-2020,kanyakumari,1943,248,176,0,2015,4186,248,89,0,4523,2475,33
30-07-2020,karur,168,41,0,0,209,384,41,44,0,469,251,9
30-07-2020,krishnagiri,516,26,47,0,495,820,26,104,0,950,441,14
30-07-2020,madurai,2392,220,226,2,2384,10488,218,130,2,10838,8221,233
30-07-2020,nagapattinam,290,28,12,1,305,593,28,64,0,685,372,8
30-07-2020,namakkal,294,48,33,0,309,554,43,50,5,652,338,5
30-07-2020,nilgiris,152,33,24,0,161,722,33,13,0,768,605,2
30-07-2020,perambalur,156,27,21,0,162,393,27,2,0,422,257,3
30-07-2020,pudukottai,794,128,59,3,860,1897,128,29,0,2054,1169,25
30-07-2020,ramanathapuram,699,46,73,2,670,3036,46,133,0,3215,2483,62
30-07-2020,ranipet,1666,272,212,1,1725,4448,272,49,0,4769,3014,30
30-07-2020,salem,1088,70,103,3,1052,3071,69,357,1,3498,2416,30
30-07-2020,sivagangai,459,75,63,2,469,2166,75,60,0,2301,1789,43
30-07-2020,tenkasi,952,56,18,3,987,1864,56,48,0,1968,962,19
30-07-2020,thanjavur,1074,97,74,6,1091,2535,97,19,0,2651,1534,26
30-07-2020,theni,1945,261,162,4,2040,4434,257,34,4,4729,2632,57
30-07-2020,thirupathur,397,50,21,0,426,943,48,106,2,1099,662,11
30-07-2020,thiruvallur,4057,325,443,2,3937,13148,325,8,0,13481,9315,229
30-07-2020,thiruvannamalai,1766,187,0,2,1951,5473,185,350,2,6010,4002,57
30-07-2020,thiruvarur,703,4,91,3,613,1624,4,37,0,1665,1043,9
30-07-2020,thoothukudi,2430,220,370,5,2275,6378,220,214,0,6812,4494,43
30-07-2020,tirunelveli,1953,277,109,8,2113,4315,272,410,5,5002,2854,35
30-07-2020,tiruppur,315,32,29,2,316,787,32,8,0,827,501,10
30-07-2020,trichy,1413,118,11,0,1520,3884,118,9,0,4011,2431,60
30-07-2020,vellore,1249,184,174,4,1255,5455,183,38,1,5677,4365,57
30-07-2020,villupuram,962,95,136,2,919,3360,93,139,2,3594,2640,35
30-07-2020,virudhunagar,2520,244,105,5,2654,7154,244,104,0,7502,4769,79
30-07-2020,airport surveillance (international),145,2,10,0,137,0,0,805,2,807,669,1
30-07-2020,airport surveillance (domestic),110,26,6,0,130,0,0,549,26,575,445,0
30-07-2020,railway surveillance,2,0,0,0,2,0,0,425,0,425,423,0
31-07-2020,ariyalur,174,4,30,1,147,897,4,17,0,918,764,7
31-07-2020,chengalpattu,3474,334,649,2,3157,14195,334,5,0,14534,11129,248
31-07-2020,chennai,12799,1013,1026,21,12765,98759,1013,22,0,99794,84916,2113
31-07-2020,coimbatore,1734,169,161,4,1738,4614,169,38,0,4821,3029,54
31-07-2020,cuddalore,1068,158,29,2,1195,2757,156,173,2,3088,1862,31
31-07-2020,dharmapuri,283,3,7,1,278,581,3,177,0,761,479,4
31-07-2020,dindigul,744,52,177,4,615,2697,52,63,0,2812,2147,50
31-07-2020,erode,178,33,19,0,192,669,33,22,0,724,523,9
31-07-2020,kallakurichi,1224,27,199,1,1051,3315,27,403,0,3745,2671,23
31-07-2020,kancheepuram,3116,485,267,1,3333,8606,485,3,0,9094,5650,111
31-07-2020,kanyakumari,2016,169,175,6,2004,4435,169,89,0,4693,2650,39
31-07-2020,karur,205,31,8,0,228,421,31,44,0,496,259,9
31-07-2020,krishnagiri,498,15,38,0,475,849,14,104,1,968,479,14
31-07-2020,madurai,2382,173,202,4,2349,10704,173,132,0,11009,8423,237
31-07-2020,nagapattinam,305,50,16,0,339,621,49,64,1,735,388,8
31-07-2020,namakkal,304,47,16,1,334,592,46,55,1,694,354,6
31-07-2020,nilgiris,157,2,27,0,132,751,2,13,0,766,632,2
31-07-2020,perambalur,162,55,0,0,217,420,55,2,0,477,257,3
31-07-2020,pudukottai,861,112,110,0,863,2026,111,29,1,2167,1279,25
31-07-2020,ramanathapuram,670,40,74,2,634,3082,40,133,0,3255,2557,64
31-07-2020,ranipet,1727,359,237,2,1847,4722,359,49,0,5130,3251,32
31-07-2020,salem,1053,123,78,1,1097,3141,113,358,10,3622,2494,31
31-07-2020,sivagangai,467,66,83,0,450,2239,66,60,0,2365,1872,43
31-07-2020,tenkasi,992,59,24,0,1027,1925,59,48,0,2032,986,19
31-07-2020,thanjavur,1091,97,72,2,1114,2632,97,19,0,2748,1606,28
31-07-2020,theni,2040,299,154,5,2180,4691,299,38,0,5028,2786,62
31-07-2020,thirupathur,426,47,37,5,431,991,47,108,0,1146,699,16
31-07-2020,thiruvallur,3919,373,663,10,3619,13455,373,8,0,13836,9978,239
31-07-2020,thiruvannamalai,1952,41,66,5,1922,5659,41,352,0,6052,4068,62
31-07-2020,thiruvarur,613,28,79,0,562,1628,28,37,0,1693,1122,9
31-07-2020,thoothukudi,2286,284,352,4,2214,6609,282,214,2,7107,4846,47
31-07-2020,tirunelveli,2101,222,94,3,2226,4575,222,415,0,5212,2948,38
31-07-2020,tiruppur,311,51,54,0,308,814,51,8,0,873,555,10
31-07-2020,trichy,1522,133,104,0,1551,4004,133,9,0,4146,2535,60
31-07-2020,vellore,1259,194,99,4,1350,5642,191,39,3,5875,4464,61
31-07-2020,villupuram,920,169,155,0,934,3454,166,141,3,3764,2795,35
31-07-2020,virudhunagar,2660,357,188,6,2823,7404,357,104,0,7865,4957,85
31-07-2020,airport surveillance (international),137,6,6,0,137,0,0,807,6,813,675,1
31-07-2020,airport surveillance (domestic),130,1,2,0,129,0,0,575,1,576,447,0
31-07-2020,railway surveillance,2,0,1,0,1,0,0,425,0,425,424,0
01-08-2020,ariyalur,147,32,8,0,171,901,32,17,0,950,772,7
01-08-2020,chengalpattu,3175,314,435,5,3049,14547,314,5,0,14866,11564,253
01-08-2020,chennai,12774,1074,1385,27,12436,99781,1074,22,0,100877,86301,2140
01-08-2020,coimbatore,1738,238,216,10,1750,4783,238,38,0,5059,3245,64
01-08-2020,cuddalore,1196,182,51,3,1324,2914,179,175,3,3271,1913,34
01-08-2020,dharmapuri,278,9,23,0,264,584,9,177,0,770,502,4
01-08-2020,dindigul,615,81,44,3,649,2749,81,63,0,2893,2191,53
01-08-2020,erode,192,8,28,0,172,702,8,22,0,732,551,9
01-08-2020,kallakurichi,1053,60,72,2,1039,3344,60,403,0,3807,2743,25
01-08-2020,kancheepuram,3255,368,268,1,3354,9013,368,3,0,9384,5918,112
01-08-2020,kanyakumari,2004,198,188,6,2008,4604,198,89,0,4891,2838,45
01-08-2020,karur,228,36,17,0,247,452,36,44,0,532,276,9
01-08-2020,krishnagiri,475,74,69,0,480,863,67,105,7,1042,548,14
01-08-2020,madurai,2349,166,208,10,2297,10877,162,132,4,11175,8631,247
01-08-2020,nagapattinam,339,37,56,0,320,670,37,65,0,772,444,8
01-08-2020,namakkal,336,32,36,0,332,640,31,56,1,728,390,6
01-08-2020,nilgiris,132,36,18,0,150,753,34,13,2,802,650,2
01-08-2020,perambalur,217,20,44,0,193,475,20,2,0,497,301,3
01-08-2020,pudukottai,863,91,96,0,858,2137,91,30,0,2258,1375,25
01-08-2020,ramanathapuram,635,37,86,2,584,3123,37,133,0,3293,2643,66
01-08-2020,ranipet,1901,116,241,1,1775,5135,116,49,0,5300,3492,33
01-08-2020,salem,1094,51,51,2,1092,3251,50,368,1,3670,2545,33
01-08-2020,sivagangai,450,61,85,0,426,2305,61,60,0,2426,1957,43
01-08-2020,tenkasi,1027,178,187,4,1014,1984,178,48,0,2210,1173,23
01-08-2020,thanjavur,1114,167,288,0,993,2729,167,19,0,2915,1894,28
01-08-2020,theni,2180,327,299,1,2207,4990,327,38,0,5355,3085,63
01-08-2020,thirupathur,430,22,26,0,426,1037,21,108,1,1167,725,16
01-08-2020,thiruvallur,3606,305,392,7,3512,13815,305,8,0,14128,10370,246
01-08-2020,thiruvannamalai,1932,242,85,0,2089,5710,240,352,2,6304,4153,62
01-08-2020,thiruvarur,562,45,59,0,548,1656,45,37,0,1738,1181,9
01-08-2020,thoothukudi,2214,243,337,1,2119,6891,242,216,1,7350,5183,48
01-08-2020,tirunelveli,2226,181,120,6,2281,4797,181,415,0,5393,3068,44
01-08-2020,tiruppur,308,36,26,1,317,865,36,8,0,909,581,11
01-08-2020,trichy,1551,136,116,0,1571,4137,136,9,0,4282,2651,60
01-08-2020,vellore,1347,197,153,2,1389,5830,197,42,0,6069,4617,63
01-08-2020,villupuram,935,158,107,0,986,3621,158,144,0,3923,2902,35
01-08-2020,virudhunagar,2823,286,1084,5,2020,7761,286,104,0,8151,6041,90
01-08-2020,airport surveillance (international),137,8,1,0,144,0,0,813,8,821,676,1
01-08-2020,airport surveillance (domestic),129,27,5,0,151,0,0,576,27,603,452,0
01-08-2020,railway surveillance,1,0,0,0,1,0,0,425,0,425,424,0
02-08-2020,ariyalur,171,73,38,0,206,933,73,17,0,1023,810,7
02-08-2020,chengalpattu,3049,446,674,4,2817,14861,446,5,0,15312,12238,257
02-08-2020,chennai,12445,1065,1303,17,12190,100864,1065,22,0,101951,87604,2157
02-08-2020,coimbatore,1754,167,224,7,1690,5025,167,38,0,5230,3469,71
02-08-2020,cuddalore,1324,144,51,0,1417,3093,140,178,4,3415,1964,34
02-08-2020,dharmapuri,264,17,33,2,246,593,11,177,6,787,535,6
02-08-2020,dindigul,649,97,179,2,565,2830,94,63,3,2990,2370,55
02-08-2020,erode,172,22,32,0,162,710,21,22,1,754,583,9
02-08-2020,kallakurichi,1039,33,85,1,986,3404,33,403,0,3840,2828,26
02-08-2020,kancheepuram,3362,393,311,5,3439,9389,393,3,0,9785,6229,117
02-08-2020,kanyakumari,2009,200,162,4,2043,4803,200,89,0,5092,3000,49
02-08-2020,karur,247,28,15,0,260,488,28,44,0,560,291,9
02-08-2020,krishnagiri,481,59,30,0,510,931,52,112,7,1102,578,14
02-08-2020,madurai,2296,178,114,6,2354,11038,178,136,0,11352,8745,253
02-08-2020,nagapattinam,321,16,0,0,337,708,15,65,1,789,444,8
02-08-2020,namakkal,333,28,32,1,328,672,25,57,3,757,422,7
02-08-2020,nilgiris,146,14,22,0,138,783,14,15,0,812,672,2
02-08-2020,perambalur,193,27,12,1,207,495,27,2,0,524,313,4
02-08-2020,pudukottai,858,125,109,0,874,2228,124,30,1,2383,1484,25
02-08-2020,ramanathapuram,584,45,101,0,528,3160,45,133,0,3338,2744,66
02-08-2020,ranipet,1777,167,259,3,1682,5253,167,49,0,5469,3751,36
02-08-2020,salem,1092,134,60,0,1166,3301,130,369,4,3804,2605,33
02-08-2020,sivagangai,426,45,80,3,388,2366,45,60,0,2471,2037,46
02-08-2020,tenkasi,1024,95,18,4,1097,2172,95,48,0,2315,1191,27
02-08-2020,thanjavur,995,91,112,1,973,2898,91,19,0,3008,2006,29
02-08-2020,theni,2207,309,95,0,2421,5317,309,38,0,5664,3180,63
02-08-2020,thirupathur,423,70,20,3,470,1055,70,109,0,1234,745,19
02-08-2020,thiruvallur,3497,317,376,8,3430,14105,317,8,0,14430,10746,254
02-08-2020,thiruvannamalai,2089,142,49,3,2179,5950,142,354,0,6446,4202,65
02-08-2020,thiruvarur,546,45,124,0,467,1699,45,37,0,1781,1305,9
02-08-2020,thoothukudi,2126,271,241,6,2150,7140,270,217,1,7628,5424,54
02-08-2020,tirunelveli,2259,201,10,6,2444,4956,201,415,0,5572,3078,50
02-08-2020,tiruppur,317,40,16,2,339,901,40,8,0,949,597,13
02-08-2020,trichy,1569,136,131,0,1574,4271,136,9,0,4416,2782,60
02-08-2020,vellore,1389,173,231,2,1329,6027,169,42,4,6242,4848,65
02-08-2020,villupuram,986,99,105,1,979,3779,96,144,3,4022,3007,36
02-08-2020,virudhunagar,2023,337,57,6,2297,8050,337,104,0,8491,6098,96
02-08-2020,airport surveillance (international),144,15,2,0,157,0,0,821,15,836,678,1
02-08-2020,airport surveillance (domestic),151,11,4,0,158,0,0,603,11,614,456,0
02-08-2020,railway surveillance,1,0,0,0,1,0,0,425,0,425,424,0
03-08-2020,ariyalur,208,20,39,0,189,1008,20,17,0,1045,849,7
03-08-2020,chengalpattu,2830,331,438,4,2719,15321,331,5,0,15657,12676,262
03-08-2020,chennai,12204,1021,1222,20,11983,101942,1021,22,0,102985,88826,2176
03-08-2020,coimbatore,1691,227,216,7,1695,5193,227,38,0,5458,3685,78
03-08-2020,cuddalore,1417,167,64,0,1520,3233,167,182,0,3582,2028,34
03-08-2020,dharmapuri,244,4,24,0,224,602,4,183,0,789,559,6
03-08-2020,dindigul,566,75,111,1,529,2925,75,66,0,3066,2481,56
03-08-2020,erode,162,13,14,1,160,731,13,23,0,767,597,10
03-08-2020,kallakurichi,986,66,75,0,977,3437,66,403,0,3906,2903,26
03-08-2020,kancheepuram,3427,322,528,5,3216,9770,322,3,0,10095,6757,122
03-08-2020,kanyakumari,2043,215,180,3,2075,5003,215,89,0,5307,3180,52
03-08-2020,karur,260,19,6,1,272,516,19,44,0,579,297,10
03-08-2020,krishnagiri,511,67,39,0,539,984,63,119,4,1170,617,14
03-08-2020,madurai,2351,106,42,4,2411,11213,106,136,0,11455,8787,257
03-08-2020,nagapattinam,333,32,9,1,355,719,32,66,0,817,453,9
03-08-2020,namakkal,329,43,21,0,351,698,38,60,5,801,443,7
03-08-2020,nilgiris,138,37,28,0,147,797,37,15,0,849,700,2
03-08-2020,perambalur,207,19,10,2,214,522,19,2,0,543,323,6
03-08-2020,pudukottai,876,86,113,4,845,2354,86,31,0,2471,1597,29
03-08-2020,ramanathapuram,528,62,70,2,518,3205,62,133,0,3400,2814,68
03-08-2020,ranipet,1682,382,194,4,1866,5421,382,49,0,5852,3945,41
03-08-2020,salem,1164,66,81,3,1146,3429,65,373,1,3868,2686,36
03-08-2020,sivagangai,387,64,41,5,405,2410,64,60,0,2534,2078,51
03-08-2020,tenkasi,1104,75,45,5,1129,2274,75,48,0,2397,1236,32
03-08-2020,thanjavur,973,146,141,2,976,2989,146,19,0,3154,2147,31
03-08-2020,theni,2421,305,143,5,2578,5626,303,38,2,5969,3323,68
03-08-2020,thirupathur,470,44,47,1,466,1125,44,109,0,1278,792,20
03-08-2020,thiruvallur,3418,332,337,4,3409,14410,332,8,0,14750,11083,258
03-08-2020,thiruvannamalai,2181,212,67,4,2322,6094,210,354,2,6660,4269,69
03-08-2020,thiruvarur,467,18,93,0,392,1744,18,37,0,1799,1398,9
03-08-2020,thoothukudi,2153,215,227,4,2137,7413,214,218,1,7846,5651,58
03-08-2020,tirunelveli,2428,85,211,5,2297,5141,85,415,0,5641,3289,55
03-08-2020,tiruppur,339,45,20,1,363,941,45,8,0,994,617,14
03-08-2020,trichy,1574,101,162,0,1513,4407,101,9,0,4517,2944,60
03-08-2020,vellore,1330,134,246,1,1217,6196,132,46,2,6376,5094,65
03-08-2020,villupuram,979,90,250,1,818,3875,90,147,0,4112,3257,37
03-08-2020,virudhunagar,2301,348,238,9,2402,8391,348,104,0,8843,6336,105
03-08-2020,airport surveillance (international),157,6,7,0,156,0,0,836,6,842,685,1
03-08-2020,airport surveillance (domestic),158,9,1,0,166,0,0,614,9,623,457,0
03-08-2020,railway surveillance,1,0,0,0,1,0,0,425,0,425,424,0
04-08-2020,ariyalur,189,49,21,0,217,1028,48,17,1,1094,870,7
04-08-2020,chengalpattu,2732,245,386,8,2583,15667,245,5,0,15917,13062,272
04-08-2020,chennai,11999,1023,1143,23,11856,102982,1023,22,0,104027,89969,2202
04-08-2020,coimbatore,1697,228,233,7,1685,5422,228,38,0,5688,3918,85
04-08-2020,cuddalore,1520,264,61,3,1720,3400,261,182,3,3846,2089,37
04-08-2020,dharmapuri,224,2,124,1,101,606,1,183,1,791,683,7
04-08-2020,dindigul,530,64,100,1,493,3001,64,66,0,3131,2581,57
04-08-2020,erode,162,20,10,0,172,746,20,23,0,789,607,10
04-08-2020,kallakurichi,977,149,109,0,1017,3503,149,403,0,4055,3012,26
04-08-2020,kancheepuram,3204,220,559,6,2859,10080,220,3,0,10303,7316,128
04-08-2020,kanyakumari,2075,128,192,9,2002,5218,122,89,6,5435,3372,61
04-08-2020,karur,270,25,31,0,264,533,25,44,0,602,328,10
04-08-2020,krishnagiri,538,25,43,0,520,1048,22,123,3,1196,660,16
04-08-2020,madurai,2403,40,197,4,2242,11311,40,136,0,11487,8984,261
04-08-2020,nagapattinam,356,55,6,1,404,752,55,66,0,873,459,10
04-08-2020,namakkal,346,39,38,1,346,731,39,65,0,835,481,8
04-08-2020,nilgiris,147,14,22,0,139,834,14,15,0,863,722,2
04-08-2020,perambalur,214,4,37,0,181,541,4,2,0,547,360,6
04-08-2020,pudukottai,847,41,96,1,791,2442,41,31,0,2514,1693,30
04-08-2020,ramanathapuram,520,47,85,2,480,3269,47,133,0,3449,2899,70
04-08-2020,ranipet,1866,79,149,0,1796,5802,79,49,0,5930,4094,40
04-08-2020,salem,1147,62,69,3,1137,3495,62,374,0,3931,2755,39
04-08-2020,sivagangai,407,141,51,1,496,2476,141,60,0,2677,2129,52
04-08-2020,tenkasi,1130,45,386,4,785,2350,45,48,0,2443,1622,36
04-08-2020,thanjavur,972,93,200,1,864,3131,93,19,0,3243,2347,32
04-08-2020,theni,2578,292,175,4,2691,5929,292,40,0,6261,3498,72
04-08-2020,thirupathur,466,66,32,2,498,1169,66,109,0,1344,824,22
04-08-2020,thiruvallur,3404,358,319,6,3437,14730,358,8,0,15096,11402,257
04-08-2020,thiruvannamalai,2323,132,184,4,2267,6305,132,356,0,6793,4453,73
04-08-2020,thiruvarur,392,31,100,0,323,1762,31,37,0,1830,1498,9
04-08-2020,thoothukudi,2137,189,349,0,1977,7627,189,219,0,8035,6000,58
04-08-2020,tirunelveli,2298,155,149,6,2298,5227,155,415,0,5797,3438,61
04-08-2020,tiruppur,361,8,36,2,331,984,8,8,0,1000,653,16
04-08-2020,trichy,1516,83,162,2,1435,4511,83,9,0,4603,3106,62
04-08-2020,vellore,1207,160,131,2,1234,6318,159,48,1,6526,5225,67
04-08-2020,villupuram,818,50,51,1,816,3965,50,147,0,4162,3308,38
04-08-2020,virudhunagar,2403,424,447,3,2377,8741,424,104,0,9269,6783,109
04-08-2020,airport surveillance (international),156,2,5,0,153,0,0,842,2,844,690,1
04-08-2020,airport surveillance (domestic),166,10,13,0,163,0,0,623,10,633,470,0
04-08-2020,railway surveillance,1,1,0,0,2,0,0,425,1,426,424,0
05-08-2020,ariyalur,217,36,31,2,220,1076,36,18,0,1130,901,9
05-08-2020,chengalpattu,2663,487,460,7,2683,15992,487,5,0,16484,13522,279
05-08-2020,chennai,11789,1044,997,25,11811,103938,1044,22,0,105004,90966,2227
05-08-2020,coimbatore,1690,112,226,5,1571,5655,112,38,0,5805,4144,90
05-08-2020,cuddalore,1720,170,79,9,1802,3661,168,185,2,4016,2168,46
05-08-2020,dharmapuri,101,17,31,0,87,607,16,184,1,808,714,7
05-08-2020,dindigul,493,71,22,2,540,3065,68,66,3,3202,2603,59
05-08-2020,erode,172,40,3,0,209,766,37,23,3,829,610,10
05-08-2020,kallakurichi,1007,18,109,1,915,3642,18,403,0,4063,3121,27
05-08-2020,kancheepuram,2869,342,359,6,2846,10310,342,3,0,10655,7675,134
05-08-2020,kanyakumari,1999,175,219,0,1955,5337,175,95,0,5607,3591,61
05-08-2020,karur,266,50,12,0,304,560,50,44,0,654,340,10
05-08-2020,krishnagiri,517,13,81,0,449,1067,11,126,2,1206,741,16
05-08-2020,madurai,2242,106,235,6,2107,11351,104,136,2,11593,9219,267
05-08-2020,nagapattinam,396,52,16,1,431,799,50,66,2,917,475,11
05-08-2020,namakkal,348,31,11,0,368,772,30,65,1,868,492,8
05-08-2020,nilgiris,137,36,9,0,164,846,36,15,0,897,731,2
05-08-2020,perambalur,182,20,32,0,170,546,20,2,0,568,392,6
05-08-2020,pudukottai,793,150,129,2,812,2485,150,31,0,2666,1822,32
05-08-2020,ramanathapuram,482,32,90,0,424,3318,32,133,0,3483,2989,70
05-08-2020,ranipet,1796,143,258,4,1677,5881,143,49,0,6073,4352,44
05-08-2020,salem,1135,159,126,2,1166,3555,159,374,0,4088,2881,41
05-08-2020,sivagangai,492,69,47,3,511,2613,69,60,0,2742,2176,55
05-08-2020,tenkasi,785,121,40,0,866,2395,121,48,0,2564,1662,36
05-08-2020,thanjavur,864,79,129,2,812,3224,79,19,0,3322,2476,34
05-08-2020,theni,2691,278,294,7,2668,6221,278,40,0,6539,3792,79
05-08-2020,thirupathur,498,12,49,2,459,1235,12,109,0,1356,873,24
05-08-2020,thiruvallur,3439,472,357,6,3548,15090,472,8,0,15570,11759,263
05-08-2020,thiruvannamalai,2267,112,228,3,2148,6437,112,356,0,6905,4681,76
05-08-2020,thiruvarur,323,21,55,2,287,1793,21,37,0,1851,1553,11
05-08-2020,thoothukudi,1979,173,311,1,1840,7818,173,219,0,8210,6311,59
05-08-2020,tirunelveli,2295,26,182,3,2136,5379,26,415,0,5820,3620,64
05-08-2020,tiruppur,328,27,22,1,332,989,26,8,1,1024,675,17
05-08-2020,trichy,1429,136,140,2,1423,4588,136,9,0,4733,3246,64
05-08-2020,vellore,1234,179,95,7,1311,6477,179,49,0,6705,5320,74
05-08-2020,villupuram,816,77,72,1,820,4015,76,147,1,4239,3380,39
05-08-2020,virudhunagar,2380,67,454,0,1993,9168,67,104,0,9339,7237,109
05-08-2020,airport surveillance (international),153,2,2,0,153,0,0,844,2,846,692,1
05-08-2020,airport surveillance (domestic),163,20,19,0,164,0,0,633,20,653,489,0
05-08-2020,railway surveillance,2,0,0,0,2,0,0,426,0,426,424,0
06-08-2020,ariyalur,220,24,25,1,218,1112,24,18,0,1154,926,10
06-08-2020,chengalpattu,2688,408,447,5,2644,16484,408,5,0,16897,13969,284
06-08-2020,chennai,11813,1091,1162,22,11720,104983,1091,22,0,106096,92128,2248
06-08-2020,coimbatore,1573,190,178,6,1579,5769,190,38,0,5997,4322,96
06-08-2020,cuddalore,1804,214,103,3,1912,3831,213,187,1,4232,2271,49
06-08-2020,dharmapuri,87,7,8,0,86,623,7,185,0,815,722,7
06-08-2020,dindigul,542,127,104,4,561,3135,127,69,0,3331,2707,63
06-08-2020,erode,206,62,26,3,239,800,59,26,3,888,636,13
06-08-2020,kallakurichi,908,75,153,3,827,3653,75,403,0,4131,3274,30
06-08-2020,kancheepuram,2849,336,309,4,2872,10654,336,3,0,10993,7984,137
06-08-2020,kanyakumari,1955,222,242,2,1933,5512,222,95,0,5829,3833,63
06-08-2020,karur,304,26,11,0,319,610,26,44,0,680,351,10
06-08-2020,krishnagiri,451,55,57,0,449,1080,54,128,1,1263,798,16
06-08-2020,madurai,2102,101,330,9,1864,11450,101,138,0,11689,9549,276
06-08-2020,nagapattinam,426,9,45,0,390,844,8,68,1,921,520,11
06-08-2020,namakkal,360,30,25,2,363,794,28,66,2,890,517,10
06-08-2020,nilgiris,164,22,25,1,160,882,22,15,0,919,756,3
06-08-2020,perambalur,170,4,29,3,142,566,4,2,0,572,421,9
06-08-2020,pudukottai,814,87,79,1,821,2637,87,31,0,2755,1901,33
06-08-2020,ramanathapuram,424,20,54,1,389,3350,20,133,0,3503,3043,71
06-08-2020,ranipet,1676,270,215,0,1731,6023,270,49,0,6342,4567,44
06-08-2020,salem,1168,161,218,2,1109,3716,161,374,0,4251,3099,43
06-08-2020,sivagangai,509,28,77,0,460,2680,28,60,0,2768,2253,55
06-08-2020,tenkasi,867,64,58,3,870,2517,64,48,0,2629,1720,39
06-08-2020,thanjavur,812,162,91,2,881,3303,162,19,0,3484,2567,36
06-08-2020,theni,2668,297,276,3,2686,6499,297,40,0,6836,4068,82
06-08-2020,thirupathur,459,80,49,1,489,1247,80,109,0,1436,922,25
06-08-2020,thiruvallur,3547,320,394,4,3469,15562,320,8,0,15890,12153,268
06-08-2020,thiruvannamalai,2147,153,301,4,1995,6549,153,356,0,7058,4982,81
06-08-2020,thiruvarur,287,23,128,1,181,1814,23,37,0,1874,1681,12
06-08-2020,thoothukudi,1841,239,246,2,1832,7992,237,219,2,8450,6557,61
06-08-2020,tirunelveli,2137,250,112,1,2274,5406,250,415,0,6071,3732,65
06-08-2020,tiruppur,333,34,37,1,329,1016,34,9,0,1059,712,18
06-08-2020,trichy,1427,97,248,3,1273,4728,97,9,0,4834,3494,67
06-08-2020,vellore,1311,192,120,7,1376,6656,189,49,3,6897,5440,81
06-08-2020,villupuram,821,76,93,1,803,4092,75,148,1,4316,3473,40
06-08-2020,virudhunagar,1995,100,179,5,1911,9237,100,104,0,9441,7416,114
06-08-2020,airport surveillance (international),153,6,3,0,156,0,0,846,6,852,695,1
06-08-2020,airport surveillance (domestic),164,22,15,0,171,0,0,653,22,675,504,0
06-08-2020,railway surveillance,2,0,0,0,2,0,0,426,0,426,424,0
07-08-2020,ariyalur,218,51,31,1,237,1136,51,18,0,1205,957,11
07-08-2020,chengalpattu,2655,319,337,8,2629,16903,319,5,0,17227,14306,292
07-08-2020,chennai,11749,984,1103,24,11606,106103,984,22,0,107109,93231,2272
07-08-2020,coimbatore,1581,228,224,5,1580,5961,228,38,0,6227,4546,101
07-08-2020,cuddalore,1913,212,123,3,1999,4045,211,188,1,4445,2394,52
07-08-2020,dharmapuri,85,16,16,0,85,629,14,185,2,830,738,7
07-08-2020,dindigul,561,134,117,0,578,3262,134,69,0,3465,2824,63
07-08-2020,erode,239,67,10,1,295,859,67,29,0,955,646,14
07-08-2020,kallakurichi,827,139,61,2,903,3728,139,403,0,4270,3335,32
07-08-2020,kancheepuram,2887,166,356,5,2692,11005,166,3,0,11174,8340,142
07-08-2020,kanyakumari,1932,187,298,5,1816,5733,187,95,0,6015,4131,68
07-08-2020,karur,319,26,48,1,296,636,26,44,0,706,399,11
07-08-2020,krishnagiri,450,46,52,4,440,1135,40,129,6,1310,850,20
07-08-2020,madurai,1863,109,184,2,1786,11550,109,138,0,11797,9733,278
07-08-2020,nagapattinam,390,78,30,0,438,852,77,69,1,999,550,11
07-08-2020,namakkal,363,34,49,0,348,822,34,68,0,924,566,10
07-08-2020,nilgiris,159,13,17,1,154,903,13,15,0,931,773,4
07-08-2020,perambalur,142,69,21,0,190,570,69,2,0,641,442,9
07-08-2020,pudukottai,821,173,54,3,937,2724,173,31,0,2928,1955,36
07-08-2020,ramanathapuram,389,43,38,1,393,3370,43,133,0,3546,3081,72
07-08-2020,ranipet,1733,253,354,1,1631,6295,253,49,0,6597,4921,45
07-08-2020,salem,1110,168,103,6,1169,3878,166,374,2,4420,3202,49
07-08-2020,sivagangai,460,64,62,1,461,2708,64,60,0,2832,2315,56
07-08-2020,tenkasi,872,117,108,4,877,2583,117,48,0,2748,1828,43
07-08-2020,thanjavur,881,217,67,3,1028,3465,217,19,0,3701,2634,39
07-08-2020,theni,2687,351,276,4,2758,6797,351,40,0,7188,4344,86
07-08-2020,thirupathur,485,66,54,1,496,1323,66,109,0,1498,976,26
07-08-2020,thiruvallur,3411,388,449,6,3344,15824,388,8,0,16220,12602,274
07-08-2020,thiruvannamalai,1997,252,620,6,1623,6704,248,356,4,7312,5602,87
07-08-2020,thiruvarur,182,44,27,0,199,1838,44,37,0,1919,1708,12
07-08-2020,thoothukudi,1835,195,240,6,1784,8232,192,221,3,8648,6797,67
07-08-2020,tirunelveli,2268,200,170,4,2294,5650,200,415,0,6265,3902,69
07-08-2020,tiruppur,328,31,38,2,319,1049,31,9,0,1089,750,20
07-08-2020,trichy,1273,105,104,0,1274,4825,105,9,0,4939,3598,67
07-08-2020,vellore,1377,158,211,5,1319,6846,156,52,2,7056,5651,86
07-08-2020,villupuram,804,73,129,2,746,4168,73,149,0,4390,3602,42
07-08-2020,virudhunagar,1911,101,205,2,1805,9337,101,104,0,9542,7621,116
07-08-2020,airport surveillance (international),156,1,81,0,76,0,0,852,1,853,776,1
07-08-2020,airport surveillance (domestic),171,2,21,0,152,0,0,675,2,677,525,0
07-08-2020,railway surveillance,2,0,0,0,2,0,0,426,0,426,424,0
08-08-2020,ariyalur,235,42,13,1,263,1185,42,18,0,1245,970,12
08-08-2020,chengalpattu,2386,425,114,8,2689,16981,425,5,0,17411,14420,302
08-08-2020,chennai,11637,986,869,20,11734,107116,986,22,0,108124,94100,2290
08-08-2020,coimbatore,1619,183,149,10,1643,6229,183,38,0,6450,4695,112
08-08-2020,cuddalore,1989,193,108,3,2071,4246,192,189,1,4628,2502,55
08-08-2020,dharmapuri,84,22,13,1,92,642,21,187,1,851,751,8
08-08-2020,dindigul,722,138,53,4,803,3540,138,69,0,3747,2877,67
08-08-2020,erode,294,58,18,2,332,925,58,29,0,1012,664,16
08-08-2020,kallakurichi,936,90,210,2,814,3901,90,403,0,4394,3545,35
08-08-2020,kancheepuram,2656,284,167,4,2769,11135,284,3,0,11422,8507,146
08-08-2020,kanyakumari,1826,197,126,1,1896,5930,196,95,1,6222,4257,69
08-08-2020,karur,288,40,62,1,265,654,40,44,0,738,461,12
08-08-2020,krishnagiri,431,60,51,1,439,1166,57,135,3,1361,901,21
08-08-2020,madurai,1795,92,256,4,1627,11668,91,138,1,11898,9989,282
08-08-2020,nagapattinam,438,77,24,0,491,929,77,70,0,1076,574,11
08-08-2020,namakkal,345,32,42,2,333,853,32,68,0,953,608,12
08-08-2020,nilgiris,153,19,15,0,157,914,19,15,0,948,788,3
08-08-2020,perambalur,190,45,26,0,209,639,45,2,0,686,468,9
08-08-2020,pudukottai,945,114,73,0,986,2905,114,31,0,3050,2028,36
08-08-2020,ramanathapuram,377,55,22,1,409,3397,55,133,0,3585,3103,73
08-08-2020,ranipet,1640,138,366,3,1409,6557,138,49,0,6744,5287,48
08-08-2020,salem,1152,55,226,3,978,4027,55,376,0,4458,3428,52
08-08-2020,sivagangai,461,55,60,5,451,2772,55,60,0,2887,2375,61
08-08-2020,tenkasi,878,203,48,1,1032,2701,203,48,0,2952,1876,44
08-08-2020,thanjavur,1034,227,81,3,1177,3688,227,19,0,3934,2715,42
08-08-2020,theni,2656,452,252,5,2851,7046,452,40,0,7538,4596,91
08-08-2020,thirupathur,492,58,40,4,506,1385,58,109,0,1552,1016,30
08-08-2020,thiruvallur,3345,391,327,6,3403,16213,391,8,0,16612,12929,280
08-08-2020,thiruvannamalai,1800,121,204,2,1715,7129,120,360,1,7610,5806,89
08-08-2020,thiruvarur,197,30,6,0,221,1880,30,37,0,1947,1714,12
08-08-2020,thoothukudi,1794,247,229,2,1810,8434,245,224,2,8905,7026,69
08-08-2020,tirunelveli,2329,126,140,7,2308,5884,126,415,0,6425,4042,75
08-08-2020,tiruppur,291,45,26,1,309,1052,45,9,0,1106,776,21
08-08-2020,trichy,1283,84,62,2,1303,4939,84,9,0,5032,3660,69
08-08-2020,vellore,1314,155,180,2,1287,6997,154,54,1,7206,5831,88
08-08-2020,villupuram,728,92,277,3,540,4222,92,149,0,4463,3879,44
08-08-2020,virudhunagar,1789,246,107,4,1924,9423,246,104,0,9773,7728,121
08-08-2020,airport surveillance (international),76,0,0,0,76,0,0,853,0,853,776,1
08-08-2020,airport surveillance (domestic),152,6,1,0,157,0,0,677,6,683,526,0
08-08-2020,railway surveillance,2,0,0,0,2,0,0,426,0,426,424,0
09-08-2020,ariyalur,263,46,25,1,283,1227,46,18,0,1291,995,13
09-08-2020,chengalpattu,2692,397,356,5,2728,17409,397,5,0,17811,14776,307
09-08-2020,chennai,11738,989,1061,12,11654,108106,989,22,0,109117,95161,2302
09-08-2020,coimbatore,1646,217,185,13,1665,6415,217,38,0,6670,4880,125
09-08-2020,cuddalore,2071,146,102,2,2113,4438,146,190,0,4774,2604,57
09-08-2020,dharmapuri,92,29,1,1,119,663,28,188,1,880,752,9
09-08-2020,dindigul,803,131,327,4,603,3678,131,69,0,3878,3204,71
09-08-2020,erode,318,66,16,1,367,969,65,29,1,1064,680,17
09-08-2020,kallakurichi,814,86,60,0,840,3991,86,403,0,4480,3605,35
09-08-2020,kancheepuram,2761,393,431,5,2718,11411,393,3,0,11807,8938,151
09-08-2020,kanyakumari,1895,127,268,4,1750,6125,127,96,0,6348,4525,73
09-08-2020,karur,266,32,17,0,281,695,32,44,0,771,478,12
09-08-2020,krishnagiri,440,60,29,0,471,1224,60,138,0,1422,930,21
09-08-2020,madurai,1627,107,463,6,1265,11759,107,139,0,12005,10452,288
09-08-2020,nagapattinam,491,69,39,0,521,1006,69,70,0,1145,613,11
09-08-2020,namakkal,336,35,34,2,335,888,35,68,0,991,642,14
09-08-2020,nilgiris,157,10,15,0,152,933,10,15,0,958,803,3
09-08-2020,perambalur,209,32,14,0,227,684,32,2,0,718,482,9
09-08-2020,pudukottai,986,139,113,0,1012,3019,139,31,0,3189,2141,36
09-08-2020,ramanathapuram,410,60,47,2,421,3453,60,133,0,3646,3150,75
09-08-2020,ranipet,1410,219,226,4,1399,6696,219,49,0,6964,5513,52
09-08-2020,salem,977,165,64,0,1078,4081,163,376,2,4622,3492,52
09-08-2020,sivagangai,450,50,47,4,449,2826,50,60,0,2936,2422,65
09-08-2020,tenkasi,1039,173,39,1,1172,2911,173,48,0,3132,1915,45
09-08-2020,thanjavur,1177,155,41,3,1288,3915,155,19,0,4089,2756,45
09-08-2020,theni,2851,360,194,3,3014,7498,360,40,0,7898,4790,94
09-08-2020,thirupathur,501,58,53,3,503,1438,58,109,0,1605,1069,33
09-08-2020,thiruvallur,3408,396,285,6,3513,16609,396,8,0,17013,13214,286
09-08-2020,thiruvannamalai,1715,222,75,5,1857,7249,221,361,1,7832,5881,94
09-08-2020,thiruvarur,221,51,10,0,262,1910,51,37,0,1998,1724,12
09-08-2020,thoothukudi,1813,251,237,6,1821,8682,250,226,1,9159,7263,75
09-08-2020,tirunelveli,2299,162,255,4,2202,6001,162,415,0,6578,4297,79
09-08-2020,tiruppur,315,42,25,2,330,1103,42,9,0,1154,801,23
09-08-2020,trichy,1304,96,132,2,1266,5024,96,9,0,5129,3792,71
09-08-2020,vellore,1287,149,205,5,1226,7151,149,55,0,7355,6036,93
09-08-2020,villupuram,540,67,155,0,452,4314,67,149,0,4530,4034,44
09-08-2020,virudhunagar,1924,193,338,13,1766,9669,193,104,0,9966,8066,134
09-08-2020,airport surveillance (international),76,7,2,0,81,0,0,853,7,860,778,1
09-08-2020,airport surveillance (domestic),157,7,34,0,130,0,0,683,7,690,560,0
09-08-2020,railway surveillance,2,0,0,0,2,0,0,426,0,426,424,0
10-08-2020,ariyalur,283,54,32,0,305,1273,54,18,0,1345,1027,13
10-08-2020,chengalpattu,2766,483,341,5,2903,17844,483,5,0,18332,15117,312
10-08-2020,chennai,11682,976,1305,25,11328,109123,976,22,0,110121,96466,2327
10-08-2020,coimbatore,1664,292,388,7,1561,6631,292,38,0,6961,5268,132
10-08-2020,cuddalore,2113,287,132,1,2267,4584,282,190,5,5061,2736,58
10-08-2020,dharmapuri,119,18,6,0,131,691,16,189,2,898,758,9
10-08-2020,dindigul,603,173,58,4,714,3809,172,69,1,4051,3262,75
10-08-2020,erode,367,37,10,0,394,1034,37,30,0,1101,690,17
10-08-2020,kallakurichi,839,85,97,1,826,4076,85,403,0,4564,3702,36
10-08-2020,kancheepuram,2732,310,311,3,2728,11818,310,3,0,12131,9249,154
10-08-2020,kanyakumari,1750,205,161,7,1787,6252,204,96,1,6553,4686,80
10-08-2020,karur,282,44,12,1,313,728,44,44,0,816,490,13
10-08-2020,krishnagiri,471,58,13,0,516,1284,58,138,0,1480,943,21
10-08-2020,madurai,1264,100,298,5,1061,11865,100,139,0,12104,10750,293
10-08-2020,nagapattinam,523,57,19,3,558,1077,57,70,0,1204,632,14
10-08-2020,namakkal,335,29,50,1,313,923,28,68,1,1020,692,15
10-08-2020,nilgiris,152,7,24,0,135,943,7,15,0,965,827,3
10-08-2020,perambalur,227,35,25,0,237,716,35,2,0,753,507,9
10-08-2020,pudukottai,1014,133,87,4,1056,3160,133,31,0,3324,2228,40
10-08-2020,ramanathapuram,422,35,46,3,408,3514,35,133,0,3682,3196,78
10-08-2020,ranipet,1402,184,195,0,1391,6918,184,49,0,7151,5708,52
10-08-2020,salem,1072,128,73,4,1123,4238,127,378,1,4744,3565,56
10-08-2020,sivagangai,450,59,60,3,446,2877,59,60,0,2996,2482,68
10-08-2020,tenkasi,1172,114,49,5,1232,3084,114,48,0,3246,1964,50
10-08-2020,thanjavur,1291,123,133,4,1277,4073,120,19,3,4215,2889,49
10-08-2020,theni,3016,357,321,3,3049,7860,357,40,0,8257,5111,97
10-08-2020,thirupathur,503,84,47,0,540,1496,84,109,0,1689,1116,33
10-08-2020,thiruvallur,3441,399,337,4,3499,16933,399,8,0,17340,13551,290
10-08-2020,thiruvannamalai,1859,154,166,0,1847,7472,153,362,1,7988,6047,94
10-08-2020,thiruvarur,260,30,8,1,281,1959,30,37,0,2026,1732,13
10-08-2020,thoothukudi,1823,196,221,5,1793,8934,195,227,1,9357,7484,80
10-08-2020,tirunelveli,2203,83,103,3,2180,6164,83,415,0,6662,4400,82
10-08-2020,tiruppur,325,48,14,0,359,1140,48,9,0,1197,815,23
10-08-2020,trichy,1251,56,289,2,1016,5105,56,9,0,5170,4081,73
10-08-2020,vellore,1228,189,201,5,1211,7302,187,55,2,7546,6237,98
10-08-2020,villupuram,453,89,43,0,499,4382,86,149,3,4620,4077,44
10-08-2020,virudhunagar,1766,189,355,5,1595,9862,189,104,0,10155,8421,139
10-08-2020,airport surveillance (international),81,3,0,0,84,0,0,860,3,863,778,1
10-08-2020,airport surveillance (domestic),130,11,7,0,134,0,0,690,11,701,567,0
10-08-2020,railway surveillance,2,0,0,0,2,0,0,426,0,426,424,0
11-08-2020,ariyalur,306,86,37,0,355,1328,86,18,0,1432,1064,13
11-08-2020,chengalpattu,2918,388,291,4,3011,18342,388,5,0,18735,15408,316
11-08-2020,chennai,11275,986,1108,23,11130,110046,986,22,0,111054,97574,2350
11-08-2020,coimbatore,1572,324,150,8,1738,6934,324,38,0,7296,5418,140
11-08-2020,cuddalore,2269,281,323,1,2226,4868,281,195,0,5344,3059,59
11-08-2020,dharmapuri,131,8,0,0,139,707,8,191,0,906,758,9
11-08-2020,dindigul,717,150,100,2,765,3984,148,70,2,4204,3362,77
11-08-2020,erode,391,17,19,0,389,1068,16,30,1,1115,709,17
11-08-2020,kallakurichi,827,74,73,1,827,4162,74,403,0,4639,3775,37
11-08-2020,kancheepuram,2737,330,368,0,2699,12137,330,3,0,12470,9617,154
11-08-2020,kanyakumari,1788,192,200,13,1767,6457,192,97,0,6746,4886,93
11-08-2020,karur,314,31,19,0,326,773,30,44,1,848,509,13
11-08-2020,krishnagiri,516,43,105,2,452,1342,43,138,0,1523,1048,23
11-08-2020,madurai,1062,90,278,4,870,11966,90,139,0,12195,11028,297
11-08-2020,nagapattinam,550,53,30,2,571,1126,53,70,0,1249,662,16
11-08-2020,namakkal,316,10,31,1,294,954,10,69,0,1033,723,16
11-08-2020,nilgiris,132,5,22,0,115,947,5,15,0,967,849,3
11-08-2020,perambalur,238,35,34,0,239,752,35,2,0,789,541,9
11-08-2020,pudukottai,1056,64,110,1,1009,3293,64,31,0,3388,2338,41
11-08-2020,ramanathapuram,409,36,33,0,412,3550,36,133,0,3719,3229,78
11-08-2020,ranipet,1394,333,196,4,1527,7105,333,49,0,7487,5904,56
11-08-2020,salem,1124,206,74,2,1254,4366,205,379,1,4951,3639,58
11-08-2020,sivagangai,448,55,132,2,369,2938,55,60,0,3053,2614,70
11-08-2020,tenkasi,1232,136,62,4,1302,3198,136,48,0,3382,2026,54
11-08-2020,thanjavur,1283,125,85,6,1317,4199,125,22,0,4346,2974,55
11-08-2020,theni,3049,297,342,2,3002,8217,297,40,0,8554,5453,99
11-08-2020,thirupathur,540,37,19,0,558,1580,37,109,0,1726,1135,33
11-08-2020,thiruvallur,3503,362,233,8,3624,17336,362,8,0,17706,13784,298
11-08-2020,thiruvannamalai,1851,161,43,6,1963,7629,160,363,1,8153,6090,100
11-08-2020,thiruvarur,280,88,5,3,360,1988,88,37,0,2113,1737,16
11-08-2020,thoothukudi,1795,110,234,0,1671,9131,107,228,3,9469,7718,80
11-08-2020,tirunelveli,2183,136,496,8,1815,6250,136,415,0,6801,4896,90
11-08-2020,tiruppur,358,37,14,4,377,1187,37,9,0,1233,829,27
11-08-2020,trichy,1010,86,203,4,889,5155,86,9,0,5250,4284,77
11-08-2020,vellore,1207,181,91,2,1295,7485,181,57,0,7723,6328,100
11-08-2020,villupuram,501,91,67,1,524,4470,90,152,1,4713,4144,45
11-08-2020,virudhunagar,1597,180,374,0,1403,10053,180,104,0,10337,8795,139
11-08-2020,airport surveillance (international),84,0,0,0,84,0,0,863,0,863,778,1
11-08-2020,airport surveillance (domestic),134,8,4,0,138,0,0,701,8,709,571,0
11-08-2020,railway surveillance,2,2,0,0,4,0,0,426,2,428,424,0
13-08-2020,ariyalur,419,76,34,1,460,1479,76,18,0,1573,1098,15
13-08-2020,chengalpattu,3036,453,488,7,2994,19182,453,5,0,19640,16317,329
13-08-2020,chennai,10967,989,1070,18,10868,112047,989,22,0,113058,99806,2384
13-08-2020,coimbatore,1816,289,175,7,1923,7557,289,38,0,7884,5805,156
13-08-2020,cuddalore,2470,258,79,5,2644,5488,258,197,0,5943,3234,65
13-08-2020,dharmapuri,132,21,7,0,146,722,21,191,0,934,779,9
13-08-2020,dindigul,667,141,79,2,727,4173,141,72,0,4386,3575,84
13-08-2020,erode,411,50,15,0,446,1124,50,32,0,1206,741,19
13-08-2020,kallakurichi,758,86,82,2,760,4256,86,403,0,4745,3942,43
13-08-2020,kancheepuram,2747,243,290,6,2694,12839,243,3,0,13085,10225,166
13-08-2020,kanyakumari,1706,186,245,6,1641,6764,185,100,1,7050,5306,103
13-08-2020,karur,312,40,31,2,319,843,40,45,0,928,593,16
13-08-2020,krishnagiri,402,9,45,0,366,1392,8,138,1,1539,1150,23
13-08-2020,madurai,1007,151,97,5,1056,12225,151,139,0,12515,11151,308
13-08-2020,nagapattinam,591,71,9,0,653,1251,68,70,3,1392,723,16
13-08-2020,namakkal,294,47,64,2,275,993,47,72,0,1112,819,18
13-08-2020,nilgiris,133,7,48,0,92,974,7,15,0,996,901,3
13-08-2020,perambalur,221,31,31,0,221,806,31,2,0,839,607,11
13-08-2020,pudukottai,1074,131,63,4,1138,3500,131,31,0,3662,2477,47
13-08-2020,ramanathapuram,430,60,57,5,428,3647,60,133,0,3840,3328,84
13-08-2020,ranipet,1624,57,159,2,1520,7680,57,49,0,7786,6203,63
13-08-2020,salem,1405,173,59,5,1514,4791,173,380,0,5344,3764,66
13-08-2020,sivagangai,386,65,26,1,424,3078,65,60,0,3203,2707,72
13-08-2020,tenkasi,1382,138,97,4,1419,3446,138,48,0,3632,2152,61
13-08-2020,thanjavur,1182,154,187,3,1146,4385,154,22,0,4561,3356,59
13-08-2020,theni,2998,286,275,5,3004,8796,286,40,0,9122,6014,104
13-08-2020,thirupathur,592,64,45,1,610,1690,64,109,0,1863,1219,34
13-08-2020,thiruvallur,3699,390,282,4,3803,18079,390,8,0,18477,14359,315
13-08-2020,thiruvannamalai,1925,152,39,5,2033,7916,150,364,2,8432,6293,106
13-08-2020,thiruvarur,347,27,20,1,353,2082,27,37,0,2146,1775,18
13-08-2020,thoothukudi,1620,103,225,0,1498,9395,94,232,9,9730,8150,82
13-08-2020,tirunelveli,1562,189,203,7,1541,6508,189,415,0,7112,5465,106
13-08-2020,tiruppur,435,64,50,3,446,1306,64,9,0,1379,896,37
13-08-2020,trichy,859,161,83,2,935,5380,161,9,0,5550,4534,81
13-08-2020,vellore,1180,143,86,1,1236,7715,141,57,2,7915,6577,102
13-08-2020,villupuram,547,104,59,1,591,4646,104,156,0,4906,4268,47
13-08-2020,virudhunagar,1433,219,225,2,1425,10526,219,104,0,10849,9280,144
13-08-2020,airport surveillance (international),52,2,5,0,49,0,0,865,2,867,817,1
13-08-2020,airport surveillance (domestic),104,5,12,0,97,0,0,721,5,726,629,0
13-08-2020,railway surveillance,4,0,0,0,4,0,0,428,0,428,424,0
14-08-2020,ariyalur,460,69,32,1,496,1555,69,18,0,1642,1130,16
14-08-2020,chengalpattu,2997,437,351,6,3077,19638,437,5,0,20080,16668,335
14-08-2020,chennai,10884,1187,837,25,11209,113051,1187,22,0,114260,100643,2408
14-08-2020,coimbatore,1928,385,243,8,2062,7851,385,38,0,8274,6048,164
14-08-2020,cuddalore,2644,221,157,4,2704,5747,219,197,2,6165,3391,70
14-08-2020,dharmapuri,142,39,4,0,177,739,37,191,2,969,783,9
14-08-2020,dindigul,727,138,42,3,820,4314,138,72,0,4524,3617,87
14-08-2020,erode,446,128,58,1,515,1174,126,32,2,1334,799,20
14-08-2020,kallakurichi,761,30,119,1,671,4343,30,403,0,4776,4061,44
14-08-2020,kancheepuram,2703,315,319,2,2697,13091,315,3,0,13409,10544,168
14-08-2020,kanyakumari,1641,128,269,5,1495,6949,127,101,1,7178,5575,108
14-08-2020,karur,316,14,100,2,228,880,14,45,0,939,693,18
14-08-2020,krishnagiri,367,12,37,1,341,1401,12,139,0,1552,1187,24
14-08-2020,madurai,1056,46,44,1,1057,12376,46,139,0,12561,11195,309
14-08-2020,nagapattinam,649,34,86,0,597,1315,34,73,0,1422,809,16
14-08-2020,namakkal,277,30,28,0,279,1042,30,72,0,1144,847,18
14-08-2020,nilgiris,88,18,12,0,94,977,18,15,0,1010,913,3
14-08-2020,perambalur,221,24,54,0,191,837,24,2,0,863,661,11
14-08-2020,pudukottai,1139,155,155,1,1138,3632,155,31,0,3818,2632,48
14-08-2020,ramanathapuram,429,57,49,1,436,3708,57,133,0,3898,3377,85
14-08-2020,ranipet,1519,178,343,3,1351,7736,178,49,0,7963,6546,66
14-08-2020,salem,1516,191,109,3,1595,4966,189,380,2,5537,3873,69
14-08-2020,sivagangai,422,70,68,3,421,3141,70,60,0,3271,2775,75
14-08-2020,tenkasi,1419,93,161,4,1347,3584,92,48,1,3725,2313,65
14-08-2020,thanjavur,1149,88,142,2,1093,4542,88,22,0,4652,3498,61
14-08-2020,theni,3004,367,175,8,3188,9082,365,40,2,9489,6189,112
14-08-2020,thirupathur,616,63,63,2,614,1760,63,109,0,1932,1282,36
14-08-2020,thiruvallur,3788,495,372,8,3903,18455,495,8,0,18958,14731,324
14-08-2020,thiruvannamalai,2034,81,125,8,1982,8067,79,366,2,8514,6418,114
14-08-2020,thiruvarur,353,56,40,0,369,2109,56,37,0,2202,1815,18
14-08-2020,thoothukudi,1498,60,222,1,1335,9489,60,241,0,9790,8372,83
14-08-2020,tirunelveli,1541,117,210,4,1444,6697,114,415,3,7229,5675,110
14-08-2020,tiruppur,445,53,36,3,459,1369,53,9,0,1431,932,40
14-08-2020,trichy,934,106,132,0,908,5539,106,9,0,5654,4666,80
14-08-2020,vellore,1221,178,87,4,1308,7841,177,59,1,8078,6664,106
14-08-2020,villupuram,591,127,62,0,656,4750,127,156,0,5033,4330,47
14-08-2020,virudhunagar,1424,90,212,2,1300,10744,90,104,0,10938,9492,146
14-08-2020,airport surveillance (international),49,1,0,0,50,0,0,867,1,868,817,1
14-08-2020,airport surveillance (domestic),97,9,1,0,105,0,0,726,9,735,630,0
14-08-2020,railway surveillance,4,0,0,0,4,0,0,428,0,428,424,0
15-08-2020,ariyalur,496,73,45,1,523,1624,73,18,0,1715,1175,17
15-08-2020,chengalpattu,3087,376,447,5,3011,20084,376,5,0,20465,17115,339
15-08-2020,chennai,11214,1179,1046,26,11321,114243,1179,22,0,115444,101689,2434
15-08-2020,coimbatore,2066,290,175,6,2175,8241,290,38,0,8569,6223,171
15-08-2020,cuddalore,2704,340,314,1,2729,5966,339,199,1,6505,3705,71
15-08-2020,dharmapuri,177,18,15,1,179,776,18,193,0,987,798,10
15-08-2020,dindigul,823,118,64,4,873,4455,118,72,0,4645,3681,91
15-08-2020,erode,518,14,54,2,476,1301,14,34,0,1349,853,20
15-08-2020,kallakurichi,671,81,42,3,707,4373,81,403,0,4857,4103,47
15-08-2020,kancheepuram,2679,184,2,4,2857,13389,184,3,0,13576,10546,173
15-08-2020,kanyakumari,1494,182,166,3,1507,7075,182,102,0,7359,5741,111
15-08-2020,karur,231,40,28,0,243,897,40,45,0,982,721,18
15-08-2020,krishnagiri,344,56,50,1,349,1416,56,139,0,1611,1237,25
15-08-2020,madurai,1049,90,105,6,1028,12414,90,139,0,12643,11300,315
15-08-2020,nagapattinam,598,81,25,0,654,1350,80,73,1,1504,834,16
15-08-2020,namakkal,282,34,30,3,283,1075,33,72,1,1181,877,21
15-08-2020,nilgiris,85,32,2,0,115,986,32,15,0,1033,915,3
15-08-2020,perambalur,191,26,27,0,190,861,26,2,0,889,688,11
15-08-2020,pudukottai,1141,170,79,7,1225,3789,170,31,0,3990,2711,54
15-08-2020,ramanathapuram,436,59,1,1,493,3765,59,133,0,3957,3378,86
15-08-2020,ranipet,1345,260,1,5,1599,7908,260,49,0,8217,6547,71
15-08-2020,salem,1595,200,100,1,1694,5155,200,382,0,5737,3973,70
15-08-2020,sivagangai,421,49,53,3,414,3211,49,60,0,3320,2828,78
15-08-2020,tenkasi,1349,87,67,2,1367,3678,87,49,0,3814,2380,67
15-08-2020,thanjavur,1096,109,116,7,1082,4633,109,22,0,4764,3614,68
15-08-2020,theni,3189,213,357,3,3042,9448,213,42,0,9703,6546,115
15-08-2020,thirupathur,611,70,82,0,599,1819,70,109,0,1998,1364,35
15-08-2020,thiruvallur,3905,422,427,3,3897,18952,422,8,0,19382,15158,327
15-08-2020,thiruvannamalai,1990,100,201,4,1885,8154,99,368,1,8622,6619,118
15-08-2020,thiruvarur,367,54,55,1,365,2163,54,37,0,2254,1870,19
15-08-2020,thoothukudi,1336,77,184,2,1227,9551,77,241,0,9869,8556,86
15-08-2020,tirunelveli,1444,169,130,5,1478,6811,169,418,0,7398,5805,115
15-08-2020,tiruppur,454,68,59,3,460,1418,68,9,0,1495,991,44
15-08-2020,trichy,899,117,99,5,912,5636,117,9,0,5762,4765,85
15-08-2020,vellore,1312,153,346,3,1116,8023,146,60,7,8236,7010,110
15-08-2020,villupuram,656,84,45,0,695,4877,83,156,1,5117,4375,47
15-08-2020,virudhunagar,1302,167,192,6,1271,10836,167,104,0,11107,9684,152
15-08-2020,airport surveillance (international),50,6,1,0,55,0,0,868,6,874,818,1
15-08-2020,airport surveillance (domestic),105,12,4,0,113,0,0,735,12,747,634,0
15-08-2020,railway surveillance,4,0,0,0,4,0,0,428,0,428,424,0
16-08-2020,ariyalur,523,77,16,0,584,1697,77,18,0,1792,1191,17
16-08-2020,chengalpattu,3021,436,422,3,3032,20470,436,5,0,20911,17537,342
16-08-2020,chennai,11333,1196,1009,22,11498,115432,1196,22,0,116650,102698,2454
16-08-2020,coimbatore,2178,395,182,14,2377,8534,395,38,0,8967,6405,185
16-08-2020,cuddalore,2729,185,184,2,2728,6305,184,200,1,6690,3889,73
16-08-2020,dharmapuri,181,20,6,1,194,796,17,193,3,1009,804,11
16-08-2020,dindigul,873,110,201,0,782,4573,108,72,2,4755,3882,91
16-08-2020,erode,469,103,42,4,526,1308,97,34,6,1445,895,24
16-08-2020,kallakurichi,698,72,57,3,710,4444,71,403,1,4919,4160,49
16-08-2020,kancheepuram,2850,307,307,3,2847,13566,307,3,0,13876,10853,176
16-08-2020,kanyakumari,1507,133,178,3,1459,7257,133,102,0,7492,5919,114
16-08-2020,karur,243,30,8,1,264,937,30,45,0,1012,729,19
16-08-2020,krishnagiri,345,51,31,1,364,1468,48,139,3,1658,1268,26
16-08-2020,madurai,1028,121,104,6,1039,12504,120,139,1,12764,11404,321
16-08-2020,nagapattinam,654,66,31,0,689,1430,66,74,0,1570,865,16
16-08-2020,namakkal,281,42,44,0,279,1106,42,73,0,1221,921,21
16-08-2020,nilgiris,115,24,18,0,121,1018,24,15,0,1057,933,3
16-08-2020,perambalur,197,42,34,0,205,894,42,2,0,938,722,11
16-08-2020,pudukottai,1225,187,43,6,1363,3959,187,31,0,4177,2754,60
16-08-2020,ramanathapuram,493,58,51,1,499,3824,58,133,0,4015,3429,87
16-08-2020,ranipet,1588,152,248,2,1490,8157,152,49,0,8358,6795,73
16-08-2020,salem,1697,177,309,5,1560,5358,169,382,8,5917,4282,75
16-08-2020,sivagangai,414,54,46,5,417,3260,54,60,0,3374,2874,83
16-08-2020,tenkasi,1372,86,270,2,1186,3770,86,49,0,3905,2650,69
16-08-2020,thanjavur,1082,124,194,5,1007,4742,124,22,0,4888,3808,73
16-08-2020,theni,3043,205,319,0,2929,9662,205,42,0,9909,6865,115
16-08-2020,thirupathur,602,12,46,1,567,1892,12,109,0,2013,1410,36
16-08-2020,thiruvallur,3895,488,294,8,4081,19374,488,8,0,19870,15452,337
16-08-2020,thiruvannamalai,1885,98,133,4,1846,8253,94,369,4,8720,6752,122
16-08-2020,thiruvarur,365,65,31,1,398,2217,65,37,0,2319,1901,20
16-08-2020,thoothukudi,1228,94,195,3,1124,9629,94,241,0,9964,8751,89
16-08-2020,tirunelveli,1472,130,148,7,1447,6974,130,418,0,7522,5953,122
16-08-2020,tiruppur,462,34,36,3,457,1488,34,9,0,1531,1027,47
16-08-2020,trichy,913,104,113,1,903,5754,104,9,0,5867,4878,86
16-08-2020,vellore,1114,264,204,1,1173,8167,264,67,0,8498,7214,111
16-08-2020,villupuram,695,130,67,2,756,4961,129,157,1,5248,4442,50
16-08-2020,virudhunagar,1271,76,379,5,963,11003,76,104,0,11183,10063,157
16-08-2020,airport surveillance (international),55,1,0,0,56,0,0,874,1,875,818,1
16-08-2020,airport surveillance (domestic),113,1,19,0,95,0,0,747,1,748,653,0
16-08-2020,railway surveillance,4,0,0,0,4,0,0,428,0,428,424,0
18-08-2020,ariyalur,611,73,40,2,642,1850,72,18,1,1941,1280,19
18-08-2020,chengalpattu,2804,344,400,7,2741,21150,344,5,0,21499,18402,356
18-08-2020,chennai,12042,1182,1097,24,12103,117855,1182,22,0,119059,104455,2501
18-08-2020,coimbatore,2488,392,253,5,2622,9328,392,38,0,9758,6935,201
18-08-2020,cuddalore,2847,250,242,4,2851,6880,250,202,0,7332,4403,78
18-08-2020,dharmapuri,199,8,23,0,184,842,8,196,0,1046,851,11
18-08-2020,dindigul,841,150,96,1,894,4838,150,75,0,5063,4074,95
18-08-2020,erode,653,58,16,2,693,1542,58,40,0,1640,920,27
18-08-2020,kallakurichi,618,75,90,3,600,4560,75,404,0,5039,4386,53
18-08-2020,kancheepuram,2810,249,263,7,2789,14044,249,3,0,14296,11321,186
18-08-2020,kanyakumari,1467,147,112,7,1495,7597,147,102,0,7846,6225,126
18-08-2020,karur,285,49,39,1,294,1000,49,45,0,1094,778,22
18-08-2020,krishnagiri,345,19,38,0,326,1527,19,142,0,1688,1336,26
18-08-2020,madurai,1130,77,147,3,1057,12738,77,140,0,12955,11571,327
18-08-2020,nagapattinam,661,75,42,2,692,1501,72,74,3,1650,940,18
18-08-2020,namakkal,325,37,29,2,331,1216,37,73,0,1326,970,25
18-08-2020,nilgiris,132,9,8,0,133,1065,9,15,0,1089,952,4
18-08-2020,perambalur,231,34,48,1,216,974,34,2,0,1010,781,13
18-08-2020,pudukottai,1377,110,112,5,1370,4307,110,32,0,4449,3012,67
18-08-2020,ramanathapuram,503,48,55,2,494,3932,48,133,0,4113,3528,91
18-08-2020,ranipet,1337,129,285,2,1179,8469,129,49,0,8647,7385,83
18-08-2020,salem,1744,286,105,8,1917,5793,286,392,0,6471,4469,85
18-08-2020,sivagangai,409,51,54,1,405,3367,51,60,0,3478,2986,87
18-08-2020,tenkasi,1202,93,120,2,1173,4004,93,49,0,4146,2899,74
18-08-2020,thanjavur,927,129,83,5,968,4979,129,22,0,5130,4082,80
18-08-2020,theni,2913,295,446,1,2761,10147,295,42,0,10484,7606,117
18-08-2020,thirupathur,503,73,85,1,490,1977,73,109,0,2159,1627,42
18-08-2020,thiruvallur,3859,489,384,5,3959,20121,489,8,0,20618,16313,346
18-08-2020,thiruvannamalai,1461,123,215,1,1368,8426,119,373,4,8922,7427,127
18-08-2020,thiruvarur,444,41,93,5,387,2353,41,37,0,2431,2018,26
18-08-2020,thoothukudi,1022,68,217,1,872,9799,68,241,0,10108,9146,90
18-08-2020,tirunelveli,1382,119,151,2,1348,7204,119,420,0,7743,6265,130
18-08-2020,tiruppur,502,45,56,0,491,1593,45,9,0,1647,1108,48
18-08-2020,trichy,942,119,94,1,966,5985,119,9,0,6113,5053,94
18-08-2020,vellore,1140,94,11,6,1217,8480,94,67,0,8641,7303,121
18-08-2020,villupuram,779,114,133,1,759,5231,112,159,2,5504,4694,51
18-08-2020,virudhunagar,1022,54,159,1,916,11297,54,104,0,11455,10380,159
18-08-2020,airport surveillance (international),65,0,1,0,64,0,0,884,0,884,819,1
18-08-2020,airport surveillance (domestic),96,1,8,0,89,0,0,751,1,752,663,0
18-08-2020,railway surveillance,4,0,0,0,4,0,0,428,0,428,424,0
19-08-2020,ariyalur,642,51,74,1,618,1922,51,19,0,1992,1354,20
19-08-2020,chengalpattu,2751,315,448,4,2614,21504,315,5,0,21824,18850,360
19-08-2020,chennai,12125,1186,1039,16,12256,119059,1186,22,0,120267,105494,2517
19-08-2020,coimbatore,2628,394,286,16,2720,9726,394,38,0,10158,7221,217
19-08-2020,cuddalore,2852,238,155,5,2930,7131,238,202,0,7571,4558,83
19-08-2020,dharmapuri,184,18,17,0,185,850,18,196,0,1064,868,11
19-08-2020,dindigul,886,111,91,6,900,4980,111,75,0,5166,4165,101
19-08-2020,erode,694,85,26,1,752,1601,85,40,0,1726,946,28
19-08-2020,kallakurichi,599,58,40,0,617,4634,58,404,0,5096,4426,53
19-08-2020,kancheepuram,2784,257,440,3,2598,14288,257,3,0,14548,11761,189
19-08-2020,kanyakumari,1495,122,182,4,1431,7744,122,102,0,7968,6407,130
19-08-2020,karur,294,39,31,1,301,1049,39,45,0,1133,809,23
19-08-2020,krishnagiri,326,19,50,0,295,1546,19,142,0,1707,1386,26
19-08-2020,madurai,1060,109,89,2,1078,12818,108,140,1,13067,11660,329
19-08-2020,nagapattinam,692,68,39,2,719,1573,68,77,0,1718,979,20
19-08-2020,namakkal,331,35,8,0,358,1253,35,73,0,1361,978,25
19-08-2020,nilgiris,129,35,4,0,160,1070,35,15,0,1120,956,4
19-08-2020,perambalur,217,37,19,0,235,1009,37,2,0,1048,800,13
19-08-2020,pudukottai,1371,105,130,1,1345,4418,105,32,0,4555,3142,68
19-08-2020,ramanathapuram,490,40,60,3,467,3976,40,133,0,4149,3588,94
19-08-2020,ranipet,1155,146,131,10,1160,8577,146,49,0,8772,7516,96
19-08-2020,salem,1917,295,238,0,1974,6079,290,392,5,6766,4707,85
19-08-2020,sivagangai,405,67,1,3,468,3418,67,60,0,3545,2987,90
19-08-2020,tenkasi,1179,62,235,4,1002,4103,62,49,0,4214,3134,78
19-08-2020,thanjavur,969,114,256,2,825,5109,114,22,0,5245,4338,82
19-08-2020,theni,2761,288,373,4,2672,10442,288,42,0,10772,7979,121
19-08-2020,thirupathur,490,51,97,2,442,2050,51,109,0,2210,1724,44
19-08-2020,thiruvallur,3953,393,402,9,3935,20604,393,8,0,21005,16715,355
19-08-2020,thiruvannamalai,1368,95,343,2,1118,8545,95,377,0,9017,7770,129
19-08-2020,thiruvarur,387,120,56,2,449,2394,120,37,0,2551,2074,28
19-08-2020,thoothukudi,875,99,185,3,786,9870,99,241,0,10210,9331,93
19-08-2020,tirunelveli,1337,151,164,3,1321,7312,151,420,0,7883,6429,133
19-08-2020,tiruppur,490,61,43,1,507,1637,61,9,0,1707,1151,49
19-08-2020,trichy,966,99,54,0,1011,6104,99,9,0,6212,5107,94
19-08-2020,vellore,1226,175,234,2,1165,8580,175,67,0,8822,7537,120
19-08-2020,villupuram,759,69,117,1,710,5343,69,161,0,5573,4811,52
19-08-2020,virudhunagar,916,184,225,3,872,11351,184,104,0,11639,10605,162
19-08-2020,airport surveillance (international),64,1,0,0,65,0,0,884,1,885,819,1
19-08-2020,airport surveillance (domestic),89,3,2,0,90,0,0,752,3,755,665,0
19-08-2020,railway surveillance,4,0,0,0,4,0,0,428,0,428,424,0
21-08-2020,ariyalur,570,85,51,2,602,2011,85,19,0,2115,1490,23
21-08-2020,chengalpattu,2649,430,448,3,2628,22302,430,5,0,22737,19743,366
21-08-2020,chennai,12315,1282,866,23,12708,121451,1282,24,0,122757,107492,2557
21-08-2020,coimbatore,2932,395,258,3,3066,10524,395,38,0,10957,7660,231
21-08-2020,cuddalore,3127,242,511,4,2854,7646,242,202,0,8090,5144,92
21-08-2020,dharmapuri,167,25,9,0,183,873,23,196,2,1094,900,11
21-08-2020,dindigul,930,129,181,3,875,5228,128,75,1,5432,4449,108
21-08-2020,erode,782,103,67,1,817,1761,102,43,1,1907,1060,30
21-08-2020,kallakurichi,672,50,0,1,721,4783,50,404,0,5237,4459,57
21-08-2020,kancheepuram,2541,220,339,4,2418,14808,220,3,0,15031,12413,200
21-08-2020,kanyakumari,1507,155,105,3,1554,7991,153,102,2,8248,6555,139
21-08-2020,karur,315,41,23,0,333,1124,41,45,0,1210,854,23
21-08-2020,krishnagiri,265,49,32,0,282,1569,45,142,4,1760,1452,26
21-08-2020,madurai,1056,86,138,1,1003,13010,86,141,0,13237,11903,331
21-08-2020,nagapattinam,534,49,20,3,560,1659,49,78,0,1786,1200,26
21-08-2020,namakkal,381,62,5,3,435,1341,58,73,4,1476,1013,28
21-08-2020,nilgiris,198,46,11,1,232,1159,45,15,1,1220,983,5
21-08-2020,perambalur,244,36,27,0,253,1078,36,2,0,1116,849,14
21-08-2020,pudukottai,1325,98,53,2,1368,4629,98,32,0,4759,3320,71
21-08-2020,ramanathapuram,483,107,37,0,553,4067,107,133,0,4307,3660,94
21-08-2020,ranipet,1132,178,49,3,1258,8864,178,49,0,9091,7733,100
21-08-2020,salem,2162,269,181,6,2244,6723,267,397,2,7389,5047,98
21-08-2020,sivagangai,357,38,70,3,322,3532,38,60,0,3630,3213,95
21-08-2020,tenkasi,1078,112,61,3,1126,4312,112,49,0,4473,3261,86
21-08-2020,thanjavur,858,100,76,2,880,5335,100,22,0,5457,4491,86
21-08-2020,theni,2519,122,381,2,2258,10967,122,42,0,11131,8747,126
21-08-2020,thirupathur,493,100,29,1,563,2185,100,109,0,2394,1781,50
21-08-2020,thiruvallur,3906,369,348,4,3923,21379,369,8,0,21756,17467,366
21-08-2020,thiruvannamalai,1028,61,171,3,915,8750,61,377,0,9188,8137,136
21-08-2020,thiruvarur,481,68,62,2,485,2575,68,37,0,2680,2163,32
21-08-2020,thoothukudi,660,127,149,1,637,10054,127,241,0,10422,9690,95
21-08-2020,tirunelveli,1345,163,197,3,1308,7615,163,420,0,8198,6751,139
21-08-2020,tiruppur,520,99,21,1,597,1767,98,9,1,1875,1226,52
21-08-2020,trichy,1037,110,131,2,1014,6320,110,9,0,6439,5327,98
21-08-2020,vellore,1134,200,220,4,1110,8860,197,73,3,9133,7894,129
21-08-2020,villupuram,558,129,76,2,609,5480,128,162,1,5771,5108,54
21-08-2020,virudhunagar,917,50,351,2,614,11689,50,104,0,11843,11064,165
21-08-2020,airport surveillance (international),34,5,0,0,39,0,0,886,5,891,851,1
21-08-2020,airport surveillance (domestic),67,5,10,0,62,0,0,760,5,765,703,0
21-08-2020,railway surveillance,4,0,0,0,4,0,0,428,0,428,424,0
22-08-2020,ariyalur,603,48,109,1,541,2097,48,19,0,2164,1599,24
22-08-2020,chengalpattu,2627,406,393,3,2637,22734,406,5,0,23145,20136,372
22-08-2020,chennai,12732,1294,1053,11,12962,122753,1294,24,0,124071,108545,2564
22-08-2020,coimbatore,3078,389,312,4,3151,10931,389,38,0,11358,7972,235
22-08-2020,cuddalore,2856,309,224,5,2936,7890,309,202,0,8401,5368,97
22-08-2020,dharmapuri,183,27,10,0,200,896,27,198,0,1121,910,11
22-08-2020,dindigul,873,129,103,0,899,5354,129,76,0,5559,4552,108
22-08-2020,erode,817,117,19,0,915,1863,116,44,1,2024,1079,30
22-08-2020,kallakurichi,725,54,155,0,624,4837,54,404,0,5295,4614,57
22-08-2020,kancheepuram,2419,257,362,1,2313,15029,257,3,0,15289,12775,201
22-08-2020,kanyakumari,1554,108,161,4,1497,8144,108,104,0,8356,6716,143
22-08-2020,karur,333,40,12,0,361,1165,40,45,0,1250,866,23
22-08-2020,krishnagiri,282,30,24,1,287,1614,28,146,2,1790,1476,27
22-08-2020,madurai,998,96,172,1,921,13091,96,141,0,13328,12075,332
22-08-2020,nagapattinam,559,81,28,1,611,1708,81,78,0,1867,1228,28
22-08-2020,namakkal,433,42,41,2,432,1396,40,77,2,1515,1054,29
22-08-2020,nilgiris,218,32,20,0,230,1190,32,16,0,1238,1003,5
22-08-2020,perambalur,254,6,34,0,226,1115,6,2,0,1123,883,14
22-08-2020,pudukottai,1368,154,133,1,1388,4727,154,32,0,4913,3453,72
22-08-2020,ramanathapuram,553,40,60,3,530,4174,40,133,0,4347,3720,97
22-08-2020,ranipet,1258,93,272,4,1075,9042,93,49,0,9184,8005,104
22-08-2020,salem,2245,288,115,3,2415,6992,288,399,0,7679,5162,102
22-08-2020,sivagangai,323,60,49,3,331,3571,60,60,0,3691,3262,98
22-08-2020,tenkasi,1119,137,98,2,1156,4417,137,49,0,4603,3359,88
22-08-2020,thanjavur,880,109,82,2,905,5435,109,22,0,5566,4573,88
22-08-2020,theni,2258,144,223,1,2178,11089,144,42,0,11275,8970,127
22-08-2020,thirupathur,563,73,33,1,602,2285,73,109,0,2467,1814,51
22-08-2020,thiruvallur,3905,384,384,2,3903,21730,384,8,0,22122,17851,368
22-08-2020,thiruvannamalai,915,87,127,3,872,8811,86,377,1,9275,8264,139
22-08-2020,thiruvarur,485,75,33,0,527,2643,75,37,0,2755,2196,32
22-08-2020,thoothukudi,639,120,147,2,610,10183,111,241,9,10544,9837,97
22-08-2020,tirunelveli,1310,140,158,5,1287,7780,140,420,0,8340,6909,144
22-08-2020,tiruppur,599,70,58,1,610,1867,70,10,0,1947,1284,53
22-08-2020,trichy,1015,120,161,4,970,6431,120,9,0,6560,5488,102
22-08-2020,vellore,1110,244,123,3,1228,9057,241,76,3,9377,8017,132
22-08-2020,villupuram,602,133,58,4,673,5601,133,163,0,5897,5166,58
22-08-2020,virudhunagar,617,39,50,2,604,11742,39,104,0,11885,11114,167
22-08-2020,airport surveillance (international),39,5,0,0,44,0,0,891,5,896,851,1
22-08-2020,airport surveillance (domestic),62,0,7,0,55,0,0,765,0,765,710,0
22-08-2020,railway surveillance,4,0,0,0,4,0,0,428,0,428,424,0
23-08-2020,ariyalur,541,64,71,0,534,2145,64,19,0,2228,1670,24
23-08-2020,chengalpattu,2638,352,483,4,2503,23141,352,5,0,23498,20619,376
23-08-2020,chennai,12984,1298,1040,19,13223,124067,1298,24,0,125389,109585,2581
23-08-2020,coimbatore,3152,392,444,2,3098,11321,392,38,0,11751,8416,237
23-08-2020,cuddalore,2938,380,238,2,3078,8201,380,202,0,8783,5606,99
23-08-2020,dharmapuri,200,12,11,0,201,923,11,198,1,1133,921,11
23-08-2020,dindigul,899,178,69,3,1005,5483,178,76,0,5737,4621,111
23-08-2020,erode,917,45,73,2,887,1981,37,45,8,2071,1152,32
23-08-2020,kallakurichi,621,93,83,1,630,4888,93,404,0,5385,4697,58
23-08-2020,kancheepuram,2316,222,238,3,2297,15289,222,3,0,15514,13013,204
23-08-2020,kanyakumari,1498,181,177,1,1501,8253,181,104,0,8538,6893,144
23-08-2020,karur,361,49,25,1,384,1205,49,45,0,1299,891,24
23-08-2020,krishnagiri,287,19,12,0,294,1642,19,148,0,1809,1488,27
23-08-2020,madurai,921,105,48,3,975,13187,102,141,3,13433,12123,335
23-08-2020,nagapattinam,611,22,56,1,576,1789,22,78,0,1889,1284,29
23-08-2020,namakkal,427,47,59,0,415,1431,46,79,1,1557,1113,29
23-08-2020,nilgiris,230,87,38,3,276,1222,87,16,0,1325,1041,8
23-08-2020,perambalur,226,30,39,1,216,1121,30,2,0,1153,922,15
23-08-2020,pudukottai,1388,155,170,0,1373,4881,155,32,0,5068,3623,72
23-08-2020,ramanathapuram,530,38,61,0,507,4214,38,133,0,4385,3781,97
23-08-2020,ranipet,1075,155,181,2,1047,9135,155,49,0,9339,8186,106
23-08-2020,salem,2417,261,231,8,2439,7282,260,399,1,7942,5393,110
23-08-2020,sivagangai,331,43,52,3,319,3631,43,60,0,3734,3314,101
23-08-2020,tenkasi,1164,140,261,3,1040,4562,140,49,0,4751,3620,91
23-08-2020,thanjavur,905,116,182,3,836,5544,116,22,0,5682,4755,91
23-08-2020,theni,2178,170,265,7,2076,11233,170,42,0,11445,9235,134
23-08-2020,thirupathur,603,53,52,1,603,2359,53,109,0,2521,1866,52
23-08-2020,thiruvallur,3879,354,378,5,3850,22091,354,8,0,22453,18229,374
23-08-2020,thiruvannamalai,873,100,125,0,848,8898,100,378,0,9376,8389,139
23-08-2020,thiruvarur,527,29,55,3,498,2718,29,37,0,2784,2251,35
23-08-2020,thoothukudi,609,91,112,0,588,10294,89,250,2,10635,9949,98
23-08-2020,tirunelveli,1277,158,139,4,1292,7909,158,420,0,8487,7048,147
23-08-2020,tiruppur,608,75,54,0,629,1935,75,10,0,2020,1338,53
23-08-2020,trichy,973,97,105,3,962,6554,96,9,1,6660,5593,105
23-08-2020,vellore,1227,180,219,6,1182,9297,178,79,2,9556,8236,138
23-08-2020,villupuram,672,160,95,0,737,5734,160,163,0,6057,5261,59
23-08-2020,virudhunagar,604,10,106,3,505,11781,10,104,0,11895,11220,170
23-08-2020,airport surveillance (international),44,0,0,0,44,0,0,896,0,896,851,1
23-08-2020,airport surveillance (domestic),55,14,0,0,69,0,0,765,14,779,710,0
23-08-2020,railway surveillance,4,0,0,0,4,0,0,428,0,428,424,0
26-08-2020,ariyalur,507,44,35,2,514,2315,44,19,0,2378,1837,27
26-08-2020,chengalpattu,2571,294,319,4,2542,24129,294,5,0,24428,21500,386
26-08-2020,chennai,13384,1290,1137,20,13517,127932,1287,25,3,129247,113092,2638
26-08-2020,coimbatore,3135,484,359,10,3250,12430,484,40,0,12954,9442,262
26-08-2020,cuddalore,3102,286,333,2,3053,9326,286,202,0,9814,6654,107
26-08-2020,dharmapuri,146,36,10,0,172,948,33,199,3,1183,1000,11
26-08-2020,dindigul,906,37,110,2,831,5914,37,76,0,6027,5079,117
26-08-2020,erode,1065,102,92,5,1070,2341,102,55,0,2498,1390,38
26-08-2020,kallakurichi,588,78,53,0,613,5083,78,404,0,5565,4890,62
26-08-2020,kancheepuram,2155,329,219,8,2257,15963,329,3,0,16295,13813,225
26-08-2020,kanyakumari,1480,159,149,5,1485,8731,159,104,0,8994,7352,157
26-08-2020,karur,369,32,39,1,361,1307,32,45,0,1384,998,25
26-08-2020,krishnagiri,327,33,37,0,323,1761,33,150,0,1944,1593,28
26-08-2020,madurai,1001,31,94,1,937,13444,31,146,0,13621,12343,341
26-08-2020,nagapattinam,747,84,54,0,777,2029,84,78,0,2191,1384,30
26-08-2020,namakkal,440,70,28,0,482,1588,70,81,0,1739,1224,33
26-08-2020,nilgiris,379,4,41,1,341,1452,4,16,0,1472,1121,10
26-08-2020,perambalur,198,18,31,0,185,1201,18,2,0,1221,1020,16
26-08-2020,pudukottai,1341,143,181,4,1299,5342,143,32,0,5517,4135,83
26-08-2020,ramanathapuram,489,39,58,3,467,4351,39,133,0,4523,3955,101
26-08-2020,ranipet,1154,121,120,2,1153,9598,121,49,0,9768,8504,111
26-08-2020,salem,2617,451,222,8,2838,8115,451,400,0,8966,6005,123
26-08-2020,sivagangai,300,18,68,1,249,3763,18,60,0,3841,3488,104
26-08-2020,tenkasi,927,98,90,3,932,4890,98,49,0,5037,4006,99
26-08-2020,thanjavur,790,123,112,6,795,5841,123,22,0,5986,5085,106
26-08-2020,theni,1982,184,222,2,1942,11822,184,42,0,12048,9968,138
26-08-2020,thirupathur,596,56,96,0,556,2508,56,109,0,2673,2062,55
26-08-2020,thiruvallur,1802,280,304,2,1776,23043,280,8,0,23331,21172,383
26-08-2020,thiruvannamalai,822,58,124,3,753,9242,58,380,0,9680,8777,150
26-08-2020,thiruvarur,539,105,37,2,605,2920,105,37,0,3062,2418,39
26-08-2020,thoothukudi,671,105,22,2,752,10552,105,252,0,10909,10050,107
26-08-2020,tirunelveli,1278,156,145,6,1283,8335,156,420,0,8911,7464,164
26-08-2020,tiruppur,659,97,182,3,571,2134,97,10,0,2241,1613,57
26-08-2020,trichy,946,83,119,0,910,6864,83,10,0,6957,5936,111
26-08-2020,vellore,1227,158,141,5,1239,9767,155,83,3,10008,8622,147
26-08-2020,villupuram,951,189,115,1,1024,6235,187,171,2,6595,5507,64
26-08-2020,virudhunagar,412,79,94,4,393,11945,79,104,0,12128,11552,183
26-08-2020,airport surveillance (international),47,0,6,0,41,0,0,899,0,899,857,1
26-08-2020,airport surveillance (domestic),74,4,8,0,70,0,0,794,4,798,728,0
26-08-2020,railway surveillance,4,0,0,0,4,0,0,428,0,428,424,0
27-08-2020,ariyalur,514,74,95,1,492,2359,74,19,0,2452,1932,28
27-08-2020,chengalpattu,2563,298,263,8,2590,24446,298,5,0,24749,21763,396
27-08-2020,chennai,13552,1286,1356,32,13450,129250,1281,28,5,130564,114448,2666
27-08-2020,coimbatore,3254,439,357,11,3325,12919,439,40,0,13398,9799,274
27-08-2020,cuddalore,3054,261,406,0,2909,9613,261,202,0,10076,7060,107
27-08-2020,dharmapuri,172,1,17,2,154,981,1,202,0,1184,1017,13
27-08-2020,dindigul,826,102,181,1,746,5946,102,76,0,6124,5260,118
27-08-2020,erode,1072,121,36,0,1157,2444,121,55,0,2620,1426,37
27-08-2020,kallakurichi,610,73,98,2,583,5158,73,404,0,5635,4988,64
27-08-2020,kancheepuram,2236,256,193,3,2296,16271,256,3,0,16530,14006,228
27-08-2020,kanyakumari,1481,104,66,2,1517,8886,104,104,0,9094,7418,159
27-08-2020,karur,362,33,28,0,367,1340,33,45,0,1418,1026,25
27-08-2020,krishnagiri,323,32,25,0,330,1795,30,150,2,1977,1618,29
27-08-2020,madurai,928,73,103,4,894,13466,71,146,2,13685,12446,345
27-08-2020,nagapattinam,779,90,183,4,682,2115,90,78,0,2283,1567,34
27-08-2020,namakkal,480,84,33,1,530,1656,82,81,2,1821,1257,34
27-08-2020,nilgiris,341,25,48,0,318,1456,25,16,0,1497,1169,10
27-08-2020,perambalur,185,19,28,1,175,1219,19,2,0,1240,1048,17
27-08-2020,pudukottai,1300,136,150,2,1284,5486,136,32,0,5654,4285,85
27-08-2020,ramanathapuram,468,75,37,0,506,4391,75,133,0,4599,3992,101
27-08-2020,ranipet,1154,162,106,3,1207,9720,162,49,0,9931,8610,114
27-08-2020,salem,2840,413,217,5,3031,8566,413,400,0,9379,6222,126
27-08-2020,sivagangai,251,64,26,0,289,3783,64,60,0,3907,3514,104
27-08-2020,tenkasi,938,55,23,0,970,4995,55,49,0,5099,4029,100
27-08-2020,thanjavur,795,122,124,1,792,5964,122,22,0,6108,5209,107
27-08-2020,theni,1943,130,202,1,1870,12007,130,42,0,12179,10170,139
27-08-2020,thirupathur,552,42,79,1,514,2560,42,109,0,2711,2141,56
27-08-2020,thiruvallur,1747,323,482,13,1575,23296,323,8,0,23627,21654,398
27-08-2020,thiruvannamalai,754,99,81,1,771,9301,99,380,0,9780,8858,151
27-08-2020,thiruvarur,604,95,138,2,559,3024,95,37,0,3156,2556,41
27-08-2020,thoothukudi,756,95,32,0,819,10661,95,252,0,11008,10082,107
27-08-2020,tirunelveli,1272,118,82,2,1306,8480,118,420,0,9018,7546,166
27-08-2020,tiruppur,571,96,31,2,634,2231,96,10,0,2337,1644,59
27-08-2020,trichy,912,113,97,2,926,6949,112,10,1,7072,6033,113
27-08-2020,vellore,1237,161,187,1,1210,9920,159,86,2,10167,8809,148
27-08-2020,villupuram,1027,144,175,0,996,6425,143,173,1,6742,5682,64
27-08-2020,virudhunagar,394,152,38,1,507,12025,152,104,0,12281,11590,184
27-08-2020,airport surveillance (international),41,5,24,0,22,0,0,899,5,904,881,1
27-08-2020,airport surveillance (domestic),70,10,23,0,57,0,0,798,10,808,751,0
27-08-2020,railway surveillance,4,0,0,0,4,0,0,428,0,428,424,0
28-08-2020,ariyalur,492,67,80,2,477,2433,67,19,0,2519,2012,30
28-08-2020,chengalpattu,2601,296,334,6,2557,24757,296,5,0,25058,22097,404
28-08-2020,chennai,13463,1296,1201,28,13530,130540,1296,33,0,131869,115649,2690
28-08-2020,coimbatore,3328,496,438,6,3380,13361,496,40,0,13897,10237,280
28-08-2020,cuddalore,2911,256,280,8,2879,9876,256,202,0,10334,7340,115
28-08-2020,dharmapuri,154,16,26,0,144,982,16,202,0,1200,1043,13
28-08-2020,dindigul,744,96,161,3,676,6046,96,76,0,6218,5421,121
28-08-2020,erode,1146,126,57,1,1214,2554,126,55,0,2735,1483,38
28-08-2020,kallakurichi,579,77,64,2,590,5227,77,404,0,5708,5052,66
28-08-2020,kancheepuram,2274,194,227,0,2241,16506,194,3,0,16703,14233,229
28-08-2020,kanyakumari,1517,81,205,5,1388,8990,79,104,2,9175,7623,164
28-08-2020,karur,368,35,33,0,370,1374,35,45,0,1454,1059,25
28-08-2020,krishnagiri,330,29,27,0,332,1825,29,152,0,2006,1645,29
28-08-2020,madurai,894,103,124,5,868,13537,103,148,0,13788,12570,350
28-08-2020,nagapattinam,682,56,23,2,713,2205,56,78,0,2339,1590,36
28-08-2020,namakkal,537,89,88,2,536,1745,89,83,0,1917,1345,36
28-08-2020,nilgiris,319,38,51,0,306,1482,38,16,0,1536,1220,10
28-08-2020,perambalur,175,9,45,0,139,1238,9,2,0,1249,1093,17
28-08-2020,pudukottai,1284,97,112,3,1266,5622,97,32,0,5751,4397,88
28-08-2020,ramanathapuram,506,29,48,2,485,4466,29,133,0,4628,4040,103
28-08-2020,ranipet,1208,137,292,1,1052,9883,137,49,0,10069,8902,115
28-08-2020,salem,3030,437,301,3,3163,8978,432,400,5,9815,6523,129
28-08-2020,sivagangai,289,55,38,2,304,3847,55,60,0,3962,3552,106
28-08-2020,tenkasi,967,61,83,1,944,5047,61,49,0,5157,4112,101
28-08-2020,thanjavur,790,132,138,2,782,6084,132,22,0,6238,5347,109
28-08-2020,theni,1870,114,171,1,1812,12137,114,42,0,12293,10341,140
28-08-2020,thirupathur,514,48,80,1,481,2602,48,109,0,2759,2221,57
28-08-2020,thiruvallur,1575,298,52,4,1817,23620,298,8,0,23926,21706,403
28-08-2020,thiruvannamalai,774,205,104,3,872,9403,203,380,2,9988,8962,154
28-08-2020,thiruvarur,559,120,67,0,612,3119,120,37,0,3276,2623,41
28-08-2020,thoothukudi,820,103,61,3,859,10757,102,252,1,11112,10143,110
28-08-2020,tirunelveli,1308,128,135,1,1300,8600,128,420,0,9148,7681,167
28-08-2020,tiruppur,635,120,66,3,686,2328,120,10,0,2458,1710,62
28-08-2020,trichy,927,85,96,0,916,7062,85,11,0,7158,6129,113
28-08-2020,vellore,1206,157,128,0,1235,10075,156,88,1,10320,8937,148
28-08-2020,villupuram,998,152,183,0,967,6570,152,174,0,6896,5865,64
28-08-2020,virudhunagar,507,152,130,2,527,12177,152,104,0,12433,11720,186
28-08-2020,airport surveillance (international),22,0,0,0,22,0,0,904,0,904,881,1
28-08-2020,airport surveillance (domestic),57,6,3,0,60,0,0,808,6,814,754,0
28-08-2020,railway surveillance,4,0,0,0,4,0,0,428,0,428,424,0
29-08-2020,ariyalur,477,60,65,1,471,2500,60,19,0,2579,2077,31
29-08-2020,chengalpattu,2556,306,257,4,2601,25055,306,5,0,25366,22354,411
29-08-2020,chennai,13544,1285,1159,17,13653,131855,1285,33,0,133173,116808,2712
29-08-2020,coimbatore,3385,491,345,9,3522,13862,491,40,0,14393,10582,289
29-08-2020,cuddalore,2880,420,157,1,3142,10133,420,202,0,10755,7497,116
29-08-2020,dharmapuri,144,18,33,0,129,998,18,202,0,1218,1076,13
29-08-2020,dindigul,674,129,28,2,773,6140,129,76,0,6345,5449,123
29-08-2020,erode,1214,156,54,1,1315,2680,148,55,8,2891,1537,39
29-08-2020,kallakurichi,590,82,66,3,603,5304,82,404,0,5790,5118,69
29-08-2020,kancheepuram,2244,241,479,3,2003,16706,241,3,0,16950,14712,235
29-08-2020,kanyakumari,1388,161,271,6,1272,9069,160,106,1,9336,7894,170
29-08-2020,karur,370,30,25,0,375,1409,30,45,0,1484,1084,25
29-08-2020,krishnagiri,332,40,44,0,328,1854,40,152,0,2046,1689,29
29-08-2020,madurai,859,115,114,4,856,13631,115,148,0,13894,12684,354
29-08-2020,nagapattinam,713,101,52,1,761,2261,99,78,2,2440,1642,37
29-08-2020,namakkal,535,70,78,0,527,1833,70,83,0,1986,1423,36
29-08-2020,nilgiris,304,17,14,0,307,1518,17,16,0,1551,1234,10
29-08-2020,perambalur,139,19,14,0,144,1247,19,2,0,1268,1107,17
29-08-2020,pudukottai,1266,124,103,2,1285,5719,124,32,0,5875,4500,90
29-08-2020,ramanathapuram,487,35,41,0,481,4497,35,133,0,4665,4081,103
29-08-2020,ranipet,1021,151,242,2,928,9989,151,49,0,10189,9144,117
29-08-2020,salem,3164,432,359,5,3232,9411,432,405,0,10248,6882,134
29-08-2020,sivagangai,302,35,58,0,279,3900,35,60,0,3995,3610,106
29-08-2020,tenkasi,945,75,55,1,964,5109,75,49,0,5233,4167,102
29-08-2020,thanjavur,782,134,103,1,812,6217,134,22,0,6373,5450,111
29-08-2020,theni,1814,125,382,1,1556,12253,125,42,0,12420,10723,141
29-08-2020,thirupathur,482,30,40,1,471,2651,30,109,0,2790,2261,58
29-08-2020,thiruvallur,1810,284,436,3,1655,23899,284,8,0,24191,22142,394
29-08-2020,thiruvannamalai,879,152,1,2,1028,9613,152,382,0,10147,8963,156
29-08-2020,thiruvarur,620,102,32,1,689,3247,102,37,0,3386,2655,42
29-08-2020,thoothukudi,859,89,98,1,849,10859,89,253,0,11201,10241,111
29-08-2020,tirunelveli,1299,154,151,3,1299,8727,154,420,0,9301,7832,170
29-08-2020,tiruppur,685,100,26,2,757,2447,100,10,0,2557,1736,64
29-08-2020,trichy,917,102,107,2,910,7148,102,11,0,7261,6236,115
29-08-2020,vellore,1244,178,295,6,1121,10240,175,89,3,10507,9232,154
29-08-2020,villupuram,969,171,145,1,994,6724,171,174,0,7069,6010,65
29-08-2020,virudhunagar,527,126,114,1,538,12329,126,104,0,12559,11834,187
29-08-2020,airport surveillance (international),22,6,0,0,28,0,0,904,6,910,881,1
29-08-2020,airport surveillance (domestic),60,6,2,0,64,0,0,814,6,820,756,0
29-08-2020,railway surveillance,4,0,0,0,4,0,0,428,0,428,424,0
30-08-2020,ariyalur,473,89,88,0,474,2562,89,19,0,2670,2165,31
30-08-2020,chengalpattu,2579,419,382,8,2608,25339,419,5,0,25763,22736,419
30-08-2020,chennai,13666,1249,1427,16,13472,133154,1248,33,1,134436,118235,2729
30-08-2020,coimbatore,3525,498,451,5,3567,14356,498,40,0,14894,11033,294
30-08-2020,cuddalore,3144,383,483,5,3039,10555,383,202,0,11140,7980,121
30-08-2020,dharmapuri,129,14,3,0,140,1016,14,202,0,1232,1079,13
30-08-2020,dindigul,774,88,51,2,809,6270,88,76,0,6434,5500,125
30-08-2020,erode,1315,158,185,1,1287,2828,148,63,10,3049,1722,40
30-08-2020,kallakurichi,602,228,78,4,748,5385,228,404,0,6017,5196,73
30-08-2020,kancheepuram,2014,193,223,5,1979,16959,193,3,0,17155,14935,241
30-08-2020,kanyakumari,1274,122,123,3,1270,9231,122,107,0,9460,8017,173
30-08-2020,karur,379,49,53,0,375,1443,49,45,0,1537,1137,25
30-08-2020,krishnagiri,328,69,26,1,370,1894,69,152,0,2115,1715,30
30-08-2020,madurai,858,134,129,3,860,13748,131,148,3,14030,12813,357
30-08-2020,nagapattinam,763,135,69,3,826,2362,135,80,0,2577,1711,40
30-08-2020,namakkal,522,70,36,1,555,1898,69,83,1,2051,1459,37
30-08-2020,nilgiris,304,36,22,0,318,1532,36,16,0,1584,1256,10
30-08-2020,perambalur,145,23,19,0,149,1267,23,2,0,1292,1126,17
30-08-2020,pudukottai,1287,108,95,3,1297,5845,108,32,0,5985,4595,93
30-08-2020,ramanathapuram,480,23,49,1,453,4531,23,133,0,4687,4130,104
30-08-2020,ranipet,928,196,267,1,856,10140,196,49,0,10385,9411,118
30-08-2020,salem,3238,329,274,9,3284,9849,326,405,3,10583,7156,143
30-08-2020,sivagangai,279,33,41,1,270,3935,33,60,0,4028,3651,107
30-08-2020,tenkasi,965,84,97,0,952,5185,84,49,0,5318,4264,102
30-08-2020,thanjavur,816,117,93,3,837,6355,117,22,0,6494,5543,114
30-08-2020,theni,1559,176,216,0,1519,12381,176,42,0,12599,10939,141
30-08-2020,thirupathur,471,34,32,3,470,2681,34,109,0,2824,2293,61
30-08-2020,thiruvallur,1648,293,192,4,1745,24174,293,8,0,24475,22334,396
30-08-2020,thiruvannamalai,1029,168,136,1,1060,9766,168,382,0,10316,9099,157
30-08-2020,thiruvarur,689,95,165,0,619,3349,95,37,0,3481,2820,42
30-08-2020,thoothukudi,853,91,77,0,867,10952,91,253,0,11296,10318,111
30-08-2020,tirunelveli,1296,139,149,2,1284,8878,139,420,0,9437,7981,172
30-08-2020,tiruppur,756,93,53,1,795,2546,93,10,0,2649,1789,65
30-08-2020,trichy,891,138,110,4,915,7231,138,11,0,7380,6346,119
30-08-2020,vellore,1118,167,186,3,1096,10412,166,92,1,10671,9418,157
30-08-2020,villupuram,995,183,176,0,1002,6896,183,174,0,7253,6186,65
30-08-2020,virudhunagar,538,63,150,1,450,12455,63,104,0,12622,11984,188
30-08-2020,airport surveillance (international),28,1,0,0,29,0,0,910,1,911,881,1
30-08-2020,airport surveillance (domestic),64,7,0,0,71,0,0,820,7,827,756,0
30-08-2020,railway surveillance,4,0,0,0,4,0,0,428,0,428,424,0
31-08-2020,ariyalur,475,75,67,0,483,2652,75,19,0,2746,2232,31
31-08-2020,chengalpattu,2607,347,208,2,2744,25757,347,5,0,26109,22944,421
31-08-2020,chennai,13484,1150,1391,19,13224,134413,1150,34,0,135597,119626,2747
31-08-2020,coimbatore,3574,589,436,14,3713,14861,589,40,0,15490,11469,308
31-08-2020,cuddalore,3041,307,278,2,3068,10940,307,202,0,11449,8258,123
31-08-2020,dharmapuri,141,16,7,0,150,1031,15,202,1,1249,1086,13
31-08-2020,dindigul,805,129,39,1,894,6353,129,76,0,6558,5539,125
31-08-2020,erode,1288,127,138,2,1275,2977,123,73,4,3177,1860,42
31-08-2020,kallakurichi,748,66,70,0,744,5613,66,404,0,6083,5266,73
31-08-2020,kancheepuram,1988,187,259,8,1908,17161,187,3,0,17351,15194,249
31-08-2020,kanyakumari,1270,98,261,1,1106,9353,98,107,0,9558,8278,174
31-08-2020,karur,376,47,42,0,381,1493,47,45,0,1585,1179,25
31-08-2020,krishnagiri,372,11,25,0,358,1965,11,152,0,2128,1740,30
31-08-2020,madurai,855,127,118,1,863,13874,127,151,0,14152,12931,358
31-08-2020,nagapattinam,831,105,48,2,886,2502,105,80,0,2687,1759,42
31-08-2020,namakkal,555,92,49,0,598,1968,90,84,2,2144,1508,38
31-08-2020,nilgiris,318,30,21,0,327,1568,30,16,0,1614,1277,10
31-08-2020,perambalur,150,10,27,0,133,1291,10,2,0,1303,1153,17
31-08-2020,pudukottai,1297,86,112,4,1267,5953,85,32,1,6071,4707,97
31-08-2020,ramanathapuram,455,29,107,2,375,4556,29,133,0,4718,4237,106
31-08-2020,ranipet,860,124,199,2,783,10340,124,49,0,10513,9610,120
31-08-2020,salem,3278,497,390,3,3382,10169,496,408,1,11074,7546,146
31-08-2020,sivagangai,269,26,47,0,248,3967,26,60,0,4053,3698,107
31-08-2020,tenkasi,956,94,80,1,969,5273,94,49,0,5416,4344,103
31-08-2020,thanjavur,828,125,93,2,858,6463,125,22,0,6610,5636,116
31-08-2020,theni,1519,77,171,0,1425,12557,75,42,2,12676,11110,141
31-08-2020,thirupathur,471,47,52,0,466,2716,47,109,0,2872,2345,61
31-08-2020,thiruvallur,1738,299,277,6,1754,24460,299,8,0,24767,22611,402
31-08-2020,thiruvannamalai,1060,140,87,5,1108,9935,140,382,0,10457,9186,163
31-08-2020,thiruvarur,611,113,22,1,701,3436,113,37,0,3586,2842,43
31-08-2020,thoothukudi,869,111,63,1,916,11045,110,253,1,11409,10381,112
31-08-2020,tirunelveli,1278,106,135,1,1248,9011,106,420,0,9537,8116,173
31-08-2020,tiruppur,795,70,72,0,793,2639,70,10,0,2719,1861,65
31-08-2020,trichy,918,95,122,1,890,7372,95,11,0,7478,6468,120
31-08-2020,vellore,1085,125,161,8,1041,10567,119,93,6,10785,9579,165
31-08-2020,villupuram,1002,176,186,1,991,7079,176,174,0,7429,6372,66
31-08-2020,virudhunagar,450,90,145,1,394,12518,90,104,0,12712,12129,189
31-08-2020,airport surveillance (international),29,7,0,0,36,0,0,911,7,918,881,1
31-08-2020,airport surveillance (domestic),71,6,1,0,76,0,0,827,6,833,757,0
31-08-2020,railway surveillance,4,0,2,0,2,0,0,428,0,428,426,0
01-09-2020,ariyalur,485,71,108,0,448,2729,70,19,1,2819,2340,31
01-09-2020,chengalpattu,2760,384,340,9,2795,26120,384,5,0,26509,23284,430
01-09-2020,chennai,13239,1084,1194,22,13107,135579,1083,34,1,136697,120820,2770
01-09-2020,coimbatore,3717,581,392,2,3904,15454,577,40,4,16075,11861,310
01-09-2020,cuddalore,3070,286,374,2,2980,11249,286,202,0,11737,8632,125
01-09-2020,dharmapuri,145,10,24,0,131,1041,8,203,2,1254,1110,13
01-09-2020,dindigul,894,111,140,2,863,6482,111,76,0,6669,5679,127
01-09-2020,erode,1272,90,180,1,1181,3097,90,77,0,3264,2040,43
01-09-2020,kallakurichi,740,209,58,3,888,5675,209,404,0,6288,5324,76
01-09-2020,kancheepuram,1892,191,224,2,1857,17332,191,3,0,17526,15418,251
01-09-2020,kanyakumari,1105,153,334,2,922,9450,153,107,0,9710,8612,176
01-09-2020,karur,381,33,23,1,390,1540,33,45,0,1618,1202,26
01-09-2020,krishnagiri,354,63,34,0,383,1972,62,152,1,2187,1774,30
01-09-2020,madurai,863,128,90,1,900,14000,128,151,0,14279,13021,358
01-09-2020,nagapattinam,888,85,93,0,880,2609,79,80,6,2774,1852,42
01-09-2020,namakkal,600,74,72,1,601,2060,74,86,0,2220,1580,39
01-09-2020,nilgiris,320,46,33,0,333,1591,46,16,0,1653,1310,10
01-09-2020,perambalur,133,33,34,0,132,1301,33,2,0,1336,1187,17
01-09-2020,pudukottai,1268,95,153,4,1206,6039,95,33,0,6167,4860,101
01-09-2020,ramanathapuram,375,40,40,1,374,4585,40,133,0,4758,4277,107
01-09-2020,ranipet,790,182,90,4,878,10471,182,49,0,10702,9700,124
01-09-2020,salem,3385,335,181,10,3529,10668,335,409,0,11412,7727,156
01-09-2020,sivagangai,247,37,41,1,242,3992,37,60,0,4089,3739,108
01-09-2020,tenkasi,969,49,81,1,936,5367,49,49,0,5465,4425,104
01-09-2020,thanjavur,853,132,126,1,858,6583,132,22,0,6737,5762,117
01-09-2020,theni,1424,55,145,3,1331,12632,54,44,1,12731,11255,145
01-09-2020,thirupathur,465,39,41,0,463,2762,39,109,0,2910,2386,61
01-09-2020,thiruvallur,1743,296,517,8,1514,24747,296,8,0,25051,23128,409
01-09-2020,thiruvannamalai,1110,154,100,3,1161,10077,154,382,0,10613,9286,166
01-09-2020,thiruvarur,702,99,100,2,699,3550,99,37,0,3686,2942,45
01-09-2020,thoothukudi,917,65,97,1,884,11156,64,254,1,11475,10478,113
01-09-2020,tirunelveli,1247,152,149,2,1248,9116,152,420,0,9688,8265,175
01-09-2020,tiruppur,799,87,22,1,863,2715,87,10,0,2812,1883,66
01-09-2020,trichy,889,98,92,0,895,7466,96,11,2,7575,6560,120
01-09-2020,vellore,1038,137,151,4,1020,10683,136,99,1,10919,9730,169
01-09-2020,villupuram,991,166,97,1,1059,7255,166,174,0,7595,6469,67
01-09-2020,virudhunagar,394,67,61,1,399,12608,67,104,0,12779,12190,190
01-09-2020,airport surveillance (international),36,1,0,0,37,0,0,918,1,919,881,1
01-09-2020,airport surveillance (domestic),76,10,0,0,86,0,0,833,10,843,757,0
01-09-2020,railway surveillance,2,0,0,0,2,0,0,428,0,428,426,0
02-09-2020,ariyalur,448,43,78,0,413,2799,43,20,0,2862,2418,31
02-09-2020,chengalpattu,2802,390,396,8,2788,26512,390,5,0,26907,23680,439
02-09-2020,chennai,13118,1025,1587,19,12537,136672,1025,35,0,137732,122407,2788
02-09-2020,coimbatore,3912,579,217,5,4269,16039,579,44,0,16662,12078,315
02-09-2020,cuddalore,2982,405,404,2,2981,11538,405,202,0,12145,9036,128
02-09-2020,dharmapuri,132,54,18,0,168,1050,53,205,1,1309,1128,13
02-09-2020,dindigul,860,136,104,2,890,6590,135,76,1,6802,5783,129
02-09-2020,erode,1170,106,145,1,1130,3176,106,77,0,3359,2185,44
02-09-2020,kallakurichi,889,54,69,3,871,5885,54,404,0,6343,5393,79
02-09-2020,kancheepuram,1861,133,230,5,1759,17527,133,3,0,17663,15648,256
02-09-2020,kanyakumari,922,111,23,9,1001,9603,109,107,2,9821,8635,185
02-09-2020,karur,390,64,22,0,432,1573,64,45,0,1682,1224,26
02-09-2020,krishnagiri,383,49,24,2,406,2034,48,153,1,2236,1798,32
02-09-2020,madurai,884,123,201,2,804,14112,123,151,0,14386,13222,360
02-09-2020,nagapattinam,879,71,125,2,823,2688,70,86,1,2845,1977,45
02-09-2020,namakkal,596,83,44,0,635,2129,83,86,0,2298,1624,39
02-09-2020,nilgiris,333,14,29,1,317,1637,14,16,0,1667,1339,11
02-09-2020,perambalur,133,10,36,0,107,1335,10,2,0,1347,1223,17
02-09-2020,pudukottai,1208,76,157,1,1126,6136,76,33,0,6245,5017,102
02-09-2020,ramanathapuram,374,57,38,0,393,4625,57,133,0,4815,4315,107
02-09-2020,ranipet,874,98,104,1,867,10649,98,49,0,10796,9804,125
02-09-2020,salem,3540,403,215,4,3724,11014,402,409,1,11826,7942,160
02-09-2020,sivagangai,242,25,17,1,249,4029,25,60,0,4114,3756,109
02-09-2020,tenkasi,936,82,276,0,742,5416,82,49,0,5547,4701,104
02-09-2020,thanjavur,860,147,23,0,984,6717,147,22,0,6886,5785,117
02-09-2020,theni,1332,95,173,2,1252,12687,95,45,0,12827,11428,147
02-09-2020,thirupathur,459,94,82,2,469,2797,94,109,0,3000,2468,63
02-09-2020,thiruvallur,1509,285,315,5,1474,25037,285,8,0,25330,23443,413
02-09-2020,thiruvannamalai,1160,213,53,3,1317,10230,213,382,0,10825,9339,169
02-09-2020,thiruvarur,700,133,55,3,775,3649,133,37,0,3819,2997,47
02-09-2020,thoothukudi,884,57,99,1,841,11220,53,255,4,11532,10577,114
02-09-2020,tirunelveli,1246,110,121,3,1232,9266,110,420,0,9796,8386,178
02-09-2020,tiruppur,868,87,58,3,894,2807,87,10,0,2904,1941,69
02-09-2020,trichy,884,120,104,2,898,7551,120,13,0,7684,6664,122
02-09-2020,vellore,1023,159,107,2,1073,10822,155,100,4,11081,9837,171
02-09-2020,villupuram,1061,224,46,3,1236,7423,224,174,0,7821,6515,70
02-09-2020,virudhunagar,400,62,60,1,401,12676,62,104,0,12842,12250,191
02-09-2020,airport surveillance (international),37,2,12,0,27,0,0,919,2,921,893,1
02-09-2020,airport surveillance (domestic),86,11,24,0,73,0,0,843,11,854,781,0
02-09-2020,railway surveillance,2,0,0,0,2,0,0,428,0,428,426,0
03-09-2020,ariyalur,413,47,23,0,437,2842,47,20,0,2909,2441,31
03-09-2020,chengalpattu,2788,378,323,7,2836,26903,378,5,0,27286,24003,447
03-09-2020,chennai,12564,968,1444,29,12059,137721,968,35,0,138724,123851,2814
03-09-2020,coimbatore,4272,593,486,3,4376,16621,593,44,0,17258,12564,318
03-09-2020,cuddalore,2983,590,315,2,3256,11945,590,202,0,12737,9351,130
03-09-2020,dharmapuri,168,21,6,0,183,1103,21,206,0,1330,1134,13
03-09-2020,dindigul,894,133,74,2,951,6729,133,77,0,6939,5857,131
03-09-2020,erode,1126,120,74,1,1171,3278,111,77,9,3475,2259,45
03-09-2020,kallakurichi,871,121,155,2,835,5939,121,404,0,6464,5548,81
03-09-2020,kancheepuram,1764,150,201,2,1711,17665,150,3,0,17818,15849,258
03-09-2020,kanyakumari,1001,92,165,2,926,9712,92,109,0,9913,8800,187
03-09-2020,karur,433,31,96,2,366,1638,31,45,0,1714,1320,28
03-09-2020,krishnagiri,407,85,55,1,436,2083,84,154,1,2322,1853,33
03-09-2020,madurai,786,87,60,0,813,14217,86,151,1,14455,13282,360
03-09-2020,nagapattinam,831,59,38,3,849,2766,58,87,1,2912,2015,48
03-09-2020,namakkal,634,58,111,1,580,2211,58,86,0,2355,1735,40
03-09-2020,nilgiris,309,61,34,1,335,1643,61,16,0,1720,1373,12
03-09-2020,perambalur,107,21,28,0,100,1345,21,2,0,1368,1251,17
03-09-2020,pudukottai,1128,103,187,1,1043,6214,103,33,0,6350,5204,103
03-09-2020,ramanathapuram,395,72,30,0,437,4684,72,133,0,4889,4345,107
03-09-2020,ranipet,863,157,57,2,961,10743,157,49,0,10949,9861,127
03-09-2020,salem,3726,214,350,4,3586,11419,208,410,6,12043,8292,165
03-09-2020,sivagangai,251,29,62,0,218,4056,29,60,0,4145,3818,109
03-09-2020,tenkasi,740,61,140,1,660,5496,61,49,0,5606,4841,105
03-09-2020,thanjavur,988,136,133,2,989,6868,136,22,0,7026,5918,119
03-09-2020,theni,1255,80,211,2,1122,12785,80,45,0,12910,11639,149
03-09-2020,thirupathur,470,66,64,1,471,2892,66,109,0,3067,2532,64
03-09-2020,thiruvallur,1448,258,335,7,1364,25297,258,8,0,25563,23778,421
03-09-2020,thiruvannamalai,1320,146,191,2,1273,10446,140,382,6,10974,9530,171
03-09-2020,thiruvarur,765,89,99,3,752,3772,89,37,0,3898,3096,50
03-09-2020,thoothukudi,843,53,105,0,791,11275,53,259,0,11587,10682,114
03-09-2020,tirunelveli,1232,163,104,2,1289,9376,163,420,0,9959,8490,180
03-09-2020,tiruppur,896,112,52,3,953,2896,112,10,0,3018,1993,72
03-09-2020,trichy,899,114,104,0,909,7672,114,13,0,7799,6768,122
03-09-2020,vellore,1068,141,110,0,1099,10972,136,104,5,11217,9947,171
03-09-2020,villupuram,1236,150,60,2,1324,7647,150,174,0,7971,6575,72
03-09-2020,virudhunagar,404,125,28,2,499,12741,125,104,0,12970,12278,193
03-09-2020,airport surveillance (international),27,0,0,0,27,0,0,921,0,921,893,1
03-09-2020,airport surveillance (domestic),73,8,0,0,81,0,0,854,8,862,781,0
03-09-2020,railway surveillance,2,0,0,0,2,0,0,428,0,428,426,0
04-09-2020,ariyalur,437,58,61,0,434,2889,58,20,0,2967,2502,31
04-09-2020,chengalpattu,2834,370,404,3,2797,27279,370,5,0,27654,24407,450
04-09-2020,chennai,12063,992,1040,12,12003,138693,992,35,0,139720,124891,2826
04-09-2020,coimbatore,4388,595,428,4,4551,17226,595,44,0,17865,12992,322
04-09-2020,cuddalore,3255,499,114,3,3637,12534,499,202,0,13235,9465,133
04-09-2020,dharmapuri,183,41,37,0,187,1124,40,206,1,1371,1171,13
04-09-2020,dindigul,951,93,151,4,889,6862,93,77,0,7032,6008,135
04-09-2020,erode,1162,121,135,0,1148,3380,115,86,6,3587,2394,45
04-09-2020,kallakurichi,835,182,78,2,937,6060,182,404,0,6646,5626,83
04-09-2020,kancheepuram,1712,154,330,4,1532,17816,154,3,0,17973,16179,262
04-09-2020,kanyakumari,928,107,225,1,809,9806,107,109,0,10022,9025,188
04-09-2020,karur,368,42,33,1,376,1671,42,45,0,1758,1353,29
04-09-2020,krishnagiri,432,72,29,0,475,2163,70,155,2,2390,1882,33
04-09-2020,madurai,810,123,52,4,877,14300,123,152,0,14575,13334,364
04-09-2020,nagapattinam,849,98,34,3,910,2824,98,88,0,3010,2049,51
04-09-2020,namakkal,577,75,45,1,606,2266,73,86,2,2427,1780,41
04-09-2020,nilgiris,330,95,52,1,372,1699,95,16,0,1810,1425,13
04-09-2020,perambalur,100,13,11,0,102,1366,13,2,0,1381,1262,17
04-09-2020,pudukottai,1043,102,118,1,1026,6317,102,33,0,6452,5322,104
04-09-2020,ramanathapuram,438,21,70,0,389,4757,21,133,0,4911,4415,107
04-09-2020,ranipet,956,121,184,2,891,10895,121,49,0,11065,10045,129
04-09-2020,salem,3589,239,293,5,3530,11630,238,416,1,12285,8585,170
04-09-2020,sivagangai,216,48,61,0,203,4083,48,60,0,4191,3879,109
04-09-2020,tenkasi,664,85,122,2,625,5561,85,49,0,5695,4963,107
04-09-2020,thanjavur,990,164,172,0,982,7005,164,22,0,7191,6090,119
04-09-2020,theni,1122,84,201,0,1005,12865,84,45,0,12994,11840,149
04-09-2020,thirupathur,473,74,62,1,484,2960,73,109,1,3143,2594,65
04-09-2020,thiruvallur,1368,260,309,6,1313,25559,260,8,0,25827,24087,427
04-09-2020,thiruvannamalai,1274,216,162,3,1325,10587,215,388,1,11191,9692,174
04-09-2020,thiruvarur,752,98,156,2,692,3861,98,37,0,3996,3252,52
04-09-2020,thoothukudi,792,45,79,1,757,11329,44,259,1,11633,10761,115
04-09-2020,tirunelveli,1283,114,169,2,1226,9533,114,420,0,10067,8659,182
04-09-2020,tiruppur,954,90,72,2,970,3009,90,10,0,3109,2065,74
04-09-2020,trichy,909,104,98,0,915,7786,104,13,0,7903,6866,122
04-09-2020,vellore,1100,134,138,1,1095,11109,130,109,4,11352,10085,172
04-09-2020,villupuram,1324,148,379,5,1088,7797,148,174,0,8119,6954,77
04-09-2020,virudhunagar,499,93,222,3,367,12866,93,104,0,13063,12500,196
04-09-2020,airport surveillance (international),27,0,2,0,25,0,0,921,0,921,895,1
04-09-2020,airport surveillance (domestic),81,6,6,0,81,0,0,862,6,868,787,0
04-09-2020,railway surveillance,2,0,0,0,2,0,0,428,0,428,426,0
07-09-2020,ariyalur,401,29,25,3,402,3050,29,20,0,3099,2662,35
07-09-2020,chengalpattu,2723,330,393,3,2657,28306,330,5,0,28641,25524,460
07-09-2020,chennai,11264,949,1052,16,11145,141619,949,35,0,142603,128580,2878
07-09-2020,coimbatore,4796,524,666,4,4650,18911,524,44,0,19479,14497,332
07-09-2020,cuddalore,3742,398,530,5,3605,13858,398,202,0,14458,10706,147
07-09-2020,dharmapuri,256,56,13,2,297,1238,55,207,1,1501,1188,16
07-09-2020,dindigul,991,136,98,1,1028,7201,136,77,0,7414,6246,140
07-09-2020,erode,1147,117,86,0,1178,3748,117,94,0,3959,2731,50
07-09-2020,kallakurichi,1045,189,75,0,1159,6561,189,404,0,7154,5910,85
07-09-2020,kancheepuram,1428,190,245,4,1369,18308,190,3,0,18501,16862,270
07-09-2020,kanyakumari,918,96,156,2,856,10108,96,109,0,10313,9260,197
07-09-2020,karur,350,54,19,0,385,1800,54,45,0,1899,1485,29
07-09-2020,krishnagiri,555,71,32,1,593,2400,71,161,0,2632,2005,34
07-09-2020,madurai,986,106,45,1,1046,14623,105,152,1,14881,13468,367
07-09-2020,nagapattinam,1100,64,133,2,1029,3237,64,88,0,3389,2305,55
07-09-2020,namakkal,609,97,43,2,661,2526,96,88,1,2711,2005,45
07-09-2020,nilgiris,381,36,36,0,381,1881,36,16,0,1933,1538,14
07-09-2020,perambalur,99,13,17,1,94,1416,13,2,0,1431,1319,18
07-09-2020,pudukottai,969,89,98,5,955,6647,89,33,0,6769,5700,114
07-09-2020,ramanathapuram,334,33,30,0,337,4841,33,133,0,5007,4561,109
07-09-2020,ranipet,795,126,111,4,806,11266,126,49,0,11441,10499,136
07-09-2020,salem,3092,185,521,6,2750,12237,185,417,0,12839,9901,188
07-09-2020,sivagangai,202,41,24,2,217,4196,41,60,0,4297,3969,111
07-09-2020,tenkasi,683,65,122,1,625,5763,65,49,0,5877,5143,109
07-09-2020,thanjavur,973,122,12,2,1081,7428,122,22,0,7572,6368,123
07-09-2020,theni,850,88,77,1,860,13113,88,45,0,13246,12235,151
07-09-2020,thirupathur,432,57,54,1,434,3122,57,110,0,3289,2787,68
07-09-2020,thiruvallur,1600,248,85,6,1757,26303,248,8,0,26559,24360,442
07-09-2020,thiruvannamalai,1469,262,169,4,1558,11312,262,389,0,11963,10225,180
07-09-2020,thiruvarur,626,142,81,4,683,4182,142,37,0,4361,3619,59
07-09-2020,thoothukudi,662,91,39,0,714,11478,91,260,0,11829,11000,115
07-09-2020,tirunelveli,1171,81,126,0,1126,9895,81,420,0,10396,9083,187
07-09-2020,tiruppur,1079,194,48,2,1223,3449,194,10,0,3653,2348,82
07-09-2020,trichy,926,112,130,1,907,8110,112,13,0,8235,7204,124
07-09-2020,vellore,1102,147,128,2,1119,11551,145,117,2,11815,10519,177
07-09-2020,villupuram,1148,139,277,0,1010,8221,139,174,0,8534,7445,79
07-09-2020,virudhunagar,465,97,132,1,429,13147,97,104,0,13348,12721,198
07-09-2020,airport surveillance (international),20,0,0,0,20,0,0,922,0,922,901,1
07-09-2020,airport surveillance (domestic),67,2,2,0,67,0,0,876,2,878,811,0
07-09-2020,railway surveillance,2,0,0,0,2,0,0,428,0,428,426,0
09-09-2020,ariyalur,418,44,79,0,383,3128,44,20,0,3192,2773,36
09-09-2020,chengalpattu,2615,237,380,4,2468,28989,237,5,0,29231,26296,467
09-09-2020,chennai,11029,993,1154,14,10854,143567,993,35,0,144595,130831,2910
09-09-2020,coimbatore,4032,445,580,6,3891,19904,445,44,0,20393,16164,338
09-09-2020,cuddalore,3657,344,292,2,3707,14663,344,202,0,15209,11344,158
09-09-2020,dharmapuri,339,114,11,0,442,1351,112,209,2,1674,1216,16
09-09-2020,dindigul,991,96,110,3,974,7424,96,77,0,7597,6477,146
09-09-2020,erode,1073,90,139,0,1024,3988,90,94,0,4172,3096,52
09-09-2020,kallakurichi,1157,114,213,0,1058,6888,114,404,0,7406,6263,85
09-09-2020,kancheepuram,1297,171,182,2,1284,18625,171,3,0,18799,17238,277
09-09-2020,kanyakumari,840,136,125,4,847,10295,136,109,0,10540,9492,201
09-09-2020,karur,401,38,36,1,402,1903,37,45,1,1986,1553,31
09-09-2020,krishnagiri,643,75,49,5,664,2554,75,161,0,2790,2085,41
09-09-2020,madurai,1065,63,67,1,1060,14835,63,153,0,15051,13622,369
09-09-2020,nagapattinam,1009,172,95,1,1085,3325,172,88,0,3585,2442,58
09-09-2020,namakkal,721,93,60,1,753,2706,93,89,0,2888,2088,47
09-09-2020,nilgiris,408,69,60,0,417,1973,69,16,0,2058,1627,14
09-09-2020,perambalur,93,15,15,0,93,1444,15,2,0,1461,1350,18
09-09-2020,pudukottai,881,118,188,0,811,6853,118,33,0,7004,6077,116
09-09-2020,ramanathapuram,334,40,24,1,349,4906,40,133,0,5079,4619,111
09-09-2020,ranipet,841,108,173,0,776,11518,108,49,0,11675,10761,138
09-09-2020,salem,2358,279,588,3,2046,12588,279,417,0,13284,11041,197
09-09-2020,sivagangai,226,37,25,1,237,4285,37,60,0,4382,4031,114
09-09-2020,tenkasi,663,60,40,2,681,5910,60,49,0,6019,5225,113
09-09-2020,thanjavur,1014,131,223,1,921,7669,131,22,0,7822,6777,124
09-09-2020,theni,843,86,142,1,786,13293,86,45,0,13424,12484,154
09-09-2020,thirupathur,447,82,45,1,483,3229,82,110,0,3421,2869,69
09-09-2020,thiruvallur,1803,281,170,9,1905,26833,281,8,0,27122,24762,455
09-09-2020,thiruvannamalai,1663,142,226,3,1576,11822,142,389,0,12353,10592,185
09-09-2020,thiruvarur,841,127,113,2,853,4523,127,37,0,4687,3772,62
09-09-2020,thoothukudi,713,58,83,1,687,11634,58,260,0,11952,11148,117
09-09-2020,tirunelveli,1091,139,136,1,1093,10103,139,420,0,10662,9379,190
09-09-2020,tiruppur,1285,120,120,1,1284,3782,120,10,0,3912,2545,83
09-09-2020,trichy,910,98,90,5,913,8323,98,13,0,8434,7391,130
09-09-2020,vellore,1103,140,237,0,1006,11830,135,119,5,12089,10900,183
09-09-2020,villupuram,809,139,197,1,750,8486,139,174,0,8799,7966,83
09-09-2020,virudhunagar,517,90,49,1,557,13354,90,104,0,13548,12790,201
09-09-2020,airport surveillance (international),16,0,0,0,16,0,0,922,0,922,905,1
09-09-2020,airport surveillance (domestic),65,0,0,0,65,0,0,879,0,879,814,0
09-09-2020,railway surveillance,2,0,0,0,2,0,0,428,0,428,426,0
10-09-2020,ariyalur,388,33,70,1,350,3177,33,20,0,3230,2843,37
10-09-2020,chengalpattu,2465,279,362,2,2380,29223,279,5,0,29507,26658,469
10-09-2020,chennai,10874,991,1009,11,10845,144580,991,35,0,145606,131840,2921
10-09-2020,coimbatore,3897,440,545,2,3790,20355,440,44,0,20839,16709,340
10-09-2020,cuddalore,3708,263,476,6,3489,15008,263,202,0,15473,11820,164
10-09-2020,dharmapuri,440,124,15,0,549,1461,122,211,2,1796,1231,16
10-09-2020,dindigul,971,87,92,0,966,7517,87,77,0,7681,6569,146
10-09-2020,erode,1025,32,90,2,965,4079,32,94,0,4205,3186,54
10-09-2020,kallakurichi,1060,113,252,0,921,7004,113,404,0,7521,6515,85
10-09-2020,kancheepuram,1279,173,202,1,1249,18791,173,3,0,18967,17440,278
10-09-2020,kanyakumari,847,75,138,4,780,10431,75,109,0,10615,9630,205
10-09-2020,karur,407,62,43,0,426,1945,62,46,0,2053,1596,31
10-09-2020,krishnagiri,667,123,64,0,726,2632,123,161,0,2916,2149,41
10-09-2020,madurai,1068,61,137,0,992,14904,61,153,0,15118,13757,369
10-09-2020,nagapattinam,1086,130,145,7,1064,3498,130,88,0,3716,2587,65
10-09-2020,namakkal,746,123,113,1,755,2792,123,89,0,3004,2201,48
10-09-2020,nilgiris,418,69,34,0,453,2043,69,16,0,2128,1661,14
10-09-2020,perambalur,97,29,20,0,106,1463,29,2,0,1494,1370,18
10-09-2020,pudukottai,813,99,115,1,796,6973,99,33,0,7105,6192,117
10-09-2020,ramanathapuram,349,53,29,1,372,4946,53,133,0,5132,4648,112
10-09-2020,ranipet,764,118,101,2,779,11616,118,49,0,11783,10864,140
10-09-2020,salem,2052,300,567,7,1778,12873,300,417,0,13590,11608,204
10-09-2020,sivagangai,234,20,30,0,224,4319,20,60,0,4399,4061,114
10-09-2020,tenkasi,690,64,90,0,664,5979,64,49,0,6092,5315,113
10-09-2020,thanjavur,915,90,197,2,806,7794,90,22,0,7906,6974,126
10-09-2020,theni,789,95,80,0,804,13380,95,45,0,13520,12562,154
10-09-2020,thirupathur,483,85,78,1,489,3311,85,110,0,3506,2947,70
10-09-2020,thiruvallur,1904,296,129,4,2067,27112,296,8,0,27416,24890,459
10-09-2020,thiruvannamalai,1584,81,144,2,1519,11972,81,389,0,12442,10736,187
10-09-2020,thiruvarur,855,127,85,1,896,4652,127,37,0,4816,3857,63
10-09-2020,thoothukudi,689,112,92,1,708,11694,112,260,0,12066,11240,118
10-09-2020,tirunelveli,1082,123,111,2,1092,10231,123,420,0,10774,9490,192
10-09-2020,tiruppur,1283,155,105,0,1333,3901,155,10,0,4066,2650,83
10-09-2020,trichy,889,130,95,0,924,8397,130,13,0,8540,7486,130
10-09-2020,vellore,999,152,122,3,1026,11958,149,124,3,12234,11022,186
10-09-2020,villupuram,753,189,171,0,771,8627,189,174,0,8990,8136,83
10-09-2020,virudhunagar,550,31,37,0,544,13441,31,104,0,13576,12831,201
10-09-2020,airport surveillance (international),16,0,0,0,16,0,0,922,0,922,905,1
10-09-2020,airport surveillance (domestic),65,1,0,0,66,0,0,879,1,880,814,0
10-09-2020,railway surveillance,2,0,0,0,2,0,0,428,0,428,426,0
11-09-2020,ariyalur,350,16,81,0,285,3210,16,20,0,3246,2924,37
11-09-2020,chengalpattu,2380,297,692,2,1983,29502,297,5,0,29804,27350,471
11-09-2020,chennai,10845,987,932,21,10879,145571,987,35,0,146593,132772,2942
11-09-2020,coimbatore,3790,394,550,3,3631,20795,394,44,0,21233,17259,343
11-09-2020,cuddalore,3489,289,285,2,3491,15271,289,202,0,15762,12105,166
11-09-2020,dharmapuri,549,96,10,3,632,1583,96,213,0,1892,1241,19
11-09-2020,dindigul,966,47,152,2,859,7604,47,77,0,7728,6721,148
11-09-2020,erode,965,70,65,0,970,4111,70,94,0,4275,3251,54
11-09-2020,kallakurichi,921,147,142,2,924,7117,147,404,0,7668,6657,87
11-09-2020,kancheepuram,1249,132,127,2,1252,18964,132,3,0,19099,17567,280
11-09-2020,kanyakumari,780,123,117,1,785,10506,123,109,0,10738,9747,206
11-09-2020,karur,426,27,31,0,422,2007,27,46,0,2080,1627,31
11-09-2020,krishnagiri,726,39,54,1,710,2755,39,161,0,2955,2203,42
11-09-2020,madurai,992,51,93,2,948,14965,51,153,0,15169,13850,371
11-09-2020,nagapattinam,1064,48,94,1,1017,3628,48,88,0,3764,2681,66
11-09-2020,namakkal,755,114,89,0,780,2915,114,89,0,3118,2290,48
11-09-2020,nilgiris,453,90,64,2,477,2112,90,16,0,2218,1725,16
11-09-2020,perambalur,106,10,13,1,102,1492,10,2,0,1504,1383,19
11-09-2020,pudukottai,796,109,104,1,800,7072,109,33,0,7214,6296,118
11-09-2020,ramanathapuram,372,10,0,1,381,4999,10,133,0,5142,4648,113
11-09-2020,ranipet,779,92,117,2,752,11734,92,49,0,11875,10981,142
11-09-2020,salem,1778,298,209,6,1861,13173,298,417,0,13888,11817,210
11-09-2020,sivagangai,224,25,45,0,204,4339,25,60,0,4424,4106,114
11-09-2020,tenkasi,664,50,151,0,563,6043,50,49,0,6142,5466,113
11-09-2020,thanjavur,806,145,171,2,778,7884,145,22,0,8051,7145,128
11-09-2020,theni,804,85,99,2,788,13475,85,45,0,13605,12661,156
11-09-2020,thirupathur,489,84,48,1,524,3396,84,110,0,3590,2995,71
11-09-2020,thiruvallur,2067,312,342,8,2029,27408,312,8,0,27728,25232,467
11-09-2020,thiruvannamalai,1519,296,147,2,1666,12053,296,389,0,12738,10883,189
11-09-2020,thiruvarur,896,159,229,1,825,4779,159,37,0,4975,4086,64
11-09-2020,thoothukudi,708,101,99,0,710,11806,101,260,0,12167,11339,118
11-09-2020,tirunelveli,1092,136,104,0,1124,10354,136,420,0,10910,9594,192
11-09-2020,tiruppur,1333,124,107,0,1350,4056,124,10,0,4190,2757,83
11-09-2020,trichy,924,140,121,1,942,8527,139,13,1,8680,7607,131
11-09-2020,vellore,1026,182,117,2,1089,12107,180,127,2,12416,11139,188
11-09-2020,villupuram,771,161,98,2,832,8816,161,174,0,9151,8234,85
11-09-2020,virudhunagar,544,31,102,1,472,13472,31,104,0,13607,12933,202
11-09-2020,airport surveillance (international),16,0,0,0,16,0,0,922,0,922,905,1
11-09-2020,airport surveillance (domestic),66,2,5,0,63,0,0,880,2,882,819,0
11-09-2020,railway surveillance,2,0,0,0,2,0,0,428,0,428,426,0
12-09-2020,ariyalur,285,14,38,0,261,3226,14,20,0,3260,2962,37
12-09-2020,chengalpattu,1977,267,233,4,2007,29793,267,5,0,30065,27583,475
12-09-2020,chennai,10899,978,1215,17,10645,146578,978,35,0,147591,133987,2959
12-09-2020,coimbatore,3635,428,495,6,3562,21193,428,44,0,21665,17754,349
12-09-2020,cuddalore,3499,253,612,4,3136,15568,253,202,0,16023,12717,170
12-09-2020,dharmapuri,628,99,52,0,675,1675,99,213,0,1987,1293,19
12-09-2020,dindigul,861,66,135,1,791,7653,66,77,0,7796,6856,149
12-09-2020,erode,968,136,96,2,1006,4179,136,94,0,4409,3347,56
12-09-2020,kallakurichi,931,86,115,0,902,7271,86,404,0,7761,6772,87
12-09-2020,kancheepuram,1255,133,151,7,1230,19099,133,3,0,19235,17718,287
12-09-2020,kanyakumari,785,109,149,0,745,10629,109,109,0,10847,9896,206
12-09-2020,karur,426,43,78,0,391,2038,43,46,0,2127,1705,31
12-09-2020,krishnagiri,713,149,52,2,808,2797,148,161,1,3107,2255,44
12-09-2020,madurai,939,78,109,0,908,15007,78,153,0,15238,13959,371
12-09-2020,nagapattinam,1019,153,94,1,1077,3678,153,88,0,3919,2775,67
12-09-2020,namakkal,777,95,42,2,828,3026,94,89,1,3210,2332,50
12-09-2020,nilgiris,477,61,28,1,509,2202,61,16,0,2279,1753,17
12-09-2020,perambalur,102,17,22,0,97,1502,17,2,0,1521,1405,19
12-09-2020,pudukottai,802,77,103,0,776,7183,77,33,0,7293,6399,118
12-09-2020,ramanathapuram,381,23,103,0,301,5009,23,133,0,5165,4751,113
12-09-2020,ranipet,741,88,178,1,650,11815,88,49,0,11952,11159,143
12-09-2020,salem,1864,289,225,8,1920,13474,289,417,0,14180,12042,218
12-09-2020,sivagangai,205,50,34,0,221,4365,50,60,0,4475,4140,114
12-09-2020,tenkasi,564,81,36,3,606,6094,81,49,0,6224,5502,116
12-09-2020,thanjavur,774,145,104,0,815,8025,145,22,0,8192,7249,128
12-09-2020,theni,789,79,86,1,781,13561,79,45,0,13685,12747,157
12-09-2020,thirupathur,524,41,78,2,485,3480,41,110,0,3631,3073,73
12-09-2020,thiruvallur,2027,299,342,3,1981,27718,299,8,0,28025,25574,470
12-09-2020,thiruvannamalai,1662,144,235,3,1568,12345,144,389,0,12878,11118,192
12-09-2020,thiruvarur,826,147,222,0,751,4939,147,37,0,5123,4308,64
12-09-2020,thoothukudi,711,83,99,1,694,11908,83,260,0,12251,11438,119
12-09-2020,tirunelveli,1123,108,130,1,1100,10489,108,420,0,11017,9724,193
12-09-2020,tiruppur,1350,256,76,1,1529,4180,256,10,0,4446,2833,84
12-09-2020,trichy,936,79,115,1,899,8660,79,14,0,8753,7722,132
12-09-2020,vellore,1091,125,141,4,1071,12289,124,129,1,12543,11280,192
12-09-2020,villupuram,818,175,108,0,885,8963,175,174,0,9312,8342,85
12-09-2020,virudhunagar,473,39,95,0,417,13504,39,104,0,13647,13028,202
12-09-2020,airport surveillance (international),16,0,0,0,16,0,0,922,0,922,905,1
12-09-2020,airport surveillance (domestic),63,2,1,0,64,0,0,882,2,884,820,0
12-09-2020,railway surveillance,2,0,0,0,2,0,0,428,0,428,426,0
14-09-2020,ariyalur,229,16,39,0,206,3253,16,20,0,3289,3046,37
14-09-2020,chengalpattu,1997,364,323,3,2035,30374,364,5,0,30743,28221,487
14-09-2020,chennai,10408,991,940,23,10436,148557,991,35,0,149583,136155,2992
14-09-2020,coimbatore,3502,498,448,3,3549,22120,498,44,0,22662,18756,357
14-09-2020,cuddalore,2960,296,435,3,2818,16069,296,202,0,16567,13570,179
14-09-2020,dharmapuri,697,87,8,0,776,1815,87,214,0,2116,1320,20
14-09-2020,dindigul,763,76,116,0,723,7787,76,77,0,7940,7067,150
14-09-2020,erode,1044,133,119,3,1055,4441,133,94,0,4668,3551,62
14-09-2020,kallakurichi,899,139,94,0,944,7476,139,404,0,8019,6985,90
14-09-2020,kancheepuram,1253,167,155,1,1264,19400,167,3,0,19570,18018,288
14-09-2020,kanyakumari,738,134,117,1,754,10851,134,109,0,11094,10132,208
14-09-2020,karur,399,57,37,1,418,2117,57,46,0,2220,1769,33
14-09-2020,krishnagiri,858,78,146,0,790,3012,78,162,0,3252,2418,44
14-09-2020,madurai,885,95,287,1,692,15146,95,153,0,15394,14330,372
14-09-2020,nagapattinam,1141,120,94,1,1166,3993,120,88,0,4201,2966,69
14-09-2020,namakkal,912,118,136,1,893,3254,118,90,0,3462,2518,51
14-09-2020,nilgiris,549,94,52,0,591,2333,94,16,0,2443,1835,17
14-09-2020,perambalur,112,10,11,0,111,1543,10,2,0,1555,1425,19
14-09-2020,pudukottai,789,95,99,0,785,7397,95,33,0,7525,6619,121
14-09-2020,ramanathapuram,244,25,22,0,247,5049,25,133,0,5207,4846,114
14-09-2020,ranipet,694,99,145,1,647,12047,99,49,0,12195,11403,145
14-09-2020,salem,1984,297,233,3,2045,14060,297,417,0,14774,12498,231
14-09-2020,sivagangai,233,39,39,0,233,4458,39,60,0,4557,4210,114
14-09-2020,tenkasi,555,80,47,0,588,6215,80,49,0,6344,5638,118
14-09-2020,thanjavur,878,125,111,2,890,8319,125,22,0,8466,7446,130
14-09-2020,theni,789,55,85,0,759,13733,55,45,0,13833,12917,157
14-09-2020,thirupathur,492,82,55,0,519,3591,82,110,0,3783,3191,73
14-09-2020,thiruvallur,2083,294,330,4,2043,28318,294,8,0,28620,26092,485
14-09-2020,thiruvannamalai,1542,222,278,0,1486,12685,222,389,0,13296,11616,194
14-09-2020,thiruvarur,700,143,119,1,723,5229,143,37,0,5409,4621,65
14-09-2020,thoothukudi,682,73,46,0,709,12041,73,260,0,12374,11546,119
14-09-2020,tirunelveli,1063,72,110,0,1025,10700,72,420,0,11192,9976,191
14-09-2020,tiruppur,1715,192,84,1,1822,4736,192,10,0,4938,3030,86
14-09-2020,trichy,887,74,107,0,854,8826,74,14,0,8914,7929,131
14-09-2020,vellore,928,139,64,0,1003,12494,135,132,4,12765,11567,195
14-09-2020,villupuram,887,125,144,0,868,9272,125,174,0,9571,8618,85
14-09-2020,virudhunagar,435,42,91,0,386,13580,42,104,0,13726,13136,204
14-09-2020,airport surveillance (international),16,0,10,0,6,0,0,922,0,922,915,1
14-09-2020,airport surveillance (domestic),68,6,23,0,51,0,0,888,6,894,843,0
14-09-2020,railway surveillance,2,0,0,0,2,0,0,428,0,428,426,0
15-09-2020,ariyalur,206,26,66,0,166,3269,26,20,0,3315,3112,37
15-09-2020,chengalpattu,2035,324,236,4,2119,30738,324,5,0,31067,28457,491
15-09-2020,chennai,10436,989,1530,12,9883,149548,989,35,0,150572,137685,3004
15-09-2020,coimbatore,3549,485,437,4,3593,22618,485,44,0,23147,19193,361
15-09-2020,cuddalore,2818,268,523,5,2558,16365,268,202,0,16835,14093,184
15-09-2020,dharmapuri,776,88,48,0,816,1902,88,214,0,2204,1368,20
15-09-2020,dindigul,723,61,107,1,676,7863,61,77,0,8001,7174,151
15-09-2020,erode,1055,135,143,1,1046,4574,135,94,0,4803,3694,63
15-09-2020,kallakurichi,944,127,57,0,1014,7615,127,404,0,8146,7042,90
15-09-2020,kancheepuram,1264,198,152,0,1310,19567,198,3,0,19768,18170,288
15-09-2020,kanyakumari,754,103,41,2,814,10985,103,109,0,11197,10173,210
15-09-2020,karur,418,61,37,0,442,2174,61,46,0,2281,1806,33
15-09-2020,krishnagiri,790,75,38,1,826,3090,75,162,0,3327,2456,45
15-09-2020,madurai,692,83,41,2,732,15241,83,153,0,15477,14371,374
15-09-2020,nagapattinam,1166,111,121,1,1155,4113,111,88,0,4312,3087,70
15-09-2020,namakkal,893,97,110,1,879,3372,97,90,0,3559,2628,52
15-09-2020,nilgiris,591,85,99,0,577,2427,85,16,0,2528,1934,17
15-09-2020,perambalur,111,26,31,0,106,1553,26,2,0,1581,1456,19
15-09-2020,pudukottai,785,63,56,1,791,7492,63,33,0,7588,6675,122
15-09-2020,ramanathapuram,247,26,3,0,270,5074,26,133,0,5233,4849,114
15-09-2020,ranipet,647,92,102,0,637,12146,92,49,0,12287,11505,145
15-09-2020,salem,2045,292,166,9,2162,14357,291,417,1,15066,12664,240
15-09-2020,sivagangai,233,28,28,0,233,4497,28,60,0,4585,4238,114
15-09-2020,tenkasi,588,56,26,3,615,6295,56,49,0,6400,5664,121
15-09-2020,thanjavur,890,160,51,2,997,8444,160,22,0,8626,7497,132
15-09-2020,theni,759,81,97,3,740,13788,81,45,0,13914,13014,160
15-09-2020,thirupathur,519,74,29,3,561,3673,74,110,0,3857,3220,76
15-09-2020,thiruvallur,2043,283,268,5,2053,28612,283,8,0,28903,26360,490
15-09-2020,thiruvannamalai,1486,189,211,3,1461,12907,189,389,0,13485,11827,197
15-09-2020,thiruvarur,723,129,81,0,771,5372,129,37,0,5538,4702,65
15-09-2020,thoothukudi,709,84,74,0,719,12114,84,260,0,12458,11620,119
15-09-2020,tirunelveli,1025,117,77,0,1065,10772,117,420,0,11309,10053,191
15-09-2020,tiruppur,1822,262,291,1,1792,4928,262,10,0,5200,3321,87
15-09-2020,trichy,854,103,85,1,871,8900,103,14,0,9017,8014,132
15-09-2020,vellore,1003,134,59,2,1076,12629,132,136,2,12899,11626,197
15-09-2020,villupuram,868,134,161,0,841,9397,134,174,0,9705,8779,85
15-09-2020,virudhunagar,386,41,26,1,400,13622,41,104,0,13767,13162,205
15-09-2020,airport surveillance (international),6,2,3,0,5,0,0,922,2,924,918,1
15-09-2020,airport surveillance (domestic),51,5,24,0,32,0,0,894,5,899,867,0
15-09-2020,railway surveillance,2,0,0,0,2,0,0,428,0,428,426,0
16-09-2020,ariyalur,167,27,5,0,189,3296,27,20,0,3343,3117,37
16-09-2020,chengalpattu,2120,319,220,4,2215,31064,319,5,0,31388,28677,496
16-09-2020,chennai,9893,983,1029,14,9833,150542,983,35,0,151560,138714,3013
16-09-2020,coimbatore,3599,549,707,4,3437,23109,549,44,0,23702,19900,365
16-09-2020,cuddalore,2557,263,400,5,2415,16632,263,202,0,17097,14493,189
16-09-2020,dharmapuri,817,117,56,1,877,1991,117,214,0,2322,1424,21
16-09-2020,dindigul,672,68,68,0,672,7920,68,77,0,8065,7242,151
16-09-2020,erode,1048,98,123,1,1022,4711,98,94,0,4903,3817,64
16-09-2020,kallakurichi,1014,162,44,0,1132,7742,162,404,0,8308,7086,90
16-09-2020,kancheepuram,1313,189,169,1,1332,19767,189,3,0,19959,18339,288
16-09-2020,kanyakumari,814,114,84,0,844,11088,114,109,0,11311,10257,210
16-09-2020,karur,445,43,60,0,428,2238,43,46,0,2327,1866,33
16-09-2020,krishnagiri,826,68,47,0,847,3165,68,162,0,3395,2503,45
16-09-2020,madurai,736,97,34,0,799,15328,97,153,0,15578,14405,374
16-09-2020,nagapattinam,1162,71,155,1,1077,4231,71,88,0,4390,3242,71
16-09-2020,namakkal,873,120,70,1,922,3463,120,90,0,3673,2698,53
16-09-2020,nilgiris,573,72,22,0,623,2508,72,16,0,2596,1956,17
16-09-2020,perambalur,106,16,13,0,109,1579,16,2,0,1597,1469,19
16-09-2020,pudukottai,793,131,96,0,828,7557,131,33,0,7721,6771,122
16-09-2020,ramanathapuram,270,36,30,0,276,5100,36,133,0,5269,4879,114
16-09-2020,ranipet,618,96,118,0,596,12219,96,49,0,12364,11623,145
16-09-2020,salem,2157,280,212,5,2220,14643,279,418,1,15341,12876,245
16-09-2020,sivagangai,231,42,30,0,243,4523,42,60,0,4625,4268,114
16-09-2020,tenkasi,612,70,136,1,545,6348,70,49,0,6467,5800,122
16-09-2020,thanjavur,983,138,155,2,964,8591,138,22,0,8751,7652,135
16-09-2020,theni,741,50,84,2,705,13870,50,45,0,13965,13098,162
16-09-2020,thirupathur,562,93,38,2,615,3748,93,110,0,3951,3258,78
16-09-2020,thiruvallur,2062,282,285,4,2055,28908,282,8,0,29198,26645,498
16-09-2020,thiruvannamalai,1462,156,232,5,1381,13097,156,389,0,13642,12059,202
16-09-2020,thiruvarur,772,139,165,0,746,5502,139,37,0,5678,4867,65
16-09-2020,thoothukudi,719,85,40,0,764,12198,85,260,0,12543,11660,119
16-09-2020,tirunelveli,1067,118,130,1,1054,10891,118,420,0,11429,10183,192
16-09-2020,tiruppur,1792,149,304,0,1637,5190,149,10,0,5349,3625,87
16-09-2020,trichy,870,98,99,2,867,9002,98,14,0,9114,8113,134
16-09-2020,vellore,1080,116,116,0,1080,12765,115,138,1,13019,11742,197
16-09-2020,villupuram,841,142,110,1,872,9531,142,174,0,9847,8889,86
16-09-2020,virudhunagar,400,50,82,0,368,13663,50,104,0,13817,13244,205
16-09-2020,airport surveillance (international),5,0,0,0,5,0,0,924,0,924,918,1
16-09-2020,airport surveillance (domestic),32,5,0,0,37,0,0,899,5,904,867,0
16-09-2020,railway surveillance,2,0,0,0,2,0,0,428,0,428,426,0
17-09-2020,ariyalur,190,34,44,0,180,3324,34,20,0,3378,3161,37
17-09-2020,chengalpattu,2256,283,256,2,2281,31424,283,5,0,31712,28933,498
17-09-2020,chennai,9850,992,956,12,9874,151540,992,35,0,152567,139670,3023
17-09-2020,coimbatore,3439,530,364,3,3602,23660,530,44,0,24234,20264,368
17-09-2020,cuddalore,2421,206,296,5,2326,16901,206,202,0,17309,14789,194
17-09-2020,dharmapuri,877,124,59,0,942,2108,124,214,0,2446,1483,21
17-09-2020,dindigul,668,78,71,1,674,7984,78,77,0,8139,7313,152
17-09-2020,erode,1023,98,97,0,1024,4810,98,94,0,5002,3914,64
17-09-2020,kallakurichi,1125,110,80,0,1155,7897,110,404,0,8411,7166,90
17-09-2020,kancheepuram,1265,187,186,3,1263,19889,187,3,0,20079,18525,291
17-09-2020,kanyakumari,847,118,200,1,764,11205,118,109,0,11432,10457,211
17-09-2020,karur,429,52,63,2,416,2282,52,46,0,2380,1929,35
17-09-2020,krishnagiri,848,85,96,2,835,3234,85,162,0,3481,2599,47
17-09-2020,madurai,791,78,47,4,818,15416,78,153,0,15647,14452,377
17-09-2020,nagapattinam,1086,72,152,0,1006,4311,72,88,0,4471,3394,71
17-09-2020,namakkal,923,112,80,2,953,3584,112,90,0,3786,2778,55
17-09-2020,nilgiris,623,82,87,0,618,2580,82,16,0,2678,2043,17
17-09-2020,perambalur,110,13,14,0,109,1596,13,2,0,1611,1483,19
17-09-2020,pudukottai,828,118,112,0,834,7688,118,33,0,7839,6883,122
17-09-2020,ramanathapuram,276,30,34,0,272,5136,30,133,0,5299,4913,114
17-09-2020,ranipet,600,97,100,0,597,12319,97,49,0,12465,11723,145
17-09-2020,salem,2221,291,242,3,2267,14923,291,419,0,15633,13118,248
17-09-2020,sivagangai,244,42,20,0,266,4567,42,60,0,4669,4288,115
17-09-2020,tenkasi,548,70,95,1,522,6421,70,49,0,6540,5895,123
17-09-2020,thanjavur,957,155,90,3,1019,8722,155,22,0,8899,7742,138
17-09-2020,theni,706,77,81,1,701,13921,77,45,0,14043,13179,163
17-09-2020,thirupathur,612,94,77,0,629,3838,94,110,0,4042,3335,78
17-09-2020,thiruvallur,2062,239,518,7,1776,29199,239,8,0,29446,27163,507
17-09-2020,thiruvannamalai,1372,169,136,0,1405,13244,167,389,2,13802,12195,202
17-09-2020,thiruvarur,744,108,120,0,732,5639,108,37,0,5784,4987,65
17-09-2020,thoothukudi,761,80,52,0,789,12280,80,260,0,12620,11712,119
17-09-2020,tirunelveli,1046,95,97,0,1044,11001,95,420,0,11516,10280,192
17-09-2020,tiruppur,1641,191,75,3,1754,5343,191,10,0,5544,3700,90
17-09-2020,trichy,865,115,100,0,880,9098,115,14,0,9227,8213,134
17-09-2020,vellore,1082,141,245,2,976,12882,139,139,2,13162,11987,199
17-09-2020,villupuram,881,125,143,2,861,9682,125,174,0,9981,9032,88
17-09-2020,virudhunagar,372,68,27,0,413,13717,68,104,0,13889,13271,205
17-09-2020,airport surveillance (international),5,0,1,0,4,0,0,924,0,924,919,1
17-09-2020,airport surveillance (domestic),37,1,11,0,27,0,0,904,1,905,878,0
17-09-2020,railway surveillance,2,0,0,0,2,0,0,428,0,428,426,0
18-09-2020,ariyalur,180,33,29,0,184,3358,33,20,0,3411,3190,37
18-09-2020,chengalpattu,2274,265,346,4,2189,31702,265,5,0,31972,29279,504
18-09-2020,chennai,9936,989,963,16,9946,152592,989,35,0,153616,140633,3037
18-09-2020,coimbatore,3603,543,108,4,4034,24191,542,44,1,24778,20372,372
18-09-2020,cuddalore,2331,254,292,4,2289,17112,254,202,0,17568,15081,198
18-09-2020,dharmapuri,944,106,57,0,993,2234,106,214,0,2554,1540,21
18-09-2020,dindigul,677,88,131,1,633,8065,88,77,0,8230,7444,153
18-09-2020,erode,1020,118,171,3,964,4904,118,94,0,5116,4085,67
18-09-2020,kallakurichi,1159,91,123,0,1127,8011,91,404,0,8506,7289,90
18-09-2020,kancheepuram,1239,151,174,1,1215,20051,151,3,0,20205,18699,291
18-09-2020,kanyakumari,764,115,125,4,750,11323,115,109,0,11547,10582,215
18-09-2020,karur,416,68,45,0,439,2334,68,46,0,2448,1974,35
18-09-2020,krishnagiri,842,50,139,1,752,3326,50,162,0,3538,2738,48
18-09-2020,madurai,813,82,165,0,730,15489,82,153,0,15724,14617,377
18-09-2020,nagapattinam,1010,80,73,1,1016,4387,80,88,0,4555,3467,72
18-09-2020,namakkal,957,108,172,1,892,3700,106,90,2,3898,2950,56
18-09-2020,nilgiris,618,72,101,0,589,2662,72,16,0,2750,2144,17
18-09-2020,perambalur,109,11,19,0,101,1609,11,2,0,1622,1502,19
18-09-2020,pudukottai,834,123,94,0,863,7806,123,33,0,7962,6977,122
18-09-2020,ramanathapuram,274,31,32,0,273,5168,31,133,0,5332,4945,114
18-09-2020,ranipet,598,53,76,2,573,12417,53,49,0,12519,11799,147
18-09-2020,salem,2269,288,269,3,2285,15216,288,419,0,15923,13387,251
18-09-2020,sivagangai,260,38,24,0,274,4603,38,60,0,4701,4312,115
18-09-2020,tenkasi,523,97,48,1,571,6492,97,49,0,6638,5943,124
18-09-2020,thanjavur,1021,162,150,2,1031,8879,162,22,0,9063,7892,140
18-09-2020,theni,703,67,104,1,665,14000,67,45,0,14112,13283,164
18-09-2020,thirupathur,625,81,96,0,610,3928,81,110,0,4119,3431,78
18-09-2020,thiruvallur,1735,258,350,4,1639,29398,258,8,0,29664,27513,512
18-09-2020,thiruvannamalai,1404,148,81,2,1469,13410,148,391,0,13949,12276,204
18-09-2020,thiruvarur,730,101,68,1,762,5745,101,37,0,5883,5055,66
18-09-2020,thoothukudi,789,90,80,0,799,12360,90,260,0,12710,11792,119
18-09-2020,tirunelveli,1044,104,98,1,1049,11096,104,420,0,11620,10378,193
18-09-2020,tiruppur,1750,187,189,2,1746,5530,187,10,0,5727,3889,92
18-09-2020,trichy,880,136,218,3,795,9213,136,14,0,9363,8431,137
18-09-2020,vellore,970,118,135,2,951,13015,115,141,3,13274,12122,201
18-09-2020,villupuram,862,139,71,1,929,9808,139,174,0,10121,9103,89
18-09-2020,virudhunagar,414,39,108,2,343,13786,39,104,0,13929,13379,207
18-09-2020,airport surveillance (international),4,0,0,0,4,0,0,924,0,924,919,1
18-09-2020,airport surveillance (domestic),27,4,1,0,30,0,0,905,4,909,879,0
18-09-2020,railway surveillance,2,0,0,0,2,0,0,428,0,428,426,0
20-09-2020,ariyalur,182,36,5,0,213,3431,36,20,0,3487,3236,38
20-09-2020,chengalpattu,2267,283,87,7,2456,32292,283,5,0,32580,29607,517
20-09-2020,chennai,9985,996,1263,12,9706,154608,996,35,0,155639,142875,3058
20-09-2020,coimbatore,4290,568,488,6,4364,25298,568,48,0,25914,21168,382
20-09-2020,cuddalore,2269,297,248,3,2315,17654,297,202,0,18153,15635,203
20-09-2020,dharmapuri,987,136,89,1,1033,2443,136,214,0,2793,1738,22
20-09-2020,dindigul,619,82,113,1,587,8227,82,77,0,8386,7645,154
20-09-2020,erode,1053,148,122,3,1076,5185,148,94,0,5427,4281,70
20-09-2020,kallakurichi,1023,55,204,0,874,8195,55,404,0,8654,7689,91
20-09-2020,kancheepuram,1100,156,135,2,1119,20318,156,3,0,20477,19064,294
20-09-2020,kanyakumari,659,133,155,0,637,11544,133,109,0,11786,10934,215
20-09-2020,karur,460,60,9,0,511,2466,60,46,0,2572,2025,36
20-09-2020,krishnagiri,760,112,78,0,794,3465,112,162,0,3739,2897,48
20-09-2020,madurai,760,86,135,1,710,15639,86,153,0,15878,14790,378
20-09-2020,nagapattinam,1036,103,140,0,999,4529,103,88,0,4720,3646,75
20-09-2020,namakkal,923,131,55,0,999,3910,131,92,0,4133,3076,58
20-09-2020,nilgiris,598,130,60,2,666,2822,130,16,0,2968,2282,20
20-09-2020,perambalur,115,11,9,0,117,1646,11,2,0,1659,1523,19
20-09-2020,pudukottai,867,101,98,2,868,8020,101,33,0,8154,7162,124
20-09-2020,ramanathapuram,263,15,53,0,225,5230,15,133,0,5378,5038,115
20-09-2020,ranipet,505,42,55,1,491,12525,42,49,0,12616,11974,151
20-09-2020,salem,2301,291,259,6,2327,15785,291,419,0,16495,13905,263
20-09-2020,sivagangai,261,61,44,1,277,4678,61,60,0,4799,4406,116
20-09-2020,tenkasi,545,87,31,1,600,6658,87,49,0,6794,6068,126
20-09-2020,thanjavur,1077,162,99,2,1138,9187,162,22,0,9371,8089,144
20-09-2020,theni,636,53,105,0,584,14122,53,45,0,14220,13469,167
20-09-2020,thirupathur,637,68,97,0,608,4097,68,110,0,4275,3587,80
20-09-2020,thiruvallur,1644,207,149,5,1697,29925,207,8,0,30140,27922,521
20-09-2020,thiruvannamalai,1261,104,75,0,1290,13717,104,393,0,14214,12717,207
20-09-2020,thiruvarur,787,96,82,0,801,5938,96,37,0,6071,5204,66
20-09-2020,thoothukudi,771,82,73,1,779,12516,82,260,0,12858,11959,120
20-09-2020,tirunelveli,1036,92,103,0,1025,11303,92,420,0,11815,10596,194
20-09-2020,tiruppur,1760,169,124,2,1803,5880,169,10,0,6059,4161,95
20-09-2020,trichy,752,92,76,0,768,9446,92,14,0,9552,8645,139
20-09-2020,vellore,963,95,150,0,908,13277,95,144,0,13516,12403,205
20-09-2020,villupuram,949,127,87,1,988,10093,127,174,0,10394,9314,92
20-09-2020,virudhunagar,304,47,49,0,302,13880,47,104,0,14031,13522,207
20-09-2020,airport surveillance (international),4,0,0,0,4,0,0,924,0,924,919,1
20-09-2020,airport surveillance (domestic),42,2,2,0,42,0,0,922,2,924,882,0
20-09-2020,railway surveillance,2,0,0,0,2,0,0,428,0,428,426,0
21-09-2020,ariyalur,215,28,56,0,187,3469,28,20,0,3517,3292,38
21-09-2020,chengalpattu,2456,219,245,6,2424,32575,219,5,0,32799,29852,523
21-09-2020,chennai,9710,982,805,16,9871,155608,982,35,0,156625,143680,3074
21-09-2020,coimbatore,4364,648,531,6,4475,25866,648,48,0,26562,21699,388
21-09-2020,cuddalore,2310,153,255,0,2208,17946,153,202,0,18301,15890,203
21-09-2020,dharmapuri,1033,89,130,0,992,2579,89,214,0,2882,1868,22
21-09-2020,dindigul,579,73,55,0,597,8301,73,77,0,8451,7700,154
21-09-2020,erode,1076,201,131,2,1144,5333,201,94,0,5628,4412,72
21-09-2020,kallakurichi,874,105,109,1,869,8250,105,404,0,8759,7798,92
21-09-2020,kancheepuram,1119,117,171,4,1061,20474,117,3,0,20594,19235,298
21-09-2020,kanyakumari,637,97,103,0,631,11677,97,109,0,11883,11037,215
21-09-2020,karur,512,54,94,0,472,2527,54,46,0,2627,2119,36
21-09-2020,krishnagiri,801,92,54,3,836,3584,91,162,1,3838,2951,51
21-09-2020,madurai,710,85,2,1,792,15725,85,153,0,15963,14792,379
21-09-2020,nagapattinam,1004,89,149,0,944,4637,89,88,0,4814,3795,75
21-09-2020,namakkal,999,130,192,3,934,4041,130,92,0,4263,3268,61
21-09-2020,nilgiris,666,122,64,0,724,2952,122,16,0,3090,2346,20
21-09-2020,perambalur,117,10,24,1,102,1657,10,2,0,1669,1547,20
21-09-2020,pudukottai,870,98,151,0,817,8123,98,33,0,8254,7313,124
21-09-2020,ramanathapuram,225,15,10,0,230,5245,15,133,0,5393,5048,115
21-09-2020,ranipet,491,79,29,1,540,12567,79,49,0,12695,12003,152
21-09-2020,salem,2327,295,361,1,2260,16076,295,419,0,16790,14266,264
21-09-2020,sivagangai,277,41,39,0,279,4739,41,60,0,4840,4445,116
21-09-2020,tenkasi,602,65,27,0,640,6747,65,49,0,6861,6095,126
21-09-2020,thanjavur,1126,136,115,4,1143,9337,136,22,0,9495,8204,148
21-09-2020,theni,584,57,93,1,547,14175,57,45,0,14277,13562,168
21-09-2020,thirupathur,608,108,77,1,638,4165,108,110,0,4383,3664,81
21-09-2020,thiruvallur,1697,212,188,1,1720,30132,212,8,0,30352,28110,522
21-09-2020,thiruvannamalai,1290,97,183,1,1203,13821,97,393,0,14311,12900,208
21-09-2020,thiruvarur,804,120,97,0,827,6037,120,37,0,6194,5301,66
21-09-2020,thoothukudi,781,96,74,0,803,12600,96,260,0,12956,12033,120
21-09-2020,tirunelveli,1021,87,146,0,962,11391,87,420,0,11898,10742,194
21-09-2020,tiruppur,1803,161,374,0,1590,6049,161,10,0,6220,4535,95
21-09-2020,trichy,769,80,80,2,767,9539,80,14,0,9633,8725,141
21-09-2020,vellore,904,139,123,4,916,13368,139,144,0,13651,12526,209
21-09-2020,villupuram,992,127,135,0,984,10224,127,174,0,10525,9449,92
21-09-2020,virudhunagar,302,35,20,1,316,13927,35,104,0,14066,13542,208
21-09-2020,airport surveillance (international),4,0,0,0,4,0,0,924,0,924,919,1
21-09-2020,airport surveillance (domestic),42,2,0,0,44,0,0,924,2,926,882,0
21-09-2020,railway surveillance,2,0,0,0,2,0,0,428,0,428,426,0
22-09-2020,ariyalur,187,20,42,0,165,3497,20,20,0,3537,3334,38
22-09-2020,chengalpattu,2422,231,371,1,2281,32794,231,5,0,33030,30223,526
22-09-2020,chennai,9873,989,831,19,10012,156590,989,35,0,157614,144511,3091
22-09-2020,coimbatore,4475,595,507,4,4559,26514,595,48,0,27157,22206,392
22-09-2020,cuddalore,2208,233,231,3,2207,18099,233,202,0,18534,16121,206
22-09-2020,dharmapuri,992,106,92,0,1006,2668,106,214,0,2988,1960,22
22-09-2020,dindigul,598,54,45,2,605,8374,54,77,0,8505,7745,155
22-09-2020,erode,1143,136,165,4,1110,5534,136,94,0,5764,4577,77
22-09-2020,kallakurichi,869,73,78,1,863,8355,73,404,0,8832,7876,93
22-09-2020,kancheepuram,1059,209,161,2,1105,20591,209,3,0,20803,19396,302
22-09-2020,kanyakumari,631,77,40,1,667,11774,77,109,0,11960,11077,216
22-09-2020,karur,472,56,35,0,493,2581,56,46,0,2683,2154,36
22-09-2020,krishnagiri,836,90,78,0,848,3675,89,163,1,3928,3029,51
22-09-2020,madurai,792,61,93,1,759,15810,61,153,0,16024,14885,380
22-09-2020,nagapattinam,944,46,125,0,865,4726,46,88,0,4860,3920,75
22-09-2020,namakkal,935,92,78,2,947,4171,92,92,0,4355,3346,62
22-09-2020,nilgiris,724,88,101,1,710,3074,88,16,0,3178,2447,21
22-09-2020,perambalur,102,7,5,0,104,1667,7,2,0,1676,1552,20
22-09-2020,pudukottai,817,89,95,1,810,8221,89,33,0,8343,7408,125
22-09-2020,ramanathapuram,230,8,23,0,215,5260,8,133,0,5401,5071,115
22-09-2020,ranipet,540,88,61,0,567,12646,88,49,0,12783,12064,152
22-09-2020,salem,2260,291,267,11,2273,16371,291,419,0,17081,14533,275
22-09-2020,sivagangai,279,38,28,2,287,4780,38,60,0,4878,4473,118
22-09-2020,tenkasi,640,54,55,3,636,6812,54,49,0,6915,6150,129
22-09-2020,thanjavur,1143,155,77,3,1218,9473,155,22,0,9650,8281,151
22-09-2020,theni,547,60,93,2,512,14232,60,45,0,14337,13655,170
22-09-2020,thirupathur,638,57,54,1,640,4273,57,110,0,4440,3718,82
22-09-2020,thiruvallur,1721,230,281,3,1667,30344,230,8,0,30582,28391,524
22-09-2020,thiruvannamalai,1203,126,220,3,1106,13918,126,393,0,14437,13120,211
22-09-2020,thiruvarur,827,116,99,1,843,6157,116,37,0,6310,5400,67
22-09-2020,thoothukudi,803,60,88,0,775,12696,60,260,0,13016,12121,120
22-09-2020,tirunelveli,962,91,119,0,934,11478,91,420,0,11989,10861,194
22-09-2020,tiruppur,1590,369,394,2,1563,6210,368,10,1,6589,4929,97
22-09-2020,trichy,767,113,71,1,808,9619,113,14,0,9746,8796,142
22-09-2020,vellore,916,95,114,1,896,13507,95,144,0,13746,12640,210
22-09-2020,villupuram,984,91,171,1,903,10351,91,174,0,10616,9620,93
22-09-2020,virudhunagar,316,42,18,0,340,13962,42,104,0,14108,13560,208
22-09-2020,airport surveillance (international),4,0,0,0,4,0,0,924,0,924,919,1
22-09-2020,airport surveillance (domestic),44,1,0,0,45,0,0,926,1,927,882,0
22-09-2020,railway surveillance,2,0,0,0,2,0,0,428,0,428,426,0
23-09-2020,ariyalur,165,11,27,0,149,3517,11,20,0,3548,3361,38
23-09-2020,chengalpattu,2280,297,182,1,2394,33025,297,5,0,33327,30405,528
23-09-2020,chennai,10014,980,1118,8,9868,157579,980,35,0,158594,145629,3097
23-09-2020,coimbatore,4559,587,512,4,4630,27109,587,48,0,27744,22718,396
23-09-2020,cuddalore,2207,183,318,5,2067,18332,183,202,0,18717,16439,211
23-09-2020,dharmapuri,1006,130,42,0,1094,2774,130,214,0,3118,2002,22
23-09-2020,dindigul,605,40,31,1,613,8428,40,77,0,8545,7776,156
23-09-2020,erode,1110,125,122,0,1113,5670,125,94,0,5889,4699,77
23-09-2020,kallakurichi,863,55,212,1,705,8428,55,404,0,8887,8088,94
23-09-2020,kancheepuram,1105,205,118,1,1191,20800,205,3,0,21008,19514,303
23-09-2020,kanyakumari,667,117,21,0,763,11851,117,109,0,12077,11098,216
23-09-2020,karur,493,41,32,0,502,2637,41,46,0,2724,2186,36
23-09-2020,krishnagiri,848,63,125,1,785,3764,63,164,0,3991,3154,52
23-09-2020,madurai,759,79,74,0,764,15871,79,153,0,16103,14959,380
23-09-2020,nagapattinam,865,46,120,1,790,4772,46,88,0,4906,4040,76
23-09-2020,namakkal,947,132,196,1,882,4263,132,92,0,4487,3542,63
23-09-2020,nilgiris,710,89,78,2,719,3162,89,16,0,3267,2525,23
23-09-2020,perambalur,104,22,15,0,111,1674,22,2,0,1698,1567,20
23-09-2020,pudukottai,810,81,62,1,828,8310,81,33,0,8424,7470,126
23-09-2020,ramanathapuram,215,10,17,3,205,5268,10,133,0,5411,5088,118
23-09-2020,ranipet,566,89,48,0,607,12734,89,49,0,12872,12112,153
23-09-2020,salem,2273,298,212,9,2350,16662,298,419,0,17379,14745,284
23-09-2020,sivagangai,288,44,35,0,297,4818,44,60,0,4922,4508,117
23-09-2020,tenkasi,636,46,123,1,558,6866,46,49,0,6961,6273,130
23-09-2020,thanjavur,1217,186,138,5,1260,9628,186,22,0,9836,8419,157
23-09-2020,theni,512,71,68,2,513,14292,71,45,0,14408,13723,172
23-09-2020,thirupathur,640,65,74,1,630,4330,65,110,0,4505,3792,83
23-09-2020,thiruvallur,1667,218,286,7,1592,30574,218,8,0,30800,28677,531
23-09-2020,thiruvannamalai,1106,126,185,2,1045,14044,126,393,0,14563,13305,213
23-09-2020,thiruvarur,843,99,68,0,874,6273,99,37,0,6409,5468,67
23-09-2020,thoothukudi,775,55,80,0,750,12756,55,260,0,13071,12201,120
23-09-2020,tirunelveli,934,92,100,1,925,11569,92,420,0,12081,10961,195
23-09-2020,tiruppur,1563,247,139,4,1667,6578,247,11,0,6836,5068,101
23-09-2020,trichy,808,112,103,0,817,9732,112,14,0,9858,8899,142
23-09-2020,vellore,896,143,99,0,940,13602,138,144,5,13889,12739,210
23-09-2020,villupuram,903,105,147,1,860,10442,105,174,0,10721,9767,94
23-09-2020,virudhunagar,340,35,34,0,341,14004,35,104,0,14143,13594,208
23-09-2020,airport surveillance (international),4,0,0,0,4,0,0,924,0,924,919,1
23-09-2020,airport surveillance (domestic),45,1,2,0,44,0,0,927,1,928,884,0
23-09-2020,railway surveillance,2,0,0,0,2,0,0,428,0,428,426,0
24-09-2020,ariyalur,149,28,32,0,145,3528,28,20,0,3576,3393,38
24-09-2020,chengalpattu,2394,299,309,2,2382,33322,299,5,0,33626,30714,530
24-09-2020,chennai,9869,1089,1005,15,9938,158559,1089,35,0,159683,146634,3111
24-09-2020,coimbatore,4632,642,613,6,4655,27698,642,48,0,28388,23331,402
24-09-2020,cuddalore,2072,250,514,1,1807,18520,250,202,0,18972,16953,212
24-09-2020,dharmapuri,1094,129,81,1,1141,2904,129,214,0,3247,2083,23
24-09-2020,dindigul,600,45,54,0,591,8455,45,77,0,8577,7830,156
24-09-2020,erode,1115,138,123,1,1129,5797,138,94,0,6029,4822,78
24-09-2020,kallakurichi,687,42,111,0,618,8465,42,404,0,8911,8199,94
24-09-2020,kancheepuram,1191,196,98,1,1288,21005,196,3,0,21204,19612,304
24-09-2020,kanyakumari,763,61,4,1,819,11968,61,109,0,12138,11102,217
24-09-2020,karur,503,61,53,1,510,2679,61,46,0,2786,2239,37
24-09-2020,krishnagiri,785,86,75,1,795,3827,86,164,0,4077,3229,53
24-09-2020,madurai,767,69,81,1,754,15953,69,153,0,16175,15040,381
24-09-2020,nagapattinam,790,46,118,1,717,4818,46,88,0,4952,4158,77
24-09-2020,namakkal,882,132,76,1,937,4395,132,92,0,4619,3618,64
24-09-2020,nilgiris,719,97,80,0,736,3251,97,16,0,3364,2605,23
24-09-2020,perambalur,111,21,12,0,120,1696,21,2,0,1719,1579,20
24-09-2020,pudukottai,828,112,118,0,822,8391,112,33,0,8536,7588,126
24-09-2020,ramanathapuram,205,16,27,0,194,5278,16,133,0,5427,5115,118
24-09-2020,ranipet,607,98,156,0,549,12823,98,49,0,12970,12268,153
24-09-2020,salem,2351,311,209,5,2448,16962,311,419,0,17692,14954,290
24-09-2020,sivagangai,298,41,41,0,298,4863,41,60,0,4964,4549,117
24-09-2020,tenkasi,558,55,71,1,541,6912,55,49,0,7016,6344,131
24-09-2020,thanjavur,1260,190,104,2,1344,9814,190,22,0,10026,8523,159
24-09-2020,theni,513,65,73,1,504,14363,65,45,0,14473,13796,173
24-09-2020,thirupathur,630,68,57,2,639,4395,68,110,0,4573,3849,85
24-09-2020,thiruvallur,1592,265,195,2,1660,30792,265,8,0,31065,28872,533
24-09-2020,thiruvannamalai,1047,120,154,3,1010,14172,120,393,0,14685,13459,216
24-09-2020,thiruvarur,874,143,115,1,901,6372,143,37,0,6552,5583,68
24-09-2020,thoothukudi,751,38,60,0,729,12812,38,260,0,13110,12261,120
24-09-2020,tirunelveli,925,115,92,1,947,11661,115,420,0,12196,11053,196
24-09-2020,tiruppur,1667,188,169,9,1677,6825,188,11,0,7024,5237,110
24-09-2020,trichy,819,126,97,0,848,9846,126,14,0,9986,8996,142
24-09-2020,vellore,940,126,131,4,931,13740,119,149,7,14015,12870,214
24-09-2020,villupuram,869,146,111,1,903,10556,146,174,0,10876,9878,95
24-09-2020,virudhunagar,342,32,51,1,322,14040,32,104,0,14176,13645,209
24-09-2020,airport surveillance (international),4,0,0,0,4,0,0,924,0,924,919,1
24-09-2020,airport surveillance (domestic),44,6,0,0,50,0,0,928,6,934,884,0
24-09-2020,railway surveillance,2,0,0,0,2,0,0,428,0,428,426,0
25-09-2020,ariyalur,147,28,33,0,142,3558,28,20,0,3606,3426,38
25-09-2020,chengalpattu,2386,277,306,4,2353,33626,277,5,0,33908,31020,535
25-09-2020,chennai,9989,1193,1164,18,10000,159698,1193,35,0,160926,147798,3128
25-09-2020,coimbatore,4663,661,517,6,4801,28348,661,48,0,29057,23848,408
25-09-2020,cuddalore,1813,235,424,1,1623,18777,235,202,0,19214,17377,214
25-09-2020,dharmapuri,1142,148,95,1,1194,3034,148,214,0,3396,2178,24
25-09-2020,dindigul,602,58,80,1,579,8511,58,77,0,8646,7910,157
25-09-2020,erode,1089,151,123,1,1116,5895,151,94,0,6140,4945,79
25-09-2020,kallakurichi,619,57,85,1,590,8508,57,404,0,8969,8284,95
25-09-2020,kancheepuram,1302,165,100,2,1365,21215,165,3,0,21383,19712,306
25-09-2020,kanyakumari,820,86,11,0,895,12030,86,109,0,12225,11113,217
25-09-2020,karur,506,49,45,0,510,2736,49,46,0,2831,2284,37
25-09-2020,krishnagiri,799,104,87,3,813,3917,104,164,0,4185,3316,56
25-09-2020,madurai,724,71,77,2,716,15992,71,153,0,16216,15117,383
25-09-2020,nagapattinam,726,35,117,0,644,4873,35,88,0,4996,4275,77
25-09-2020,namakkal,931,115,101,0,945,4521,115,92,0,4728,3719,64
25-09-2020,nilgiris,736,137,71,0,802,3348,137,16,0,3501,2676,23
25-09-2020,perambalur,122,17,26,0,113,1719,17,2,0,1738,1605,20
25-09-2020,pudukottai,825,66,135,2,754,8506,66,33,0,8605,7723,128
25-09-2020,ramanathapuram,195,17,26,0,186,5295,17,133,0,5445,5141,118
25-09-2020,ranipet,551,65,118,0,498,12923,65,49,0,13037,12386,153
25-09-2020,salem,2464,297,152,8,2601,17289,297,419,0,18005,15106,298
25-09-2020,sivagangai,300,46,37,1,308,4906,46,60,0,5012,4586,118
25-09-2020,tenkasi,545,53,40,1,557,6971,53,49,0,7073,6384,132
25-09-2020,thanjavur,1349,150,169,2,1328,10009,150,22,0,10181,8692,161
25-09-2020,theni,506,66,91,0,481,14430,66,45,0,14541,13887,173
25-09-2020,thirupathur,635,67,101,0,601,4459,67,110,0,4636,3950,85
25-09-2020,thiruvallur,1587,229,254,3,1559,30983,229,8,0,31220,29126,535
25-09-2020,thiruvannamalai,1007,173,164,3,1013,14289,173,393,0,14855,13623,219
25-09-2020,thiruvarur,893,139,69,1,962,6507,139,37,0,6683,5652,69
25-09-2020,thoothukudi,737,46,101,0,682,12858,46,260,0,13164,12362,120
25-09-2020,tirunelveli,934,77,102,0,909,11763,77,420,0,12260,11155,196
25-09-2020,tiruppur,1697,158,158,4,1693,7033,158,11,0,7202,5395,114
25-09-2020,trichy,838,107,118,0,827,9962,106,14,1,10083,9114,142
25-09-2020,vellore,932,125,155,7,895,13860,125,156,0,14141,13025,221
25-09-2020,villupuram,909,162,126,0,945,10708,162,174,0,11044,10004,95
25-09-2020,virudhunagar,329,42,34,0,337,14079,42,104,0,14225,13679,209
25-09-2020,airport surveillance (international),4,0,0,0,4,0,0,924,0,924,919,1
25-09-2020,airport surveillance (domestic),50,7,14,0,43,0,0,934,7,941,898,0
25-09-2020,railway surveillance,2,0,0,0,2,0,0,428,0,428,426,0
27-09-2020,ariyalur,142,37,6,0,173,3616,37,20,0,3673,3461,39
27-09-2020,chengalpattu,2466,296,402,2,2358,34277,296,5,0,34578,31678,542
27-09-2020,chennai,10331,1280,936,19,10656,162108,1280,35,0,163423,149601,3166
27-09-2020,coimbatore,4862,596,472,5,4981,29670,596,48,0,30314,24915,418
27-09-2020,cuddalore,1562,256,315,5,1498,19228,256,202,0,19686,17968,220
27-09-2020,dharmapuri,1123,93,185,0,1031,3280,93,214,0,3587,2532,24
27-09-2020,dindigul,561,39,119,2,479,8626,39,77,0,8742,8104,159
27-09-2020,erode,1121,125,170,2,1074,6169,125,94,0,6388,5230,84
27-09-2020,kallakurichi,565,26,80,0,511,8604,26,404,0,9034,8428,95
27-09-2020,kancheepuram,1038,196,288,2,944,21394,196,3,0,21593,20340,309
27-09-2020,kanyakumari,938,92,49,1,980,12212,92,109,0,12413,11215,218
27-09-2020,karur,509,38,59,2,486,2860,38,46,0,2944,2419,39
27-09-2020,krishnagiri,825,66,60,3,828,4088,66,165,0,4319,3431,60
27-09-2020,madurai,711,82,54,1,738,16124,82,153,0,16359,15235,386
27-09-2020,nagapattinam,615,41,82,1,573,4959,41,88,0,5088,4435,80
27-09-2020,namakkal,968,173,120,0,1021,4762,173,92,0,5027,3940,66
27-09-2020,nilgiris,872,161,115,1,917,3630,161,16,0,3807,2866,24
27-09-2020,perambalur,124,14,10,0,128,1763,14,2,0,1779,1631,20
27-09-2020,pudukottai,720,96,72,3,741,8664,96,33,0,8793,7917,135
27-09-2020,ramanathapuram,170,11,27,0,154,5334,11,133,0,5478,5205,119
27-09-2020,ranipet,458,75,89,0,444,13046,75,49,0,13170,12571,155
27-09-2020,salem,2684,378,249,6,2807,17888,378,419,0,18685,15568,310
27-09-2020,sivagangai,298,30,59,1,268,4980,30,60,0,5070,4682,120
27-09-2020,tenkasi,517,30,79,1,467,7088,30,49,0,7167,6566,134
27-09-2020,thanjavur,1228,190,196,2,1220,10339,190,22,0,10551,9162,169
27-09-2020,theni,476,76,5,1,546,14565,76,45,0,14686,13963,177
27-09-2020,thirupathur,583,65,73,0,575,4593,65,110,0,4768,4106,87
27-09-2020,thiruvallur,1619,202,223,2,1596,31442,202,8,0,31652,29515,541
27-09-2020,thiruvannamalai,1008,72,153,0,927,14610,72,393,0,15075,13925,223
27-09-2020,thiruvarur,1060,123,114,1,1068,6790,123,37,0,6950,5812,70
27-09-2020,thoothukudi,632,42,69,0,605,12954,42,260,0,13256,12530,121
27-09-2020,tirunelveli,892,111,97,2,904,11932,111,420,0,12463,11361,198
27-09-2020,tiruppur,1728,282,335,8,1667,7388,282,11,0,7681,5888,126
27-09-2020,trichy,788,83,91,2,778,10156,83,15,0,10254,9331,145
27-09-2020,vellore,886,119,99,3,903,14122,115,156,4,14397,13268,226
27-09-2020,villupuram,972,144,112,1,1003,11032,144,174,0,11350,10250,97
27-09-2020,virudhunagar,243,50,29,1,263,14159,50,104,0,14313,13840,210
27-09-2020,airport surveillance (international),2,0,0,0,2,0,0,924,0,924,921,1
27-09-2020,airport surveillance (domestic),37,1,13,0,25,0,0,942,1,943,918,0
27-09-2020,railway surveillance,2,0,0,0,2,0,0,428,0,428,426,0
28-09-2020,ariyalur,173,36,30,0,179,3653,36,20,0,3709,3491,39
28-09-2020,chengalpattu,2386,249,443,3,2189,34601,249,5,0,34855,32121,545
28-09-2020,chennai,10694,1283,921,13,11043,163426,1283,35,0,164744,150522,3179
28-09-2020,coimbatore,4995,587,459,6,5117,30280,587,48,0,30915,25374,424
28-09-2020,cuddalore,1499,162,168,1,1492,19485,162,202,0,19849,18136,221
28-09-2020,dharmapuri,1038,88,124,0,1002,3380,88,214,0,3682,2656,24
28-09-2020,dindigul,474,51,39,2,484,8660,51,77,0,8788,8143,161
28-09-2020,erode,1078,133,91,0,1120,6298,133,94,0,6525,5321,84
28-09-2020,kallakurichi,516,58,76,0,498,8635,58,404,0,9097,8504,95
28-09-2020,kancheepuram,897,147,144,5,895,21543,147,3,0,21693,20484,314
28-09-2020,kanyakumari,982,98,88,2,990,12306,98,109,0,12513,11303,220
28-09-2020,karur,491,51,50,0,492,2903,51,46,0,3000,2469,39
28-09-2020,krishnagiri,832,94,63,1,862,4158,94,165,0,4417,3494,61
28-09-2020,madurai,735,86,124,1,696,16203,86,153,0,16442,15359,387
28-09-2020,nagapattinam,575,61,107,1,528,5002,61,88,0,5151,4542,81
28-09-2020,namakkal,1026,146,195,4,973,4940,145,92,1,5178,4135,70
28-09-2020,nilgiris,917,137,123,1,930,3791,137,16,0,3944,2989,25
28-09-2020,perambalur,130,26,26,0,130,1779,26,2,0,1807,1657,20
28-09-2020,pudukottai,742,97,118,3,718,8761,97,33,0,8891,8035,138
28-09-2020,ramanathapuram,154,30,30,0,154,5345,30,133,0,5508,5235,119
28-09-2020,ranipet,433,52,84,1,400,13110,52,49,0,13211,12655,156
28-09-2020,salem,2774,256,260,2,2768,18233,256,419,0,18908,15828,312
28-09-2020,sivagangai,269,38,43,0,264,5011,38,60,0,5109,4725,120
28-09-2020,tenkasi,462,53,71,2,442,7113,53,49,0,7215,6637,136
28-09-2020,thanjavur,1222,180,230,3,1169,10531,180,22,0,10733,9392,172
28-09-2020,theni,547,74,94,0,527,14642,74,45,0,14761,14057,177
28-09-2020,thirupathur,576,69,91,4,550,4659,69,110,0,4838,4197,91
28-09-2020,thiruvallur,1581,249,239,2,1589,31630,249,8,0,31887,29754,544
28-09-2020,thiruvannamalai,934,151,108,5,972,14688,151,393,0,15232,14033,227
28-09-2020,thiruvarur,1066,128,114,1,1079,6911,128,37,0,7076,5926,71
28-09-2020,thoothukudi,606,60,73,0,593,12997,60,260,0,13317,12603,121
28-09-2020,tirunelveli,896,63,101,1,857,12035,63,420,0,12518,11462,199
28-09-2020,tiruppur,1655,198,217,3,1633,7658,198,11,0,7867,6105,129
28-09-2020,trichy,773,96,101,0,768,10234,95,15,1,10345,9432,145
28-09-2020,vellore,906,135,153,3,885,14240,125,160,10,14535,13421,229
28-09-2020,villupuram,1005,131,139,0,997,11178,131,174,0,11483,10389,97
28-09-2020,virudhunagar,273,36,17,0,292,14219,36,104,0,14359,13857,210
28-09-2020,airport surveillance (international),2,0,0,0,2,0,0,924,0,924,921,1
28-09-2020,airport surveillance (domestic),25,0,0,0,25,0,0,943,0,943,918,0
28-09-2020,railway surveillance,2,0,0,0,2,0,0,428,0,428,426,0
29-09-2020,ariyalur,180,16,11,0,185,3690,16,20,0,3726,3502,39
29-09-2020,chengalpattu,2232,330,372,6,2184,34893,330,5,0,35228,32493,551
29-09-2020,chennai,11052,1277,1119,17,11193,164717,1277,35,0,166029,151641,3195
29-09-2020,coimbatore,5119,572,534,1,5156,30869,572,48,0,31489,25908,425
29-09-2020,cuddalore,1489,109,123,2,1473,19644,109,202,0,19955,18259,223
29-09-2020,dharmapuri,1003,93,158,0,938,3469,93,214,0,3776,2814,24
29-09-2020,dindigul,484,34,29,0,489,8711,34,77,0,8822,8172,161
29-09-2020,erode,1111,126,133,4,1100,6422,126,94,0,6642,5454,88
29-09-2020,kallakurichi,489,66,117,1,437,8684,66,404,0,9154,8621,96
29-09-2020,kancheepuram,849,159,120,1,887,21644,159,3,0,21806,20604,315
29-09-2020,kanyakumari,990,97,204,1,882,12404,97,109,0,12610,11507,221
29-09-2020,karur,479,42,89,0,432,2941,42,46,0,3029,2558,39
29-09-2020,krishnagiri,863,94,109,1,847,4253,94,165,0,4512,3603,62
29-09-2020,madurai,698,96,50,2,742,16291,96,153,0,16540,15409,389
29-09-2020,nagapattinam,533,38,68,0,503,5068,38,88,0,5194,4610,81
29-09-2020,namakkal,982,140,62,1,1059,5094,140,93,0,5327,4197,71
29-09-2020,nilgiris,930,149,126,0,953,3928,146,16,3,4093,3115,25
29-09-2020,perambalur,130,15,7,0,138,1805,15,2,0,1822,1664,20
29-09-2020,pudukottai,720,99,95,1,723,8860,99,33,0,8992,8130,139
29-09-2020,ramanathapuram,156,20,26,0,150,5377,20,133,0,5530,5261,119
29-09-2020,ranipet,400,95,54,0,441,13162,95,49,0,13306,12709,156
29-09-2020,salem,2771,343,341,9,2764,18492,343,419,0,19254,16169,321
29-09-2020,sivagangai,259,41,38,1,261,5044,41,60,0,5145,4763,121
29-09-2020,tenkasi,442,68,62,1,447,7166,68,49,0,7283,6699,137
29-09-2020,thanjavur,1173,186,74,3,1282,10714,186,22,0,10922,9466,174
29-09-2020,theni,527,64,53,0,538,14716,64,45,0,14825,14110,177
29-09-2020,thirupathur,547,79,88,3,535,4724,79,110,0,4913,4285,93
29-09-2020,thiruvallur,1595,279,253,0,1621,31886,279,8,0,32173,30007,545
29-09-2020,thiruvannamalai,972,89,96,2,963,14839,89,393,0,15321,14129,229
29-09-2020,thiruvarur,1074,64,127,0,1011,7035,64,37,0,7136,6053,72
29-09-2020,thoothukudi,593,43,72,1,563,13057,43,260,0,13360,12675,122
29-09-2020,tirunelveli,857,127,101,1,882,12098,127,420,0,12645,11563,200
29-09-2020,tiruppur,1636,153,204,2,1583,7859,153,11,0,8023,6309,131
29-09-2020,trichy,769,83,73,0,779,10330,81,16,2,10429,9505,145
29-09-2020,vellore,879,125,139,8,857,14360,122,170,3,14655,13560,238
29-09-2020,villupuram,1002,98,135,1,964,11314,98,174,0,11586,10524,98
29-09-2020,virudhunagar,292,36,29,0,299,14255,36,104,0,14395,13886,210
29-09-2020,airport surveillance (international),2,0,0,0,2,0,0,924,0,924,921,1
29-09-2020,airport surveillance (domestic),25,1,10,0,16,0,0,943,1,944,928,0
29-09-2020,railway surveillance,2,0,0,0,2,0,0,428,0,428,426,0
30-09-2020,ariyalur,181,31,27,0,185,3702,31,20,0,3753,3529,39
30-09-2020,chengalpattu,2211,335,373,3,2170,35250,335,5,0,35590,32866,554
30-09-2020,chennai,11246,1295,1205,16,11320,166046,1295,35,0,167376,152846,3210
30-09-2020,coimbatore,5161,574,697,11,5027,31446,574,48,0,32068,26605,436
30-09-2020,cuddalore,1477,137,128,4,1482,19757,137,202,0,20096,18387,227
30-09-2020,dharmapuri,939,41,63,2,915,3563,41,214,0,3818,2877,26
30-09-2020,dindigul,479,32,97,0,414,8735,32,77,0,8844,8269,161
30-09-2020,erode,1073,161,116,1,1117,6521,161,94,0,6776,5570,89
30-09-2020,kallakurichi,427,41,64,0,404,8740,41,404,0,9185,8685,96
30-09-2020,kancheepuram,842,207,161,1,887,21759,207,3,0,21969,20765,317
30-09-2020,kanyakumari,882,97,93,1,885,12501,97,109,0,12707,11600,222
30-09-2020,karur,434,56,27,1,462,2985,56,46,0,3087,2585,40
30-09-2020,krishnagiri,849,75,109,1,814,4349,75,165,0,4589,3712,63
30-09-2020,madurai,743,88,106,0,725,16388,88,153,0,16629,15515,389
30-09-2020,nagapattinam,503,48,62,1,488,5106,48,88,0,5242,4672,82
30-09-2020,namakkal,1060,161,154,1,1066,5235,161,93,0,5489,4351,72
30-09-2020,nilgiris,953,80,137,0,896,4074,80,19,0,4173,3252,25
30-09-2020,perambalur,140,14,31,0,123,1822,14,2,0,1838,1695,20
30-09-2020,pudukottai,723,88,92,0,719,8959,88,33,0,9080,8222,139
30-09-2020,ramanathapuram,150,12,13,0,149,5397,12,133,0,5542,5274,119
30-09-2020,ranipet,443,82,70,0,455,13259,82,49,0,13390,12779,156
30-09-2020,salem,2771,378,350,5,2794,18842,378,419,0,19639,16519,326
30-09-2020,sivagangai,261,27,43,0,245,5085,27,60,0,5172,4806,121
30-09-2020,tenkasi,447,38,69,0,416,7235,38,49,0,7322,6768,138
30-09-2020,thanjavur,1288,266,37,4,1513,10906,266,22,0,11194,9503,178
30-09-2020,theni,539,68,110,0,497,14781,68,45,0,14894,14220,177
30-09-2020,thirupathur,536,58,82,1,511,4804,58,110,0,4972,4367,94
30-09-2020,thiruvallur,1560,275,188,0,1647,32104,275,8,0,32387,30195,545
30-09-2020,thiruvannamalai,990,147,125,3,1009,14955,147,393,0,15495,14254,232
30-09-2020,thiruvarur,1011,56,115,0,952,7099,56,37,0,7192,6168,72
30-09-2020,thoothukudi,562,91,66,0,587,13099,91,260,0,13450,12741,122
30-09-2020,tirunelveli,874,93,70,0,897,12216,93,420,0,12729,11633,199
30-09-2020,tiruppur,1603,137,143,6,1591,8032,137,11,0,8180,6452,137
30-09-2020,trichy,780,97,102,0,775,10412,97,18,0,10527,9607,145
30-09-2020,vellore,855,139,142,4,848,14480,132,173,7,14792,13702,242
30-09-2020,villupuram,967,112,100,0,979,11415,112,174,0,11701,10624,98
30-09-2020,virudhunagar,301,16,37,1,279,14293,16,104,0,14413,13923,211
30-09-2020,airport surveillance (international),2,0,0,0,2,0,0,924,0,924,921,1
30-09-2020,airport surveillance (domestic),16,6,6,0,16,0,0,944,6,950,934,0
30-09-2020,railway surveillance,2,0,0,0,2,0,0,428,0,428,426,0
01-10-2020,ariyalur,186,34,37,0,183,3734,34,20,0,3788,3566,39
01-10-2020,chengalpattu,2170,356,474,6,2046,35585,356,5,0,35946,33340,560
01-10-2020,chennai,11344,1289,1000,18,11615,167365,1289,35,0,168689,153846,3228
01-10-2020,coimbatore,5029,550,511,8,5060,32022,550,48,0,32620,27116,444
01-10-2020,cuddalore,1482,180,162,0,1500,19894,180,202,0,20276,18549,227
01-10-2020,dharmapuri,892,79,71,0,900,3581,79,214,0,3874,2948,26
01-10-2020,dindigul,412,43,45,2,408,8765,43,77,0,8885,8314,163
01-10-2020,erode,1117,145,150,2,1110,6682,145,94,0,6921,5720,91
01-10-2020,kallakurichi,404,50,60,1,393,8781,50,404,0,9235,8745,97
01-10-2020,kancheepuram,892,148,152,1,887,21971,148,3,0,22122,20917,318
01-10-2020,kanyakumari,885,118,186,1,816,12598,118,109,0,12825,11786,223
01-10-2020,karur,463,47,41,0,469,3042,47,46,0,3135,2626,40
01-10-2020,krishnagiri,836,87,109,1,813,4446,87,165,0,4698,3821,64
01-10-2020,madurai,720,82,80,0,722,16471,82,153,0,16706,15595,389
01-10-2020,nagapattinam,489,54,72,1,470,5155,54,88,0,5297,4744,83
01-10-2020,namakkal,1068,111,115,1,1063,5398,111,93,0,5602,4466,73
01-10-2020,nilgiris,896,72,118,0,850,4154,72,19,0,4245,3370,25
01-10-2020,perambalur,125,23,18,0,130,1838,23,2,0,1863,1713,20
01-10-2020,pudukottai,719,87,79,0,727,9047,87,33,0,9167,8301,139
01-10-2020,ramanathapuram,149,9,19,0,139,5409,9,133,0,5551,5293,119
01-10-2020,ranipet,453,89,81,3,458,13339,89,49,0,13477,12860,159
01-10-2020,salem,2793,341,378,3,2753,19219,341,419,0,19979,16897,329
01-10-2020,sivagangai,241,36,38,0,239,5108,36,60,0,5204,4844,121
01-10-2020,tenkasi,420,49,69,1,399,7277,49,49,0,7375,6837,139
01-10-2020,thanjavur,1514,232,35,2,1709,11173,232,22,0,11427,9538,180
01-10-2020,theni,497,65,69,0,493,14849,65,45,0,14959,14289,177
01-10-2020,thirupathur,511,83,78,4,512,4862,83,110,0,5055,4445,98
01-10-2020,thiruvallur,1622,260,236,5,1641,32354,260,8,0,32622,30431,550
01-10-2020,thiruvannamalai,1015,88,130,0,973,15108,88,393,0,15589,14384,232
01-10-2020,thiruvarur,952,123,110,1,964,7155,123,37,0,7315,6278,73
01-10-2020,thoothukudi,586,75,113,0,548,13189,75,260,0,13524,12854,122
01-10-2020,tirunelveli,891,86,70,0,907,12303,86,420,0,12809,11703,199
01-10-2020,tiruppur,1592,192,169,0,1615,8170,192,11,0,8373,6621,137
01-10-2020,trichy,771,89,109,3,748,10505,89,18,0,10612,9716,148
01-10-2020,vellore,846,149,124,2,869,14610,146,180,3,14939,13826,244
01-10-2020,villupuram,980,134,147,0,967,11528,134,174,0,11836,10771,98
01-10-2020,virudhunagar,281,31,61,0,251,14311,31,104,0,14446,13984,211
01-10-2020,airport surveillance (international),2,0,0,0,2,0,0,924,0,924,921,1
01-10-2020,airport surveillance (domestic),16,2,0,0,18,0,0,950,2,952,934,0
01-10-2020,railway surveillance,2,0,0,0,2,0,0,428,0,428,426,0
02-10-2020,ariyalur,184,28,11,1,200,3769,28,20,0,3817,3577,40
02-10-2020,chengalpattu,2062,396,130,1,2327,35957,396,5,0,36358,33470,561
02-10-2020,chennai,11674,1278,925,14,12013,168712,1278,35,0,170025,154771,3241
02-10-2020,coimbatore,5061,495,637,6,4913,32573,495,48,0,33116,27753,450
02-10-2020,cuddalore,1500,166,287,3,1376,20074,166,202,0,20442,18836,230
02-10-2020,dharmapuri,901,62,69,1,893,3661,62,214,0,3937,3017,27
02-10-2020,dindigul,411,42,59,2,392,8811,42,77,0,8930,8373,165
02-10-2020,erode,1113,194,143,0,1164,6830,194,94,0,7118,5863,91
02-10-2020,kallakurichi,392,55,91,0,356,8830,55,404,0,9289,8836,97
02-10-2020,kancheepuram,869,157,148,3,875,22102,157,3,0,22262,21065,322
02-10-2020,kanyakumari,818,90,118,1,789,12718,90,109,0,12917,11904,224
02-10-2020,karur,454,52,55,1,450,3074,52,46,0,3172,2681,41
02-10-2020,krishnagiri,814,76,97,0,793,4534,76,165,0,4775,3918,64
02-10-2020,madurai,704,85,82,2,705,16535,85,153,0,16773,15677,391
02-10-2020,nagapattinam,477,32,42,1,466,5216,32,88,0,5336,4786,84
02-10-2020,namakkal,1065,163,186,3,1039,5511,163,93,0,5767,4652,76
02-10-2020,nilgiris,850,73,120,0,803,4226,73,19,0,4318,3490,25
02-10-2020,perambalur,130,17,18,0,129,1861,17,2,0,1880,1731,20
02-10-2020,pudukottai,733,93,98,2,726,9140,93,33,0,9266,8399,141
02-10-2020,ramanathapuram,141,15,5,0,151,5420,15,133,0,5568,5298,119
02-10-2020,ranipet,461,73,41,2,491,13431,73,49,0,13553,12901,161
02-10-2020,salem,2753,355,476,8,2624,19560,355,419,0,20334,17373,337
02-10-2020,sivagangai,239,26,48,0,217,5144,26,60,0,5230,4892,121
02-10-2020,tenkasi,400,35,42,1,392,7327,35,49,0,7411,6879,140
02-10-2020,thanjavur,1706,226,183,3,1746,11402,226,22,0,11650,9721,183
02-10-2020,theni,493,85,71,0,507,14914,85,45,0,15044,14360,177
02-10-2020,thirupathur,508,76,82,0,502,4941,76,110,0,5127,4527,98
02-10-2020,thiruvallur,1586,255,222,2,1617,32559,255,8,0,32822,30653,552
02-10-2020,thiruvannamalai,978,120,125,3,970,15201,120,393,0,15714,14509,235
02-10-2020,thiruvarur,957,149,171,0,935,7271,149,37,0,7457,6449,73
02-10-2020,thoothukudi,546,45,74,0,517,13262,45,260,0,13567,12928,122
02-10-2020,tirunelveli,902,78,114,0,866,12384,78,420,0,12882,11817,199
02-10-2020,tiruppur,1623,149,159,2,1611,8370,149,11,0,8530,6780,139
02-10-2020,trichy,753,91,100,3,741,10599,91,18,0,10708,9816,151
02-10-2020,vellore,868,134,149,2,851,14755,129,183,5,15072,13975,246
02-10-2020,villupuram,970,97,153,0,914,11665,97,174,0,11936,10924,98
02-10-2020,virudhunagar,251,30,65,0,216,14342,30,104,0,14476,14049,211
02-10-2020,airport surveillance (international),2,0,0,0,2,0,0,924,0,924,921,1
02-10-2020,airport surveillance (domestic),18,2,7,0,13,0,0,952,2,954,941,0
02-10-2020,railway surveillance,2,0,0,0,2,0,0,428,0,428,426,0
03-10-2020,ariyalur,197,38,31,0,204,3793,38,20,0,3851,3608,39
03-10-2020,chengalpattu,2318,395,213,2,2498,36345,395,5,0,36745,33683,564
03-10-2020,chennai,12039,1364,1071,21,12311,170016,1364,35,0,171415,155842,3262
03-10-2020,coimbatore,4922,486,685,5,4718,33077,486,48,0,33611,28438,455
03-10-2020,cuddalore,1387,145,106,6,1420,20251,145,202,0,20598,18942,236
03-10-2020,dharmapuri,894,76,75,2,893,3724,76,214,0,4014,3092,29
03-10-2020,dindigul,393,38,39,1,391,8854,38,77,0,8969,8412,166
03-10-2020,erode,1166,144,178,0,1132,7026,144,94,0,7264,6041,91
03-10-2020,kallakurichi,371,35,49,0,357,8900,35,404,0,9339,8885,97
03-10-2020,kancheepuram,880,150,152,3,875,22264,150,3,0,22417,21217,325
03-10-2020,kanyakumari,790,93,91,0,792,12809,93,109,0,13011,11995,224
03-10-2020,karur,450,40,17,0,473,3126,40,46,0,3212,2698,41
03-10-2020,krishnagiri,793,75,58,2,808,4610,75,165,0,4850,3976,66
03-10-2020,madurai,677,85,89,0,673,16592,85,153,0,16830,15766,391
03-10-2020,nagapattinam,472,46,49,0,469,5254,46,88,0,5388,4835,84
03-10-2020,namakkal,1032,150,129,0,1053,5667,150,93,0,5910,4781,76
03-10-2020,nilgiris,798,146,101,0,843,4294,146,19,0,4459,3591,25
03-10-2020,perambalur,133,11,16,0,128,1882,11,2,0,1895,1747,20
03-10-2020,pudukottai,728,65,78,2,713,9235,65,33,0,9333,8477,143
03-10-2020,ramanathapuram,154,16,12,0,158,5438,16,133,0,5587,5310,119
03-10-2020,ranipet,485,53,91,0,447,13498,53,49,0,13600,12992,161
03-10-2020,salem,2628,351,331,7,2641,19919,351,419,0,20689,17704,344
03-10-2020,sivagangai,218,37,25,0,230,5171,37,60,0,5268,4917,121
03-10-2020,tenkasi,395,30,58,0,367,7365,30,49,0,7444,6937,140
03-10-2020,thanjavur,1752,244,335,1,1660,11634,244,22,0,11900,10056,184
03-10-2020,theni,510,66,66,0,510,15002,66,45,0,15113,14426,177
03-10-2020,thirupathur,502,89,105,1,485,5017,89,110,0,5216,4632,99
03-10-2020,thiruvallur,1609,290,210,5,1684,32806,290,8,0,33104,30863,557
03-10-2020,thiruvannamalai,974,69,177,0,866,15325,69,393,0,15787,14686,235
03-10-2020,thiruvarur,935,143,114,1,963,7420,143,37,0,7600,6563,74
03-10-2020,thoothukudi,518,75,52,0,541,13308,75,260,0,13643,12980,122
03-10-2020,tirunelveli,860,76,87,0,849,12456,76,420,0,12952,11904,199
03-10-2020,tiruppur,1612,167,286,3,1490,8520,167,11,0,8698,7066,142
03-10-2020,trichy,729,85,80,1,733,10678,85,18,0,10781,9896,152
03-10-2020,vellore,851,135,128,1,857,14884,133,188,2,15207,14103,247
03-10-2020,villupuram,888,73,158,0,803,11736,73,174,0,11983,11082,98
03-10-2020,virudhunagar,217,35,54,1,197,14373,35,104,0,14512,14103,212
03-10-2020,airport surveillance (international),2,0,0,0,2,0,0,924,0,924,921,1
03-10-2020,airport surveillance (domestic),13,6,0,0,19,0,0,954,6,960,941,0
03-10-2020,railway surveillance,2,0,0,0,2,0,0,428,0,428,426,0
04-10-2020,ariyalur,204,41,3,1,241,3831,41,20,0,3892,3611,40
04-10-2020,chengalpattu,2521,381,297,6,2599,36764,381,5,0,37150,33980,571
04-10-2020,chennai,12321,1348,1374,12,12283,171390,1348,35,0,172773,157216,3274
04-10-2020,coimbatore,4722,474,301,7,4888,33567,474,48,0,34089,28739,462
04-10-2020,cuddalore,1420,141,125,1,1435,20396,141,202,0,20739,19067,237
04-10-2020,dharmapuri,894,59,188,1,764,3801,59,214,0,4074,3280,30
04-10-2020,dindigul,382,48,68,1,361,8882,48,77,0,9007,8480,166
04-10-2020,erode,1113,149,148,1,1113,7152,149,94,0,7395,6189,93
04-10-2020,kallakurichi,357,30,37,1,349,8935,30,404,0,9369,8922,98
04-10-2020,kancheepuram,849,146,100,2,893,22387,146,3,0,22536,21317,326
04-10-2020,kanyakumari,793,117,106,1,803,12903,117,109,0,13129,12101,225
04-10-2020,karur,476,52,98,0,430,3169,52,46,0,3267,2796,41
04-10-2020,krishnagiri,804,73,86,3,788,4681,73,165,0,4919,4062,69
04-10-2020,madurai,675,82,47,2,708,16679,82,153,0,16914,15813,393
04-10-2020,nagapattinam,471,20,58,1,432,5302,20,88,0,5410,4893,85
04-10-2020,namakkal,1065,165,167,0,1063,5829,165,93,0,6087,4948,76
04-10-2020,nilgiris,843,122,153,3,809,4440,122,19,0,4581,3744,28
04-10-2020,perambalur,128,11,23,0,116,1893,11,2,0,1906,1770,20
04-10-2020,pudukottai,715,72,95,1,691,9302,72,33,0,9407,8572,144
04-10-2020,ramanathapuram,158,22,19,1,160,5454,22,133,0,5609,5329,120
04-10-2020,ranipet,446,71,60,0,457,13550,71,49,0,13670,13052,161
04-10-2020,salem,2644,357,306,3,2692,20273,357,419,0,21049,18010,347
04-10-2020,sivagangai,230,36,29,0,237,5208,36,60,0,5304,4946,121
04-10-2020,tenkasi,371,35,54,3,349,7399,35,49,0,7483,6991,143
04-10-2020,thanjavur,1661,242,311,1,1591,11879,242,22,0,12143,10367,185
04-10-2020,theni,510,60,67,2,501,15068,60,45,0,15173,14493,179
04-10-2020,thirupathur,488,80,83,2,483,5109,80,110,0,5299,4715,101
04-10-2020,thiruvallur,1686,197,153,3,1727,33098,197,8,0,33303,31016,560
04-10-2020,thiruvannamalai,867,104,140,0,831,15395,104,393,0,15892,14826,235
04-10-2020,thiruvarur,961,148,128,0,981,7561,148,37,0,7746,6691,74
04-10-2020,thoothukudi,543,53,51,1,544,13385,53,260,0,13698,13031,123
04-10-2020,tirunelveli,844,76,101,0,819,12527,76,420,0,13023,12005,199
04-10-2020,tiruppur,1497,147,241,2,1401,8694,147,11,0,8852,7307,144
04-10-2020,trichy,726,68,41,3,750,10756,68,18,0,10842,9937,155
04-10-2020,vellore,847,140,145,1,841,15007,138,190,2,15337,14248,248
04-10-2020,villupuram,803,59,124,0,738,11809,59,174,0,12042,11206,98
04-10-2020,virudhunagar,197,58,30,0,225,14408,58,104,0,14570,14133,212
04-10-2020,airport surveillance (international),2,0,0,0,2,0,0,924,0,924,921,1
04-10-2020,airport surveillance (domestic),19,5,1,0,23,0,0,960,5,965,942,0
04-10-2020,railway surveillance,2,0,0,0,2,0,0,428,0,428,426,0
05-10-2020,ariyalur,241,34,51,1,223,3872,34,20,0,3926,3662,41
05-10-2020,chengalpattu,2600,343,215,3,2725,37146,343,5,0,37494,34195,574
05-10-2020,chennai,12286,1367,1074,19,12560,172741,1367,35,0,174143,158290,3293
05-10-2020,coimbatore,4889,468,460,7,4890,34042,468,48,0,34558,29199,469
05-10-2020,cuddalore,1436,129,188,0,1377,20538,129,202,0,20869,19255,237
05-10-2020,dharmapuri,763,83,84,0,762,3859,83,214,0,4156,3364,30
05-10-2020,dindigul,367,49,43,2,371,8936,49,77,0,9062,8523,168
05-10-2020,erode,1114,92,117,2,1087,7302,92,94,0,7488,6306,95
05-10-2020,kallakurichi,343,57,40,0,360,8959,57,404,0,9420,8962,98
05-10-2020,kancheepuram,893,155,169,3,876,22533,155,3,0,22691,21486,329
05-10-2020,kanyakumari,803,98,158,2,741,13020,98,109,0,13227,12259,227
05-10-2020,karur,424,33,42,0,415,3215,33,46,0,3294,2838,41
05-10-2020,krishnagiri,790,72,117,0,745,4756,72,165,0,4993,4179,69
05-10-2020,madurai,686,78,103,1,660,16739,78,153,0,16970,15916,394
05-10-2020,nagapattinam,437,85,49,0,473,5327,85,88,0,5500,4942,85
05-10-2020,namakkal,1060,147,144,2,1061,5991,147,93,0,6231,5092,78
05-10-2020,nilgiris,805,169,122,0,852,4558,169,19,0,4746,3866,28
05-10-2020,perambalur,117,10,24,0,103,1905,10,2,0,1917,1794,20
05-10-2020,pudukottai,694,75,98,1,670,9377,75,33,0,9485,8670,145
05-10-2020,ramanathapuram,160,20,17,0,163,5476,20,133,0,5629,5346,120
05-10-2020,ranipet,446,46,88,2,402,13610,46,49,0,13705,13140,163
05-10-2020,salem,2692,337,373,1,2655,20630,337,419,0,21386,18383,348
05-10-2020,sivagangai,239,30,36,0,233,5246,30,60,0,5336,4982,121
05-10-2020,tenkasi,351,38,63,2,324,7436,38,49,0,7523,7054,145
05-10-2020,thanjavur,1591,251,399,2,1441,12121,251,22,0,12394,10766,187
05-10-2020,theni,503,61,76,1,487,15130,61,45,0,15236,14569,180
05-10-2020,thirupathur,484,79,99,4,460,5190,79,110,0,5379,4814,105
05-10-2020,thiruvallur,1730,195,207,1,1717,33298,195,8,0,33501,31223,561
05-10-2020,thiruvannamalai,834,86,75,0,845,15502,86,393,0,15981,14901,235
05-10-2020,thiruvarur,979,98,143,0,934,7707,98,37,0,7842,6834,74
05-10-2020,thoothukudi,544,55,56,0,543,13438,55,260,0,13753,13087,123
05-10-2020,tirunelveli,816,81,80,0,817,12600,81,420,0,13101,12085,199
05-10-2020,tiruppur,1406,132,152,3,1383,8846,132,11,0,8989,7459,147
05-10-2020,trichy,750,77,103,0,724,10824,77,18,0,10919,10040,155
05-10-2020,vellore,847,137,130,2,852,15151,133,192,4,15480,14378,250
05-10-2020,villupuram,745,80,140,0,685,11875,80,174,0,12129,11346,98
05-10-2020,virudhunagar,228,45,37,1,235,14469,45,104,0,14618,14170,213
05-10-2020,airport surveillance (international),2,0,0,0,2,0,0,924,0,924,921,1
05-10-2020,airport surveillance (domestic),23,3,0,0,26,0,0,965,3,968,942,0
05-10-2020,railway surveillance,2,0,0,0,2,0,0,428,0,428,426,0
06-10-2020,ariyalur,221,32,26,1,226,3903,32,20,0,3955,3688,41
06-10-2020,chengalpattu,2705,283,357,2,2629,37469,283,5,0,37757,34552,576
06-10-2020,chennai,12595,1306,947,25,12929,174143,1306,35,0,175484,159237,3318
06-10-2020,coimbatore,4898,434,494,1,4837,34518,434,48,0,35000,29693,470
06-10-2020,cuddalore,1376,145,276,2,1243,20666,145,202,0,21013,19531,239
06-10-2020,dharmapuri,746,84,88,0,742,3926,84,214,0,4224,3452,30
06-10-2020,dindigul,372,40,37,1,374,8986,40,77,0,9103,8560,169
06-10-2020,erode,1065,91,116,0,1040,7372,91,94,0,7557,6422,95
06-10-2020,kallakurichi,360,30,48,0,342,9016,30,404,0,9450,9010,98
06-10-2020,kancheepuram,880,156,143,7,886,22692,156,3,0,22851,21629,336
06-10-2020,kanyakumari,741,95,72,0,764,13118,95,109,0,13322,12331,227
06-10-2020,karur,410,38,75,0,373,3243,38,46,0,3327,2913,41
06-10-2020,krishnagiri,757,64,57,0,764,4840,64,165,0,5069,4236,69
06-10-2020,madurai,654,80,44,0,690,16811,80,153,0,17044,15960,394
06-10-2020,nagapattinam,476,62,36,0,502,5415,62,88,0,5565,4978,85
06-10-2020,namakkal,1066,146,135,2,1075,6143,145,93,1,6382,5227,80
06-10-2020,nilgiris,854,87,109,1,831,4729,87,19,0,4835,3975,29
06-10-2020,perambalur,105,8,21,0,92,1917,8,2,0,1927,1815,20
06-10-2020,pudukottai,671,71,99,0,643,9453,71,33,0,9557,8769,145
06-10-2020,ramanathapuram,163,18,19,0,162,5496,18,133,0,5647,5365,120
06-10-2020,ranipet,405,55,68,0,392,13660,55,49,0,13764,13208,164
06-10-2020,salem,2659,326,372,9,2604,20971,326,419,0,21716,18755,357
06-10-2020,sivagangai,228,25,46,0,207,5271,25,60,0,5356,5028,121
06-10-2020,tenkasi,324,17,44,0,297,7474,17,49,0,7540,7098,145
06-10-2020,thanjavur,1439,224,344,1,1318,12370,224,22,0,12616,11110,188
06-10-2020,theni,487,59,74,2,470,15191,59,45,0,15295,14643,182
06-10-2020,thirupathur,461,42,77,1,425,5270,42,110,0,5422,4891,106
06-10-2020,thiruvallur,1699,263,207,6,1749,33475,263,8,0,33746,31430,567
06-10-2020,thiruvannamalai,846,84,174,1,755,15589,84,393,0,16066,15075,236
06-10-2020,thiruvarur,932,103,165,0,870,7803,103,37,0,7943,6999,74
06-10-2020,thoothukudi,544,35,70,0,509,13494,35,260,0,13789,13157,123
06-10-2020,tirunelveli,816,73,105,1,783,12680,73,420,0,13173,12190,200
06-10-2020,tiruppur,1393,152,254,3,1288,8988,152,11,0,9151,7713,150
06-10-2020,trichy,730,78,80,1,727,10907,78,18,0,11003,10120,156
06-10-2020,vellore,849,108,134,3,820,15281,106,196,2,15585,14512,253
06-10-2020,villupuram,688,83,104,1,666,11958,83,174,0,12215,11450,99
06-10-2020,virudhunagar,236,20,31,0,225,14515,20,104,0,14639,14201,213
06-10-2020,airport surveillance (international),2,0,0,0,2,0,0,924,0,924,921,1
06-10-2020,airport surveillance (domestic),26,0,0,0,26,0,0,968,0,968,942,0
06-10-2020,railway surveillance,2,0,0,0,2,0,0,428,0,428,426,0
07-10-2020,ariyalur,227,35,53,1,208,3936,35,20,0,3991,3741,42
07-10-2020,chengalpattu,2651,324,315,3,2657,37774,324,5,0,38103,34867,579
07-10-2020,chennai,12855,1369,1096,18,13110,175375,1369,35,0,176779,160333,3336
07-10-2020,coimbatore,4842,473,369,5,4941,34958,473,48,0,35479,30062,476
07-10-2020,cuddalore,1246,138,151,1,1232,20815,138,202,0,21155,19682,241
07-10-2020,dharmapuri,744,82,89,0,737,4012,82,214,0,4308,3541,30
07-10-2020,dindigul,374,49,41,1,381,9026,49,77,0,9152,8601,170
07-10-2020,erode,1036,149,128,0,1057,7459,149,94,0,7702,6550,95
07-10-2020,kallakurichi,340,59,50,0,349,9044,59,404,0,9507,9060,98
07-10-2020,kancheepuram,912,138,152,3,895,22875,138,3,0,23016,21781,340
07-10-2020,kanyakumari,760,97,61,1,795,13209,97,109,0,13415,12392,228
07-10-2020,karur,377,60,32,0,405,3285,60,46,0,3391,2945,41
07-10-2020,krishnagiri,767,72,77,3,759,4907,72,165,0,5144,4313,72
07-10-2020,madurai,688,90,78,1,699,16887,90,153,0,17130,16038,393
07-10-2020,nagapattinam,505,52,45,2,510,5480,52,88,0,5620,5023,87
07-10-2020,namakkal,1072,144,137,4,1075,6285,144,94,0,6523,5364,84
07-10-2020,nilgiris,830,106,123,0,813,4815,106,19,0,4940,4098,29
07-10-2020,perambalur,94,7,10,0,91,1927,7,2,0,1936,1825,20
07-10-2020,pudukottai,646,78,98,1,625,9527,78,33,0,9638,8867,146
07-10-2020,ramanathapuram,164,15,10,0,169,5516,15,133,0,5664,5375,120
07-10-2020,ranipet,393,76,102,1,366,13716,76,49,0,13841,13310,165
07-10-2020,salem,2608,322,515,6,2409,21301,322,419,0,22042,19270,363
07-10-2020,sivagangai,213,30,24,1,218,5302,30,60,0,5392,5052,122
07-10-2020,tenkasi,297,10,36,0,271,7491,10,49,0,7550,7134,145
07-10-2020,thanjavur,1323,242,295,2,1268,12599,242,22,0,12863,11405,190
07-10-2020,theni,473,60,64,0,469,15253,60,45,0,15358,14707,182
07-10-2020,thirupathur,422,76,57,0,441,5309,76,110,0,5495,4948,106
07-10-2020,thiruvallur,1729,252,245,4,1732,33717,252,8,0,33977,31675,570
07-10-2020,thiruvannamalai,764,114,92,4,782,15682,114,393,0,16189,15167,240
07-10-2020,thiruvarur,872,104,171,1,804,7908,104,37,0,8049,7170,75
07-10-2020,thoothukudi,511,65,71,0,505,13531,65,260,0,13856,13228,123
07-10-2020,tirunelveli,782,66,74,0,774,12752,66,420,0,13238,12264,200
07-10-2020,tiruppur,1284,182,318,2,1146,9136,182,11,0,9329,8031,152
07-10-2020,trichy,721,86,92,0,715,10979,86,18,0,11083,10212,156
07-10-2020,vellore,828,145,105,1,867,15395,143,198,2,15738,14617,254
07-10-2020,villupuram,673,36,110,1,598,12048,36,174,0,12258,11560,100
07-10-2020,virudhunagar,226,37,38,0,225,14536,37,104,0,14677,14239,213
07-10-2020,airport surveillance (international),2,0,0,0,2,0,0,924,0,924,921,1
07-10-2020,airport surveillance (domestic),26,7,0,0,33,0,0,968,7,975,942,0
07-10-2020,railway surveillance,2,0,0,0,2,0,0,428,0,428,426,0
08-10-2020,ariyalur,204,20,23,1,200,3967,20,20,0,4007,3764,43
08-10-2020,chengalpattu,2676,363,427,3,2609,38119,363,5,0,38487,35294,584
08-10-2020,chennai,13145,1295,1144,16,13280,176778,1295,35,0,178108,161477,3351
08-10-2020,coimbatore,4947,448,628,3,4764,35437,448,48,0,35933,30690,479
08-10-2020,cuddalore,1234,124,130,3,1225,20955,124,202,0,21281,19812,244
08-10-2020,dharmapuri,737,74,85,2,724,4094,74,214,0,4382,3626,32
08-10-2020,dindigul,380,45,23,1,401,9074,45,77,0,9196,8624,171
08-10-2020,erode,1060,132,118,1,1073,7611,132,94,0,7837,6668,96
08-10-2020,kallakurichi,349,40,44,1,344,9103,40,404,0,9547,9104,99
08-10-2020,kancheepuram,862,137,118,1,880,22980,137,3,0,23120,21899,341
08-10-2020,kanyakumari,795,89,54,2,828,13306,89,109,0,13504,12446,230
08-10-2020,karur,400,47,41,0,406,3340,47,46,0,3433,2986,41
08-10-2020,krishnagiri,763,70,79,3,751,4983,70,165,0,5218,4392,75
08-10-2020,madurai,697,86,67,2,714,16975,86,153,0,17214,16105,395
08-10-2020,nagapattinam,510,41,67,0,484,5532,41,88,0,5661,5090,87
08-10-2020,namakkal,1074,147,184,2,1035,6428,146,94,1,6669,5548,86
08-10-2020,nilgiris,813,92,92,0,813,4921,92,19,0,5032,4190,29
08-10-2020,perambalur,97,9,9,0,97,1940,9,2,0,1951,1834,20
08-10-2020,pudukottai,630,68,79,0,619,9610,68,33,0,9711,8946,146
08-10-2020,ramanathapuram,169,14,27,0,156,5531,14,133,0,5678,5402,120
08-10-2020,ranipet,366,65,84,2,345,13792,65,49,0,13906,13394,167
08-10-2020,salem,2413,362,467,2,2306,21627,362,419,0,22408,19737,365
08-10-2020,sivagangai,215,19,33,0,201,5329,19,60,0,5408,5085,122
08-10-2020,tenkasi,271,8,40,0,239,7501,8,49,0,7558,7174,145
08-10-2020,thanjavur,1274,239,265,5,1243,12847,239,22,0,13108,11670,195
08-10-2020,theni,469,67,66,1,469,15313,67,45,0,15425,14773,183
08-10-2020,thirupathur,437,52,48,0,441,5381,52,110,0,5543,4996,106
08-10-2020,thiruvallur,1716,194,296,4,1610,33952,194,8,0,34154,31971,573
08-10-2020,thiruvannamalai,784,98,142,0,740,15798,98,393,0,16289,15309,240
08-10-2020,thiruvarur,803,51,168,3,683,8011,51,37,0,8099,7338,78
08-10-2020,thoothukudi,504,61,58,0,507,13595,61,260,0,13916,13286,123
08-10-2020,tirunelveli,774,62,86,0,750,12818,62,420,0,13300,12350,200
08-10-2020,tiruppur,1143,173,158,2,1156,9315,173,11,0,9499,8189,154
08-10-2020,trichy,697,84,85,0,696,11047,84,18,0,11149,10297,156
08-10-2020,vellore,864,133,107,7,883,15535,129,200,4,15868,14724,261
08-10-2020,villupuram,599,52,144,0,507,12085,52,174,0,12311,11704,100
08-10-2020,virudhunagar,227,23,27,1,222,14575,23,104,0,14702,14266,214
08-10-2020,airport surveillance (international),2,0,0,0,2,0,0,924,0,924,921,1
08-10-2020,airport surveillance (domestic),33,4,5,0,32,0,0,975,4,979,947,0
08-10-2020,railway surveillance,2,0,0,0,2,0,0,428,0,428,426,0
09-10-2020,ariyalur,199,36,25,1,209,3986,36,20,0,4042,3789,44
09-10-2020,chengalpattu,2586,343,442,6,2481,38459,343,5,0,38807,35736,590
09-10-2020,chennai,13308,1288,1128,22,13446,178101,1288,35,0,179424,162605,3373
09-10-2020,coimbatore,4766,397,413,4,4746,35887,397,48,0,36332,31103,483
09-10-2020,cuddalore,1223,150,142,1,1230,21077,150,202,0,21429,19954,245
09-10-2020,dharmapuri,724,67,82,3,706,4168,67,214,0,4449,3708,35
09-10-2020,dindigul,396,44,18,2,420,9114,44,77,0,9235,8642,173
09-10-2020,erode,1075,137,149,0,1063,7745,137,94,0,7976,6817,96
09-10-2020,kallakurichi,353,37,47,0,343,9152,37,404,0,9593,9151,99
09-10-2020,kancheepuram,859,147,137,2,867,23096,147,3,0,23246,22036,343
09-10-2020,kanyakumari,828,96,103,0,821,13395,96,109,0,13600,12549,230
09-10-2020,karur,406,34,31,0,409,3387,34,46,0,3467,3017,41
09-10-2020,krishnagiri,753,84,90,1,746,5055,84,165,0,5304,4482,76
09-10-2020,madurai,717,93,59,1,750,17064,93,153,0,17310,16164,396
09-10-2020,nagapattinam,488,51,49,0,490,5577,51,88,0,5716,5139,87
09-10-2020,namakkal,1036,148,134,0,1050,6575,147,95,1,6818,5682,86
09-10-2020,nilgiris,813,109,96,0,826,5013,109,19,0,5141,4286,29
09-10-2020,perambalur,100,7,14,0,93,1952,7,2,0,1961,1848,20
09-10-2020,pudukottai,620,69,88,0,601,9679,69,33,0,9781,9034,146
09-10-2020,ramanathapuram,156,22,20,3,155,5545,22,133,0,5700,5422,123
09-10-2020,ranipet,340,62,75,3,324,13852,62,49,0,13963,13469,170
09-10-2020,salem,2309,295,364,3,2237,21992,295,419,0,22706,20101,368
09-10-2020,sivagangai,200,27,26,0,201,5347,27,60,0,5434,5111,122
09-10-2020,tenkasi,239,14,37,1,215,7509,14,49,0,7572,7211,146
09-10-2020,thanjavur,1243,240,261,1,1221,13086,240,22,0,13348,11931,196
09-10-2020,theni,470,64,65,2,467,15381,64,45,0,15490,14838,185
09-10-2020,thirupathur,441,68,48,1,460,5433,68,110,0,5611,5044,107
09-10-2020,thiruvallur,1618,226,222,1,1621,34154,226,8,0,34388,32193,574
09-10-2020,thiruvannamalai,748,93,93,2,746,15904,93,393,0,16390,15402,242
09-10-2020,thiruvarur,682,113,170,0,625,8061,113,37,0,8211,7508,78
09-10-2020,thoothukudi,508,77,75,1,509,13657,68,260,9,13994,13361,124
09-10-2020,tirunelveli,750,72,96,1,725,12880,72,420,0,13372,12446,201
09-10-2020,tiruppur,1157,159,197,1,1118,9489,159,11,0,9659,8386,155
09-10-2020,trichy,691,81,90,0,682,11126,81,18,0,11225,10387,156
09-10-2020,vellore,883,141,158,5,861,15664,133,204,8,16009,14882,266
09-10-2020,villupuram,494,73,85,0,482,12124,73,174,0,12371,11789,100
09-10-2020,virudhunagar,222,20,27,0,215,14598,20,104,0,14722,14293,214
09-10-2020,airport surveillance (international),2,0,0,0,2,0,0,924,0,924,921,1
09-10-2020,airport surveillance (domestic),32,1,1,0,32,0,0,979,1,980,948,0
09-10-2020,railway surveillance,2,0,0,0,2,0,0,428,0,428,426,0
11-10-2020,ariyalur,211,37,9,0,239,4048,37,20,0,4105,3822,44
11-10-2020,chengalpattu,2303,258,364,2,2195,39084,258,5,0,39347,36555,597
11-10-2020,chennai,13590,1250,1070,19,13751,180729,1250,35,0,182014,164848,3415
11-10-2020,coimbatore,4922,389,390,4,4917,36680,389,48,0,37117,31709,491
11-10-2020,cuddalore,1209,84,153,2,1138,21373,84,202,0,21659,20272,249
11-10-2020,dharmapuri,735,86,79,4,738,4310,86,214,0,4610,3833,39
11-10-2020,dindigul,407,35,52,0,390,9195,35,77,0,9307,8744,173
11-10-2020,erode,1068,163,130,2,1099,8019,163,94,0,8276,7076,101
11-10-2020,kallakurichi,334,46,38,0,342,9226,46,404,0,9676,9235,99
11-10-2020,kancheepuram,882,158,141,3,896,23402,158,3,0,23563,22320,347
11-10-2020,kanyakumari,806,79,107,2,776,13575,79,109,0,13763,12753,234
11-10-2020,karur,410,48,65,0,393,3468,48,46,0,3562,3126,43
11-10-2020,krishnagiri,789,88,84,0,793,5233,88,165,0,5486,4614,79
11-10-2020,madurai,740,97,60,1,776,17236,97,153,0,17486,16312,398
11-10-2020,nagapattinam,500,61,47,2,512,5696,61,88,0,5845,5243,90
11-10-2020,namakkal,1080,159,154,1,1084,6885,159,96,0,7140,5969,87
11-10-2020,nilgiris,808,128,137,0,799,5219,128,19,0,5366,4537,30
11-10-2020,perambalur,98,12,16,0,94,1979,12,2,0,1993,1879,20
11-10-2020,pudukottai,572,48,64,0,556,9818,48,33,0,9899,9197,146
11-10-2020,ramanathapuram,164,26,4,0,186,5585,26,133,0,5744,5435,123
11-10-2020,ranipet,350,75,78,1,346,14005,75,49,0,14129,13611,172
11-10-2020,salem,2324,294,303,2,2313,22627,294,419,0,23340,20654,373
11-10-2020,sivagangai,203,28,33,1,197,5411,28,60,0,5499,5179,123
11-10-2020,tenkasi,192,19,24,1,186,7546,19,49,0,7614,7280,148
11-10-2020,thanjavur,1054,181,286,2,947,13516,181,22,0,13719,12571,201
11-10-2020,theni,450,64,66,1,447,15521,64,45,0,15630,14997,186
11-10-2020,thirupathur,469,52,66,1,454,5562,52,110,0,5724,5161,109
11-10-2020,thiruvallur,1545,198,158,7,1578,34535,198,8,0,34741,32580,583
11-10-2020,thiruvannamalai,726,98,70,1,753,16101,98,393,0,16592,15594,245
11-10-2020,thiruvarur,606,98,153,3,548,8261,98,37,0,8396,7766,82
11-10-2020,thoothukudi,516,69,54,0,531,13783,69,269,0,14121,13466,124
11-10-2020,tirunelveli,703,77,87,0,693,13015,77,420,0,13512,12617,202
11-10-2020,tiruppur,1118,172,123,0,1167,9849,172,11,0,10032,8710,155
11-10-2020,trichy,695,87,81,0,701,11291,87,18,0,11396,10538,157
11-10-2020,vellore,823,135,163,3,792,15921,135,218,0,16274,15212,270
11-10-2020,villupuram,496,81,56,0,521,12290,81,174,0,12545,11923,101
11-10-2020,virudhunagar,214,35,36,0,213,14690,35,104,0,14829,14401,215
11-10-2020,airport surveillance (international),3,0,0,0,3,0,0,925,0,925,921,1
11-10-2020,airport surveillance (domestic),33,0,4,0,29,0,0,981,0,981,952,0
11-10-2020,railway surveillance,2,0,0,0,2,0,0,428,0,428,426,0
12-10-2020,ariyalur,236,27,17,0,246,4082,27,20,0,4129,3839,44
12-10-2020,chengalpattu,2224,245,315,7,2147,39371,245,5,0,39621,36870,604
12-10-2020,chennai,13776,1212,1219,13,13756,182004,1212,35,0,183251,166067,3428
12-10-2020,coimbatore,4918,393,466,6,4839,37070,393,48,0,37511,32175,497
12-10-2020,cuddalore,1140,132,176,3,1093,21459,132,202,0,21793,20448,252
12-10-2020,dharmapuri,737,84,54,2,765,4395,84,214,0,4693,3887,41
12-10-2020,dindigul,387,34,46,1,374,9227,34,77,0,9338,8790,174
12-10-2020,erode,1103,146,155,1,1093,8186,146,94,0,8426,7231,102
12-10-2020,kallakurichi,347,41,65,0,323,9277,41,404,0,9722,9300,99
12-10-2020,kancheepuram,856,139,164,2,829,23520,139,3,0,23662,22484,349
12-10-2020,kanyakumari,776,86,70,2,790,13654,86,109,0,13849,12823,236
12-10-2020,karur,389,41,20,0,410,3512,41,46,0,3599,3146,43
12-10-2020,krishnagiri,795,98,102,0,791,5323,98,165,0,5586,4716,79
12-10-2020,madurai,776,88,64,0,800,17333,88,153,0,17574,16376,398
12-10-2020,nagapattinam,513,54,37,2,528,5758,54,88,0,5900,5280,92
12-10-2020,namakkal,1080,145,146,1,1078,7040,143,96,2,7281,6115,88
12-10-2020,nilgiris,801,144,148,0,797,5349,144,19,0,5512,4685,30
12-10-2020,perambalur,95,6,11,0,90,1992,6,2,0,2000,1890,20
12-10-2020,pudukottai,558,43,72,0,529,9868,43,33,0,9944,9269,146
12-10-2020,ramanathapuram,186,16,17,1,184,5611,16,133,0,5760,5452,124
12-10-2020,ranipet,342,61,67,0,336,14076,61,49,0,14186,13678,172
12-10-2020,salem,2319,304,332,2,2289,22927,304,419,0,23650,20986,375
12-10-2020,sivagangai,197,25,34,0,188,5439,25,60,0,5524,5213,123
12-10-2020,tenkasi,185,17,21,0,181,7564,17,49,0,7630,7301,148
12-10-2020,thanjavur,946,146,317,2,773,13696,146,22,0,13864,12888,203
12-10-2020,theni,448,60,64,0,444,15586,60,45,0,15691,15061,186
12-10-2020,thirupathur,450,63,65,1,447,5610,63,110,0,5783,5226,110
12-10-2020,thiruvallur,1566,229,201,7,1587,34721,229,8,0,34958,32781,590
12-10-2020,thiruvannamalai,750,85,105,1,729,16196,85,393,0,16674,15699,246
12-10-2020,thiruvarur,549,114,88,0,575,8360,114,37,0,8511,7854,82
12-10-2020,thoothukudi,532,59,52,0,539,13853,59,269,0,14181,13518,124
12-10-2020,tirunelveli,692,62,73,2,679,13091,62,420,0,13573,12690,204
12-10-2020,tiruppur,1169,185,52,1,1301,10023,185,11,0,10219,8762,156
12-10-2020,trichy,695,45,91,0,649,11372,45,18,0,11435,10629,157
12-10-2020,vellore,791,130,143,4,774,16055,130,218,0,16403,15355,274
12-10-2020,villupuram,523,77,82,0,518,12373,77,174,0,12624,12005,101
12-10-2020,virudhunagar,214,42,14,0,242,14726,42,104,0,14872,14415,215
12-10-2020,airport surveillance (international),3,0,0,0,3,0,0,925,0,925,921,1
12-10-2020,airport surveillance (domestic),29,1,0,1,29,0,0,981,1,982,952,1
12-10-2020,railway surveillance,2,0,0,0,2,0,0,428,0,428,426,0
13-10-2020,ariyalur,242,36,23,0,255,4105,36,20,0,4161,3862,44
13-10-2020,chengalpattu,2144,252,326,4,2066,39613,252,5,0,39870,37196,608
13-10-2020,chennai,13770,1164,1217,13,13704,183230,1164,35,0,184429,167284,3441
13-10-2020,coimbatore,4849,398,478,5,4764,37473,398,48,0,37919,32653,502
13-10-2020,cuddalore,1094,138,147,3,1082,21592,138,202,0,21932,20595,255
13-10-2020,dharmapuri,774,104,71,0,807,4488,104,214,0,4806,3958,41
13-10-2020,dindigul,384,61,54,1,390,9271,61,77,0,9409,8844,175
13-10-2020,erode,1088,106,160,2,1032,8327,106,94,0,8527,7391,104
13-10-2020,kallakurichi,323,31,36,0,318,9318,31,404,0,9753,9336,99
13-10-2020,kancheepuram,837,129,146,2,818,23667,129,3,0,23799,22630,351
13-10-2020,kanyakumari,790,78,100,0,768,13740,78,109,0,13927,12923,236
13-10-2020,karur,407,36,34,0,409,3550,36,46,0,3632,3180,43
13-10-2020,krishnagiri,791,85,77,3,796,5421,85,165,0,5671,4793,82
13-10-2020,madurai,797,65,68,1,793,17418,65,153,0,17636,16444,399
13-10-2020,nagapattinam,529,51,54,0,526,5813,51,88,0,5952,5334,92
13-10-2020,namakkal,1085,129,152,0,1062,7190,129,98,0,7417,6267,88
13-10-2020,nilgiris,797,123,192,1,727,5493,123,19,0,5635,4877,31
13-10-2020,perambalur,90,5,13,0,82,1998,5,2,0,2005,1903,20
13-10-2020,pudukottai,529,54,76,0,507,9911,54,33,0,9998,9345,146
13-10-2020,ramanathapuram,184,17,15,0,186,5627,17,133,0,5777,5467,124
13-10-2020,ranipet,341,55,26,0,370,14142,55,49,0,14246,13704,172
13-10-2020,salem,2277,277,282,3,2269,23219,277,419,0,23915,21268,378
13-10-2020,sivagangai,191,16,27,0,180,5467,16,60,0,5543,5240,123
13-10-2020,tenkasi,181,31,22,0,190,7581,31,49,0,7661,7323,148
13-10-2020,thanjavur,775,118,164,2,727,13844,118,22,0,13984,13052,205
13-10-2020,theni,445,58,62,1,440,15647,58,45,0,15750,15123,187
13-10-2020,thirupathur,445,61,79,4,423,5671,61,110,0,5842,5305,114
13-10-2020,thiruvallur,1572,236,294,2,1512,34935,236,8,0,35179,33075,592
13-10-2020,thiruvannamalai,730,55,87,2,696,16282,55,393,0,16730,15786,248
13-10-2020,thiruvarur,576,109,47,0,638,8475,109,37,0,8621,7901,82
13-10-2020,thoothukudi,539,55,58,1,535,13912,55,269,0,14236,13576,125
13-10-2020,tirunelveli,679,60,62,0,677,13153,60,420,0,13633,12752,204
13-10-2020,tiruppur,1283,166,116,4,1329,10190,166,11,0,10367,8878,160
13-10-2020,trichy,645,66,77,0,634,11413,66,18,0,11497,10706,157
13-10-2020,vellore,766,105,141,2,728,16177,105,218,0,16500,15496,276
13-10-2020,villupuram,521,85,85,1,520,12453,85,174,0,12712,12090,102
13-10-2020,virudhunagar,243,51,32,0,262,14769,51,104,0,14924,14447,215
13-10-2020,airport surveillance (international),3,0,0,0,3,0,0,925,0,925,921,1
13-10-2020,airport surveillance (domestic),29,0,15,0,14,0,0,982,0,982,967,1
13-10-2020,railway surveillance,2,0,2,0,0,0,0,428,0,428,428,0
14-10-2020,ariyalur,255,30,41,1,243,4141,30,20,0,4191,3903,45
14-10-2020,chengalpattu,2072,272,308,4,2032,39871,272,5,0,40148,37504,612
14-10-2020,chennai,13718,1130,1349,11,13488,184408,1130,35,0,185573,168633,3452
14-10-2020,coimbatore,4771,389,452,5,4703,37878,389,48,0,38315,33105,507
14-10-2020,cuddalore,1082,108,115,2,1073,21730,108,202,0,22040,20710,257
14-10-2020,dharmapuri,789,91,56,0,824,4574,91,214,0,4879,4014,41
14-10-2020,dindigul,391,36,63,3,361,9333,36,77,0,9446,8907,178
14-10-2020,erode,1026,127,131,0,1022,8427,127,94,0,8648,7522,104
14-10-2020,kallakurichi,315,39,39,0,315,9346,39,404,0,9789,9375,99
14-10-2020,kancheepuram,828,148,124,2,850,23806,148,3,0,23957,22754,353
14-10-2020,kanyakumari,768,82,105,1,744,13818,82,109,0,14009,13028,237
14-10-2020,karur,408,35,48,0,395,3585,35,46,0,3666,3228,43
14-10-2020,krishnagiri,809,81,70,2,818,5519,81,165,0,5765,4863,84
14-10-2020,madurai,792,75,61,3,803,17482,75,153,0,17710,16505,402
14-10-2020,nagapattinam,525,46,52,1,518,5863,46,88,0,5997,5386,93
14-10-2020,namakkal,1070,140,250,0,960,7327,140,98,0,7565,6517,88
14-10-2020,nilgiris,721,98,87,1,731,5610,98,19,0,5727,4964,32
14-10-2020,perambalur,82,8,8,0,82,2003,8,2,0,2013,1911,20
14-10-2020,pudukottai,505,52,77,0,480,9963,52,33,0,10048,9422,146
14-10-2020,ramanathapuram,186,20,22,0,184,5644,20,133,0,5797,5489,124
14-10-2020,ranipet,370,41,54,1,356,14197,41,49,0,14287,13758,173
14-10-2020,salem,2275,274,327,2,2220,23502,274,419,0,24195,21595,380
14-10-2020,sivagangai,179,15,30,0,164,5482,15,60,0,5557,5270,123
14-10-2020,tenkasi,192,6,20,0,178,7614,6,49,0,7669,7343,148
14-10-2020,thanjavur,730,97,181,2,644,13965,97,22,0,14084,13233,207
14-10-2020,theni,440,49,60,0,429,15705,49,45,0,15799,15183,187
14-10-2020,thirupathur,421,63,68,0,416,5730,63,110,0,5903,5373,114
14-10-2020,thiruvallur,1468,207,209,3,1463,35127,207,8,0,35342,33284,595
14-10-2020,thiruvannamalai,701,53,85,0,669,16342,53,393,0,16788,15871,248
14-10-2020,thiruvarur,640,80,52,2,666,8586,80,37,0,8703,7953,84
14-10-2020,thoothukudi,536,45,47,0,534,13968,45,269,0,14282,13623,125
14-10-2020,tirunelveli,674,50,79,1,644,13210,50,420,0,13680,12831,205
14-10-2020,tiruppur,1331,168,104,1,1394,10358,168,11,0,10537,8982,161
14-10-2020,trichy,637,68,76,1,628,11482,68,18,0,11568,10782,158
14-10-2020,vellore,731,112,135,3,705,16285,112,218,0,16615,15631,279
14-10-2020,villupuram,521,79,47,0,553,12539,79,174,0,12792,12137,102
14-10-2020,virudhunagar,263,48,51,0,260,14821,48,104,0,14973,14498,215
14-10-2020,airport surveillance (international),3,0,0,0,3,0,0,925,0,925,921,1
14-10-2020,airport surveillance (domestic),14,0,0,0,14,0,0,982,0,982,967,1
14-10-2020,railway surveillance,0,0,0,0,0,0,0,428,0,428,428,0
15-10-2020,ariyalur,242,18,48,0,212,4171,18,20,0,4209,3951,46
15-10-2020,chengalpattu,2045,255,349,2,1949,40156,255,5,0,40416,37853,614
15-10-2020,chennai,13431,1148,1257,18,13304,185484,1148,35,0,186667,169890,3473
15-10-2020,coimbatore,4704,395,670,3,4426,38269,395,48,0,38712,33775,511
15-10-2020,cuddalore,1076,120,130,1,1065,21841,120,202,0,22163,20840,258
15-10-2020,dharmapuri,828,84,78,1,833,4668,84,214,0,4966,4092,41
15-10-2020,dindigul,359,35,27,0,367,9367,35,77,0,9479,8934,178
15-10-2020,erode,1020,126,122,2,1022,8552,126,94,0,8772,7644,106
15-10-2020,kallakurichi,315,40,42,1,312,9385,40,404,0,9829,9417,100
15-10-2020,kancheepuram,854,112,137,3,826,23958,112,3,0,24073,22891,356
15-10-2020,kanyakumari,741,80,111,0,710,13897,80,109,0,14086,13139,237
15-10-2020,karur,395,36,43,0,388,3620,36,46,0,3702,3271,43
15-10-2020,krishnagiri,819,73,74,0,818,5601,73,165,0,5839,4937,84
15-10-2020,madurai,800,83,90,0,793,17554,83,153,0,17790,16595,402
15-10-2020,nagapattinam,519,62,52,2,527,5910,62,88,0,6060,5438,95
15-10-2020,namakkal,961,148,158,0,951,7468,148,98,0,7714,6675,88
15-10-2020,nilgiris,731,94,131,1,693,5708,94,19,0,5821,5095,33
15-10-2020,perambalur,86,6,12,0,80,2015,6,2,0,2023,1923,20
15-10-2020,pudukottai,482,50,79,0,453,10017,50,33,0,10100,9501,146
15-10-2020,ramanathapuram,185,19,15,0,189,5665,19,133,0,5817,5504,124
15-10-2020,ranipet,356,39,43,0,352,14238,39,49,0,14326,13801,173
15-10-2020,salem,2217,263,219,1,2260,23773,263,419,0,24455,21814,381
15-10-2020,sivagangai,165,25,20,0,170,5498,25,60,0,5583,5290,123
15-10-2020,tenkasi,176,23,14,1,184,7618,23,49,0,7690,7357,149
15-10-2020,thanjavur,649,96,77,2,666,14066,96,22,0,14184,13310,208
15-10-2020,theni,431,45,57,0,419,15756,45,45,0,15846,15240,187
15-10-2020,thirupathur,418,58,76,0,400,5795,58,110,0,5963,5449,114
15-10-2020,thiruvallur,1477,192,164,5,1500,35345,192,8,0,35545,33448,597
15-10-2020,thiruvannamalai,669,76,116,2,627,16395,76,393,0,16864,15987,250
15-10-2020,thiruvarur,668,60,41,1,686,8668,60,37,0,8765,7994,85
15-10-2020,thoothukudi,534,43,42,0,535,14013,43,269,0,14325,13665,125
15-10-2020,tirunelveli,646,51,83,0,614,13262,51,420,0,13733,12914,205
15-10-2020,tiruppur,1401,146,260,1,1286,10533,146,11,0,10690,9242,162
15-10-2020,trichy,623,79,58,1,643,11545,79,18,0,11642,10840,159
15-10-2020,vellore,707,114,76,1,744,16399,114,218,0,16731,15707,280
15-10-2020,villupuram,555,65,51,0,569,12620,65,174,0,12859,12188,102
15-10-2020,virudhunagar,264,51,33,0,282,14873,51,104,0,15028,14531,215
15-10-2020,airport surveillance (international),3,0,0,0,3,0,0,925,0,925,921,1
15-10-2020,airport surveillance (domestic),14,0,0,0,14,0,0,982,0,982,967,1
15-10-2020,railway surveillance,0,0,0,0,0,0,0,428,0,428,428,0
16-10-2020,ariyalur,216,16,20,0,212,4193,16,20,0,4229,3971,46
16-10-2020,chengalpattu,2001,261,322,4,1936,40463,261,5,0,40729,38175,618
16-10-2020,chennai,13349,1140,1185,15,13289,186677,1140,35,0,187852,171075,3488
16-10-2020,coimbatore,4429,387,913,1,3902,38667,387,48,0,39102,34688,512
16-10-2020,cuddalore,1066,116,126,2,1054,21962,116,202,0,22280,20966,260
16-10-2020,dharmapuri,833,68,80,3,818,4752,68,214,0,5034,4172,44
16-10-2020,dindigul,366,33,39,0,360,9401,33,77,0,9511,8973,178
16-10-2020,erode,1016,138,55,5,1094,8672,138,94,0,8904,7699,111
16-10-2020,kallakurichi,312,46,34,0,324,9425,46,404,0,9875,9451,100
16-10-2020,kancheepuram,789,130,99,1,819,24033,130,3,0,24166,22990,357
16-10-2020,kanyakumari,710,70,63,0,717,13977,70,109,0,14156,13202,237
16-10-2020,karur,387,34,47,0,374,3655,34,46,0,3735,3318,43
16-10-2020,krishnagiri,818,63,48,2,831,5674,63,165,0,5902,4985,86
16-10-2020,madurai,793,84,73,0,804,17637,84,153,0,17874,16668,402
16-10-2020,nagapattinam,528,64,64,2,526,5973,64,88,0,6125,5502,97
16-10-2020,namakkal,954,132,137,0,949,7619,132,98,0,7849,6812,88
16-10-2020,nilgiris,694,93,102,0,685,5803,93,19,0,5915,5197,33
16-10-2020,perambalur,80,7,12,0,75,2021,7,2,0,2030,1935,20
16-10-2020,pudukottai,453,39,70,0,422,10067,39,33,0,10139,9571,146
16-10-2020,ramanathapuram,192,15,26,0,181,5687,15,133,0,5835,5530,124
16-10-2020,ranipet,351,58,64,0,345,14276,58,49,0,14383,13865,173
16-10-2020,salem,2262,244,314,3,2189,24038,244,419,0,24701,22128,384
16-10-2020,sivagangai,170,19,26,0,163,5523,19,60,0,5602,5316,123
16-10-2020,tenkasi,186,13,15,1,183,7643,13,49,0,7705,7372,150
16-10-2020,thanjavur,671,98,99,2,668,14167,98,22,0,14287,13409,210
16-10-2020,theni,419,39,70,0,388,15801,39,45,0,15885,15310,187
16-10-2020,thirupathur,400,62,63,2,397,5853,62,110,0,6025,5512,116
16-10-2020,thiruvallur,1414,195,195,1,1413,35451,195,8,0,35654,33643,598
16-10-2020,thiruvannamalai,633,64,98,1,598,16477,64,393,0,16934,16085,251
16-10-2020,thiruvarur,679,76,97,0,658,8721,76,37,0,8834,8091,85
16-10-2020,thoothukudi,535,56,44,1,546,14056,56,269,0,14381,13709,126
16-10-2020,tirunelveli,612,61,66,0,607,13311,61,420,0,13792,12980,205
16-10-2020,tiruppur,1288,147,229,2,1204,10681,147,11,0,10839,9471,164
16-10-2020,trichy,644,80,72,3,649,11625,80,18,0,11723,10912,162
16-10-2020,vellore,747,118,120,4,741,16516,118,218,0,16852,15827,284
16-10-2020,villupuram,574,85,83,0,576,12690,85,174,0,12949,12271,102
16-10-2020,virudhunagar,284,38,74,2,246,14926,38,104,0,15068,14605,217
16-10-2020,airport surveillance (international),3,0,0,0,3,0,0,925,0,925,921,1
16-10-2020,airport surveillance (domestic),14,0,1,0,13,0,0,982,0,982,968,1
16-10-2020,railway surveillance,0,0,0,0,0,0,0,428,0,428,428,0
17-10-2020,ariyalur,211,15,13,0,213,4208,15,20,0,4243,3984,46
17-10-2020,chengalpattu,1971,231,337,5,1860,40759,231,5,0,40995,38512,623
17-10-2020,chennai,13248,1132,1458,15,12907,187777,1132,35,0,188944,172533,3504
17-10-2020,coimbatore,3906,389,428,6,3861,39058,389,48,0,39495,35116,518
17-10-2020,cuddalore,1058,113,123,1,1047,22082,113,202,0,22397,21089,261
17-10-2020,dharmapuri,811,75,84,3,799,4812,75,214,0,5101,4256,46
17-10-2020,dindigul,363,35,32,0,366,9437,35,77,0,9549,9005,178
17-10-2020,erode,1097,122,157,2,1060,8813,122,94,0,9029,7856,113
17-10-2020,kallakurichi,327,45,37,1,334,9474,45,404,0,9923,9488,101
17-10-2020,kancheepuram,788,148,119,2,815,24132,148,3,0,24283,23109,359
17-10-2020,kanyakumari,719,65,71,0,713,14049,65,109,0,14223,13273,237
17-10-2020,karur,374,36,23,0,387,3689,36,46,0,3771,3341,43
17-10-2020,krishnagiri,841,69,60,1,849,5748,69,165,0,5982,5045,88
17-10-2020,madurai,797,76,84,2,787,17714,76,153,0,17943,16752,404
17-10-2020,nagapattinam,530,56,54,1,531,6041,56,88,0,6185,5556,98
17-10-2020,namakkal,942,131,100,2,971,7744,131,98,0,7973,6912,90
17-10-2020,nilgiris,685,88,105,1,667,5896,88,19,0,6003,5302,34
17-10-2020,perambalur,77,8,7,0,78,2030,8,2,0,2040,1942,20
17-10-2020,pudukottai,428,48,70,0,406,10112,48,33,0,10193,9641,146
17-10-2020,ramanathapuram,181,14,30,0,165,5702,14,133,0,5849,5560,124
17-10-2020,ranipet,343,66,55,0,354,14332,66,49,0,14447,13920,173
17-10-2020,salem,2187,240,297,3,2127,24280,240,419,0,24939,22425,387
17-10-2020,sivagangai,159,27,36,1,149,5538,27,60,0,5625,5352,124
17-10-2020,tenkasi,182,12,37,1,156,7655,12,49,0,7716,7409,151
17-10-2020,thanjavur,669,101,131,0,639,14266,101,22,0,14389,13540,210
17-10-2020,theni,391,29,65,1,354,15843,29,45,0,15917,15375,188
17-10-2020,thirupathur,397,32,56,0,373,5915,32,110,0,6057,5568,116
17-10-2020,thiruvallur,1431,218,182,2,1465,35663,218,8,0,35889,33825,599
17-10-2020,thiruvannamalai,604,62,36,2,628,16547,62,393,0,17002,16121,253
17-10-2020,thiruvarur,658,87,81,1,663,8797,87,37,0,8921,8172,86
17-10-2020,thoothukudi,547,48,68,0,527,14113,48,269,0,14430,13777,126
17-10-2020,tirunelveli,607,47,70,0,584,13372,47,420,0,13839,13050,205
17-10-2020,tiruppur,1200,159,193,0,1166,10824,159,11,0,10994,9664,164
17-10-2020,trichy,647,67,74,0,640,11703,67,18,0,11788,10986,162
17-10-2020,vellore,742,91,100,4,729,16635,91,218,0,16944,15927,288
17-10-2020,villupuram,578,80,82,0,576,12777,80,174,0,13031,12353,102
17-10-2020,virudhunagar,247,33,50,0,230,14965,33,104,0,15102,14655,217
17-10-2020,airport surveillance (international),3,0,0,0,3,0,0,925,0,925,921,1
17-10-2020,airport surveillance (domestic),13,0,0,0,13,0,0,982,0,982,968,1
17-10-2020,railway surveillance,0,0,0,0,0,0,0,428,0,428,428,0
18-10-2020,ariyalur,214,16,20,0,210,4224,16,20,0,4260,4004,46
18-10-2020,chengalpattu,1855,174,285,7,1737,40985,174,5,0,41164,38797,630
18-10-2020,chennai,12923,1036,1359,17,12583,188924,1036,35,0,189995,173892,3520
18-10-2020,coimbatore,3865,319,365,5,3814,39451,319,48,0,39818,35481,523
18-10-2020,cuddalore,1049,99,147,0,1001,22197,99,202,0,22498,21236,261
18-10-2020,dharmapuri,799,69,69,1,798,4887,69,214,0,5170,4325,47
18-10-2020,dindigul,363,28,39,3,349,9469,28,77,0,9574,9044,181
18-10-2020,erode,1051,111,122,0,1040,8926,111,94,0,9131,7978,113
18-10-2020,kallakurichi,334,32,40,0,326,9519,32,404,0,9955,9528,101
18-10-2020,kancheepuram,823,130,112,2,839,24288,130,3,0,24421,23221,361
18-10-2020,kanyakumari,714,69,77,0,706,14115,69,109,0,14293,13350,237
18-10-2020,karur,386,22,33,0,375,3724,22,46,0,3792,3374,43
18-10-2020,krishnagiri,849,62,86,1,824,5817,62,165,0,6044,5131,89
18-10-2020,madurai,783,79,88,1,773,17786,79,153,0,18018,16840,405
18-10-2020,nagapattinam,533,58,50,2,539,6099,58,88,0,6245,5606,100
18-10-2020,namakkal,976,117,185,0,908,7880,117,98,0,8095,7097,90
18-10-2020,nilgiris,667,86,123,1,629,5984,86,19,0,6089,5425,35
18-10-2020,perambalur,79,9,12,0,76,2039,9,2,0,2050,1954,20
18-10-2020,pudukottai,408,47,71,1,383,10162,47,33,0,10242,9712,147
18-10-2020,ramanathapuram,166,13,12,1,166,5717,13,133,0,5863,5572,125
18-10-2020,ranipet,356,64,67,0,353,14400,64,49,0,14513,13987,173
18-10-2020,salem,2127,188,268,5,2042,24520,188,419,0,25127,22693,392
18-10-2020,sivagangai,150,25,26,0,149,5566,25,60,0,5651,5378,124
18-10-2020,tenkasi,150,8,5,0,153,7661,8,49,0,7718,7414,151
18-10-2020,thanjavur,631,98,158,1,570,14359,98,22,0,14479,13698,211
18-10-2020,theni,354,35,69,1,319,15872,35,45,0,15952,15444,189
18-10-2020,thirupathur,370,55,69,0,356,5944,55,110,0,6109,5637,116
18-10-2020,thiruvallur,1446,195,225,0,1416,35863,195,8,0,36066,34050,600
18-10-2020,thiruvannamalai,627,63,61,1,628,16608,63,393,0,17064,16182,254
18-10-2020,thiruvarur,666,83,152,1,596,8887,83,37,0,9007,8324,87
18-10-2020,thoothukudi,528,60,39,0,549,14162,60,269,0,14491,13816,126
18-10-2020,tirunelveli,586,39,67,0,558,13421,39,420,0,13880,13117,205
18-10-2020,tiruppur,1171,166,133,1,1203,10988,166,11,0,11165,9797,165
18-10-2020,trichy,639,63,73,0,629,11769,63,18,0,11850,11059,162
18-10-2020,vellore,730,88,110,4,704,16727,88,218,0,17033,16037,292
18-10-2020,villupuram,577,77,77,0,577,12858,77,174,0,13109,12430,102
18-10-2020,virudhunagar,231,31,35,0,227,14999,31,104,0,15134,14690,217
18-10-2020,airport surveillance (international),3,0,0,0,3,0,0,925,0,925,921,1
18-10-2020,airport surveillance (domestic),13,0,0,0,13,0,0,982,0,982,968,1
18-10-2020,railway surveillance,0,0,0,0,0,0,0,428,0,428,428,0
19-10-2020,ariyalur,210,12,33,0,189,4240,12,20,0,4272,4037,46
19-10-2020,chengalpattu,1759,241,297,4,1699,41181,241,5,0,41427,39094,634
19-10-2020,chennai,12652,885,1236,16,12285,190029,885,35,0,190949,175128,3536
19-10-2020,coimbatore,3814,290,208,1,3895,39770,290,48,0,40108,35689,524
19-10-2020,cuddalore,1003,86,95,2,992,22298,86,202,0,22586,21331,263
19-10-2020,dharmapuri,802,71,69,1,803,4959,71,214,0,5244,4394,47
19-10-2020,dindigul,350,40,41,0,349,9498,40,77,0,9615,9085,181
19-10-2020,erode,1042,90,134,0,998,9039,90,94,0,9223,8112,113
19-10-2020,kallakurichi,327,33,36,1,323,9552,33,404,0,9989,9564,102
19-10-2020,kancheepuram,799,92,151,1,739,24378,92,3,0,24473,23372,362
19-10-2020,kanyakumari,706,69,68,0,707,14184,69,109,0,14362,13418,237
19-10-2020,karur,377,33,44,0,366,3748,33,46,0,3827,3418,43
19-10-2020,krishnagiri,823,65,93,3,792,5879,65,165,0,6109,5224,93
19-10-2020,madurai,775,64,76,4,759,17867,64,153,0,18084,16916,409
19-10-2020,nagapattinam,541,36,47,2,528,6159,36,88,0,6283,5653,102
19-10-2020,namakkal,901,98,128,1,870,7990,98,98,0,8186,7225,91
19-10-2020,nilgiris,629,60,129,1,559,6070,60,19,0,6149,5554,36
19-10-2020,perambalur,76,15,10,0,81,2048,15,2,0,2065,1964,20
19-10-2020,pudukottai,384,35,48,0,371,10210,35,33,0,10278,9760,147
19-10-2020,ramanathapuram,167,23,13,0,177,5731,23,133,0,5887,5585,125
19-10-2020,ranipet,357,43,80,0,320,14468,43,49,0,14560,14067,173
19-10-2020,salem,2038,192,241,1,1988,24704,192,419,0,25315,22934,393
19-10-2020,sivagangai,147,25,24,0,148,5589,25,60,0,5674,5402,124
19-10-2020,tenkasi,153,22,20,0,155,7669,22,49,0,7740,7434,151
19-10-2020,thanjavur,568,83,119,1,531,14455,83,22,0,14560,13817,212
19-10-2020,theni,319,32,64,0,287,15907,32,45,0,15984,15508,189
19-10-2020,thirupathur,356,28,86,0,298,5999,28,110,0,6137,5723,116
19-10-2020,thiruvallur,1356,172,161,3,1364,35998,172,8,0,36178,34211,603
19-10-2020,thiruvannamalai,629,53,48,2,632,16672,53,393,0,17118,16230,256
19-10-2020,thiruvarur,595,74,111,1,557,8969,74,37,0,9080,8435,88
19-10-2020,thoothukudi,549,46,35,0,560,14222,46,269,0,14537,13851,126
19-10-2020,tirunelveli,558,36,49,0,545,13460,36,420,0,13916,13166,205
19-10-2020,tiruppur,1203,140,202,1,1140,11154,140,11,0,11305,9999,166
19-10-2020,trichy,632,59,91,0,600,11835,59,18,0,11912,11150,162
19-10-2020,vellore,704,92,90,1,705,16815,92,218,0,17125,16127,293
19-10-2020,villupuram,577,76,94,2,557,12935,76,174,0,13185,12524,104
19-10-2020,virudhunagar,227,25,43,0,209,15030,25,104,0,15159,14733,217
19-10-2020,airport surveillance (international),3,0,0,0,3,0,0,925,0,925,921,1
19-10-2020,airport surveillance (domestic),13,0,1,0,12,0,0,982,0,982,969,1
19-10-2020,railway surveillance,0,0,0,0,0,0,0,428,0,428,428,0
20-10-2020,ariyalur,190,15,23,0,182,4253,15,20,0,4288,4060,46
20-10-2020,chengalpattu,1725,191,242,4,1670,41449,191,5,0,41645,39336,639
20-10-2020,chennai,12234,857,1235,11,11845,190862,857,35,0,191754,176363,3546
20-10-2020,coimbatore,3898,263,328,2,3831,40063,263,48,0,40374,36017,526
20-10-2020,cuddalore,994,69,93,1,969,22386,69,202,0,22657,21424,264
20-10-2020,dharmapuri,799,66,85,2,778,5026,66,214,0,5306,4479,49
20-10-2020,dindigul,350,20,26,0,344,9539,20,77,0,9636,9111,181
20-10-2020,erode,993,72,134,0,931,9124,72,94,0,9290,8246,113
20-10-2020,kallakurichi,333,32,41,0,324,9595,32,404,0,10031,9605,102
20-10-2020,kancheepuram,748,93,143,4,694,24479,93,3,0,24575,23515,366
20-10-2020,kanyakumari,706,61,66,2,699,14252,61,109,0,14422,13484,239
20-10-2020,karur,364,19,37,0,346,3779,19,46,0,3844,3455,43
20-10-2020,krishnagiri,796,26,87,2,733,5948,26,165,0,6139,5311,95
20-10-2020,madurai,754,61,70,1,744,17926,61,153,0,18140,16986,410
20-10-2020,nagapattinam,531,33,53,2,509,6198,33,88,0,6319,5706,104
20-10-2020,namakkal,868,95,129,0,834,8086,95,98,0,8279,7354,91
20-10-2020,nilgiris,559,31,111,0,479,6130,31,19,0,6180,5665,36
20-10-2020,perambalur,83,8,8,0,83,2065,8,2,0,2075,1972,20
20-10-2020,pudukottai,371,23,44,0,350,10245,23,33,0,10301,9804,147
20-10-2020,ramanathapuram,178,12,21,2,167,5755,12,133,0,5900,5606,127
20-10-2020,ranipet,320,29,70,0,279,14511,29,49,0,14589,14137,173
20-10-2020,salem,1997,169,226,1,1939,24905,169,419,0,25493,23160,394
20-10-2020,sivagangai,149,22,15,0,156,5615,22,60,0,5697,5417,124
20-10-2020,tenkasi,155,8,19,0,144,7691,8,49,0,7748,7453,151
20-10-2020,thanjavur,532,88,108,0,512,14539,88,22,0,14649,13925,212
20-10-2020,theni,290,29,59,0,260,15942,29,45,0,16016,15567,189
20-10-2020,thirupathur,294,47,61,1,279,6023,47,110,0,6180,5784,117
20-10-2020,thiruvallur,1356,137,174,4,1315,36162,137,8,0,36307,34385,607
20-10-2020,thiruvannamalai,633,37,50,1,619,16726,37,393,0,17156,16280,257
20-10-2020,thiruvarur,557,64,96,1,524,9043,64,37,0,9144,8531,89
20-10-2020,thoothukudi,562,37,46,0,553,14270,37,269,0,14576,13897,126
20-10-2020,tirunelveli,543,22,69,1,495,13494,22,420,0,13936,13235,206
20-10-2020,tiruppur,1146,125,179,5,1087,11300,125,11,0,11436,10178,171
20-10-2020,trichy,605,63,51,1,616,11899,63,18,0,11980,11201,163
20-10-2020,vellore,712,73,84,1,700,16914,73,218,0,17205,16211,294
20-10-2020,villupuram,542,58,73,0,527,12996,58,174,0,13228,12597,104
20-10-2020,virudhunagar,211,39,46,1,203,15057,39,104,0,15200,14779,218
20-10-2020,airport surveillance (international),3,0,0,0,3,0,0,925,0,925,921,1
20-10-2020,airport surveillance (domestic),12,0,1,0,11,0,0,982,0,982,970,1
20-10-2020,railway surveillance,0,0,0,0,0,0,0,428,0,428,428,0
22-10-2020,ariyalur,177,7,26,0,158,4275,7,20,0,4302,4098,46
22-10-2020,chengalpattu,1597,193,271,4,1515,41865,193,5,0,42063,39900,648
22-10-2020,chennai,11364,833,1077,13,11107,192431,833,35,0,193299,178623,3569
22-10-2020,coimbatore,3759,285,290,1,3753,40649,285,48,0,40982,36701,528
22-10-2020,cuddalore,947,69,145,0,871,22525,69,202,0,22796,21661,264
22-10-2020,dharmapuri,761,38,120,0,679,5119,38,214,0,5371,4644,48
22-10-2020,dindigul,328,28,27,0,329,9567,28,77,0,9672,9161,182
22-10-2020,erode,899,80,111,1,867,9285,80,94,0,9459,8476,116
22-10-2020,kallakurichi,296,24,36,0,284,9646,24,404,0,10074,9688,102
22-10-2020,kancheepuram,665,99,133,1,630,24670,99,3,0,24772,23772,370
22-10-2020,kanyakumari,670,36,76,0,630,14361,36,109,0,14506,13637,239
22-10-2020,karur,296,37,23,0,310,3815,37,46,0,3898,3545,43
22-10-2020,krishnagiri,693,45,87,1,650,6011,45,165,0,6221,5473,98
22-10-2020,madurai,731,57,45,1,742,18046,57,153,0,18256,17101,413
22-10-2020,nagapattinam,511,35,66,1,479,6284,35,88,0,6407,5822,106
22-10-2020,namakkal,803,74,85,0,792,8250,74,98,0,8422,7539,91
22-10-2020,nilgiris,442,62,78,1,425,6192,62,19,0,6273,5811,37
22-10-2020,perambalur,85,7,10,0,82,2087,7,2,0,2096,1994,20
22-10-2020,pudukottai,322,27,51,0,298,10295,27,33,0,10355,9910,147
22-10-2020,ramanathapuram,173,9,13,0,169,5782,9,133,0,5924,5628,127
22-10-2020,ranipet,249,27,30,0,246,14561,27,49,0,14637,14216,175
22-10-2020,salem,1942,140,200,5,1877,25279,140,419,0,25838,23560,401
22-10-2020,sivagangai,160,14,25,0,149,5656,14,60,0,5730,5456,125
22-10-2020,tenkasi,151,5,6,0,150,7712,5,49,0,7766,7465,151
22-10-2020,thanjavur,463,72,94,2,439,14696,72,22,0,14790,14136,215
22-10-2020,theni,228,22,48,1,201,15998,22,45,0,16065,15673,191
22-10-2020,thirupathur,284,54,61,0,277,6141,54,110,0,6305,5911,117
22-10-2020,thiruvallur,1324,170,176,4,1314,36479,170,8,0,36657,34732,611
22-10-2020,thiruvannamalai,585,38,87,2,534,16827,38,393,0,17258,16465,259
22-10-2020,thiruvarur,508,62,86,0,484,9152,62,37,0,9251,8678,89
22-10-2020,thoothukudi,509,40,47,0,502,14330,40,269,0,14639,14011,126
22-10-2020,tirunelveli,471,26,60,0,437,13556,26,420,0,14002,13358,207
22-10-2020,tiruppur,1122,155,252,3,1022,11561,155,11,0,11727,10531,174
22-10-2020,trichy,600,55,65,3,587,12024,55,18,0,12097,11343,167
22-10-2020,vellore,649,62,197,0,514,17063,62,218,0,17343,16532,297
22-10-2020,villupuram,527,60,63,1,523,13121,60,174,0,13355,12727,105
22-10-2020,virudhunagar,175,30,36,0,169,15116,30,104,0,15250,14862,219
22-10-2020,airport surveillance (international),3,0,0,0,3,0,0,925,0,925,921,1
22-10-2020,airport surveillance (domestic),11,0,11,0,0,0,0,982,0,982,981,1
22-10-2020,railway surveillance,0,0,0,0,0,0,0,428,0,428,428,0
23-10-2020,ariyalur,163,11,19,0,155,4287,11,20,0,4318,4117,46
23-10-2020,chengalpattu,1511,186,282,1,1414,42054,186,5,0,42245,40182,649
23-10-2020,chennai,11103,844,1308,11,10628,193260,844,35,0,194139,179931,3580
23-10-2020,coimbatore,3753,280,273,2,3758,40934,280,48,0,41262,36974,530
23-10-2020,cuddalore,868,54,139,1,782,22591,54,202,0,22847,21800,265
23-10-2020,dharmapuri,677,40,97,0,620,5155,40,214,0,5409,4741,48
23-10-2020,dindigul,328,19,42,1,304,9594,19,77,0,9690,9203,183
23-10-2020,erode,866,106,104,1,867,9364,106,94,0,9564,8580,117
23-10-2020,kallakurichi,280,25,35,0,270,9666,25,404,0,10095,9723,102
23-10-2020,kancheepuram,644,87,145,3,583,24783,87,3,0,24873,23917,373
23-10-2020,kanyakumari,630,51,74,0,607,14397,51,109,0,14557,13711,239
23-10-2020,karur,309,26,45,0,290,3851,26,46,0,3923,3590,43
23-10-2020,krishnagiri,652,47,72,1,626,6058,47,165,0,6270,5545,99
23-10-2020,madurai,738,71,89,0,720,18099,71,153,0,18323,17190,413
23-10-2020,nagapattinam,486,18,56,1,447,6326,18,88,0,6432,5878,107
23-10-2020,namakkal,793,95,88,0,800,8325,95,98,0,8518,7627,91
23-10-2020,nilgiris,425,45,99,0,371,6254,45,19,0,6318,5910,37
23-10-2020,perambalur,82,5,8,0,79,2094,5,2,0,2101,2002,20
23-10-2020,pudukottai,298,23,53,1,267,10322,23,33,0,10378,9963,148
23-10-2020,ramanathapuram,169,6,13,0,162,5791,6,133,0,5930,5641,127
23-10-2020,ranipet,248,30,16,0,262,14590,30,49,0,14669,14232,175
23-10-2020,salem,1881,185,195,1,1870,25423,185,419,0,26027,23755,402
23-10-2020,sivagangai,150,16,20,0,146,5671,16,60,0,5747,5476,125
23-10-2020,tenkasi,151,10,9,0,152,7718,10,49,0,7777,7474,151
23-10-2020,thanjavur,436,78,81,0,433,14765,78,22,0,14865,14217,215
23-10-2020,theni,202,20,45,0,177,16021,20,45,0,16086,15718,191
23-10-2020,thirupathur,276,45,58,0,263,6194,45,110,0,6349,5969,117
23-10-2020,thiruvallur,1295,168,172,2,1289,36630,168,8,0,36806,34904,613
23-10-2020,thiruvannamalai,535,37,59,1,512,16866,37,393,0,17296,16524,260
23-10-2020,thiruvarur,483,53,101,1,434,9213,53,37,0,9303,8779,90
23-10-2020,thoothukudi,506,51,59,1,497,14374,51,269,0,14694,14070,127
23-10-2020,tirunelveli,434,23,62,1,394,13579,23,420,0,14022,13420,208
23-10-2020,tiruppur,1023,130,92,2,1059,11717,130,11,0,11858,10623,176
23-10-2020,trichy,590,53,66,0,577,12082,53,18,0,12153,11409,167
23-10-2020,vellore,513,56,83,1,485,17124,56,218,0,17398,16615,298
23-10-2020,villupuram,528,49,83,0,494,13186,49,174,0,13409,12810,105
23-10-2020,virudhunagar,169,14,20,0,163,15146,14,104,0,15264,14882,219
23-10-2020,airport surveillance (international),3,0,0,0,3,0,0,925,0,925,921,1
23-10-2020,airport surveillance (domestic),0,0,0,0,0,0,0,982,0,982,981,1
23-10-2020,railway surveillance,0,0,0,0,0,0,0,428,0,428,428,0
24-10-2020,ariyalur,156,3,35,0,124,4299,3,20,0,4322,4152,46
24-10-2020,chengalpattu,1407,169,257,5,1314,42233,169,5,0,42407,40439,654
24-10-2020,chennai,10611,779,1240,3,10147,194087,779,35,0,194901,181171,3583
24-10-2020,coimbatore,3764,287,290,4,3757,41220,287,48,0,41555,37264,534
24-10-2020,cuddalore,783,49,79,0,753,22646,49,202,0,22897,21879,265
24-10-2020,dharmapuri,620,30,86,0,564,5195,30,214,0,5439,4827,48
24-10-2020,dindigul,304,16,32,1,287,9613,16,77,0,9706,9235,184
24-10-2020,erode,858,98,112,1,843,9461,98,94,0,9653,8692,118
24-10-2020,kallakurichi,270,28,35,0,263,9691,28,404,0,10123,9758,102
24-10-2020,kancheepuram,596,140,135,4,597,24883,140,3,0,25026,24052,377
24-10-2020,kanyakumari,607,52,77,1,581,14448,52,109,0,14609,13788,240
24-10-2020,karur,293,31,22,0,302,3880,31,46,0,3957,3612,43
24-10-2020,krishnagiri,627,37,53,3,608,6106,37,165,0,6308,5598,102
24-10-2020,madurai,711,77,92,1,695,18161,77,153,0,18391,17282,414
24-10-2020,nagapattinam,448,29,53,2,422,6345,29,88,0,6462,5931,109
24-10-2020,namakkal,789,83,123,0,749,8409,83,98,0,8590,7750,91
24-10-2020,nilgiris,371,18,74,0,315,6299,18,19,0,6336,5984,37
24-10-2020,perambalur,79,4,6,0,77,2100,4,2,0,2106,2008,21
24-10-2020,pudukottai,266,26,40,0,252,10344,26,33,0,10403,10003,148
24-10-2020,ramanathapuram,166,9,13,0,162,5801,9,133,0,5943,5654,127
24-10-2020,ranipet,263,12,11,0,264,14621,12,49,0,14682,14243,175
24-10-2020,salem,1881,148,191,2,1836,25619,148,419,0,26186,23946,404
24-10-2020,sivagangai,147,20,27,0,140,5688,20,60,0,5768,5503,125
24-10-2020,tenkasi,152,7,12,0,147,7728,7,49,0,7784,7486,151
24-10-2020,thanjavur,435,61,93,1,402,14845,61,22,0,14928,14310,216
24-10-2020,theni,177,19,40,0,156,16041,19,45,0,16105,15758,191
24-10-2020,thirupathur,261,51,60,0,252,6237,51,110,0,6398,6029,117
24-10-2020,thiruvallur,1284,165,162,1,1286,36793,165,8,0,36966,35066,614
24-10-2020,thiruvannamalai,512,50,60,0,502,16903,50,393,0,17346,16584,260
24-10-2020,thiruvarur,436,49,58,0,427,9268,49,37,0,9354,8837,90
24-10-2020,thoothukudi,499,39,47,2,489,14427,39,269,0,14735,14117,129
24-10-2020,tirunelveli,392,25,51,0,366,13600,25,420,0,14045,13471,208
24-10-2020,tiruppur,1064,101,123,1,1041,11852,101,11,0,11964,10746,177
24-10-2020,trichy,576,50,78,0,548,12133,50,18,0,12201,11487,166
24-10-2020,vellore,490,63,81,2,470,17185,63,218,0,17466,16696,300
24-10-2020,villupuram,495,35,64,1,465,13236,35,174,0,13445,12874,106
24-10-2020,virudhunagar,167,26,12,0,181,15164,26,104,0,15294,14894,219
24-10-2020,airport surveillance (international),3,0,0,0,3,0,0,925,0,925,921,1
24-10-2020,airport surveillance (domestic),0,0,0,0,0,0,0,982,0,982,981,1
24-10-2020,railway surveillance,0,0,0,0,0,0,0,428,0,428,428,0
25-10-2020,ariyalur,122,5,11,0,116,4300,5,20,0,4325,4163,46
25-10-2020,chengalpattu,1407,155,220,3,1339,42495,155,5,0,42655,40659,657
25-10-2020,chennai,10154,764,1270,9,9639,194873,764,35,0,195672,182441,3592
25-10-2020,coimbatore,3761,271,336,3,3693,41511,271,48,0,41830,37600,537
25-10-2020,cuddalore,753,51,65,1,738,22695,51,202,0,22948,21944,266
25-10-2020,dharmapuri,563,31,87,2,505,5224,31,214,0,5469,4914,50
25-10-2020,dindigul,288,17,33,0,272,9630,17,77,0,9724,9268,184
25-10-2020,erode,837,76,93,1,819,9553,76,94,0,9723,8785,119
25-10-2020,kallakurichi,261,25,37,0,249,9717,25,404,0,10146,9795,102
25-10-2020,kancheepuram,507,120,136,0,491,24933,120,3,0,25056,24188,377
25-10-2020,kanyakumari,582,57,63,0,576,14501,57,109,0,14667,13851,240
25-10-2020,karur,298,29,27,0,300,3907,29,46,0,3982,3639,43
25-10-2020,krishnagiri,607,27,86,0,548,6142,27,165,0,6334,5684,102
25-10-2020,madurai,687,65,114,0,638,18230,65,153,0,18448,17396,414
25-10-2020,nagapattinam,424,26,48,1,401,6376,26,88,0,6490,5979,110
25-10-2020,namakkal,751,89,90,2,748,8494,89,98,0,8681,7840,93
25-10-2020,nilgiris,315,31,82,0,264,6317,31,19,0,6367,6066,37
25-10-2020,perambalur,78,6,6,0,78,2105,6,2,0,2113,2014,21
25-10-2020,pudukottai,255,29,49,0,235,10373,29,33,0,10435,10052,148
25-10-2020,ramanathapuram,163,11,28,0,146,5811,11,133,0,5955,5682,127
25-10-2020,ranipet,265,20,14,0,271,14634,20,49,0,14703,14257,175
25-10-2020,salem,1835,196,192,2,1837,25766,196,419,0,26381,24138,406
25-10-2020,sivagangai,139,24,24,0,139,5707,24,60,0,5791,5527,125
25-10-2020,tenkasi,147,4,8,1,142,7735,4,49,0,7788,7494,152
25-10-2020,thanjavur,400,65,90,0,375,14904,65,22,0,14991,14400,216
25-10-2020,theni,157,20,30,0,147,16061,20,45,0,16126,15788,191
25-10-2020,thirupathur,258,45,17,1,285,6294,45,110,0,6449,6046,118
25-10-2020,thiruvallur,1276,161,161,0,1276,36948,161,8,0,37117,35227,614
25-10-2020,thiruvannamalai,504,43,42,0,505,16955,43,393,0,17391,16626,260
25-10-2020,thiruvarur,426,47,44,1,428,9316,47,37,0,9400,8881,91
25-10-2020,thoothukudi,491,42,35,0,498,14468,42,269,0,14779,14152,129
25-10-2020,tirunelveli,364,32,68,0,328,13623,32,420,0,14075,13539,208
25-10-2020,tiruppur,1044,112,171,2,983,11956,112,11,0,12079,10917,179
25-10-2020,trichy,550,48,65,0,533,12185,48,18,0,12251,11552,166
25-10-2020,vellore,464,51,91,2,422,17242,51,218,0,17511,16787,302
25-10-2020,villupuram,469,49,59,0,459,13275,49,174,0,13498,12933,106
25-10-2020,virudhunagar,182,25,26,0,181,15191,25,104,0,15320,14920,219
25-10-2020,airport surveillance (international),3,0,1,0,2,0,0,925,0,925,922,1
25-10-2020,airport surveillance (domestic),0,0,0,0,0,0,0,982,0,982,981,1
25-10-2020,railway surveillance,0,0,0,0,0,0,0,428,0,428,428,0
26-10-2020,ariyalur,116,6,15,0,107,4305,6,20,0,4331,4178,46
26-10-2020,chengalpattu,1342,143,238,8,1239,42653,143,5,0,42801,40897,665
26-10-2020,chennai,9598,747,1482,7,8856,195596,747,35,0,196378,183923,3599
26-10-2020,coimbatore,3694,253,193,1,3753,41783,253,48,0,42084,37793,538
26-10-2020,cuddalore,738,49,70,1,716,22746,49,202,0,22997,22014,267
26-10-2020,dharmapuri,498,30,69,1,458,5246,30,214,0,5490,4983,49
26-10-2020,dindigul,273,12,31,0,254,9648,12,77,0,9737,9299,184
26-10-2020,erode,819,83,95,0,807,9629,83,94,0,9806,8880,119
26-10-2020,kallakurichi,249,24,32,0,241,9742,24,404,0,10170,9827,102
26-10-2020,kancheepuram,498,119,157,0,460,25060,119,3,0,25182,24345,377
26-10-2020,kanyakumari,576,56,59,2,571,14558,56,109,0,14723,13910,242
26-10-2020,karur,301,27,37,0,291,3937,27,46,0,4010,3676,43
26-10-2020,krishnagiri,549,26,35,0,540,6172,26,165,0,6363,5719,104
26-10-2020,madurai,635,68,96,1,606,18292,68,153,0,18513,17492,415
26-10-2020,nagapattinam,403,25,66,1,361,6404,25,88,0,6517,6045,111
26-10-2020,namakkal,749,76,122,0,703,8584,76,98,0,8758,7962,93
26-10-2020,nilgiris,268,38,61,1,244,6352,38,19,0,6409,6127,38
26-10-2020,perambalur,78,3,9,0,72,2111,3,2,0,2116,2023,21
26-10-2020,pudukottai,236,28,48,1,215,10403,28,33,0,10464,10100,149
26-10-2020,ramanathapuram,146,10,17,1,138,5822,10,133,0,5965,5699,128
26-10-2020,ranipet,267,19,14,1,271,14650,19,49,0,14718,14271,176
26-10-2020,salem,1839,165,175,0,1829,25964,165,419,0,26548,24313,406
26-10-2020,sivagangai,140,22,27,0,135,5732,22,60,0,5814,5554,125
26-10-2020,tenkasi,142,3,19,1,125,7739,3,49,0,7791,7513,153
26-10-2020,thanjavur,377,63,72,0,368,14971,63,22,0,15056,14472,216
26-10-2020,theni,147,17,37,0,127,16081,17,45,0,16143,15825,191
26-10-2020,thirupathur,283,41,36,0,288,6337,41,110,0,6488,6082,118
26-10-2020,thiruvallur,1295,133,194,1,1233,37128,133,8,0,37269,35421,615
26-10-2020,thiruvannamalai,505,37,36,0,506,16998,37,393,0,17428,16662,260
26-10-2020,thiruvarur,429,45,73,0,401,9364,45,37,0,9446,8954,91
26-10-2020,thoothukudi,498,38,36,0,500,14510,38,269,0,14817,14188,129
26-10-2020,tirunelveli,329,30,50,0,309,13656,30,420,0,14106,13589,208
26-10-2020,tiruppur,983,109,114,1,977,12068,109,11,0,12188,11031,180
26-10-2020,trichy,533,46,79,1,499,12233,46,18,0,12297,11631,167
26-10-2020,vellore,429,49,53,1,424,17300,49,218,0,17567,16840,303
26-10-2020,villupuram,460,45,50,0,455,13325,45,174,0,13544,12983,106
26-10-2020,virudhunagar,182,23,17,1,187,15217,23,104,0,15344,14937,220
26-10-2020,airport surveillance (international),2,0,0,0,2,0,0,925,0,925,922,1
26-10-2020,airport surveillance (domestic),0,0,0,0,0,0,0,982,0,982,981,1
26-10-2020,railway surveillance,0,0,0,0,0,0,0,428,0,428,428,0
27-10-2020,ariyalur,106,5,33,0,78,4310,5,20,0,4335,4211,46
27-10-2020,chengalpattu,1245,144,184,2,1203,42802,144,5,0,42951,41081,667
27-10-2020,chennai,8859,695,1451,7,8096,196347,695,35,0,197077,185374,3607
27-10-2020,coimbatore,3756,209,373,2,3590,42039,209,48,0,42296,38166,540
27-10-2020,cuddalore,715,45,51,1,708,22794,45,202,0,23041,22065,268
27-10-2020,dharmapuri,459,25,69,0,415,5276,25,214,0,5515,5052,48
27-10-2020,dindigul,256,2,30,0,228,9662,2,77,0,9741,9329,184
27-10-2020,erode,805,76,108,1,772,9710,76,94,0,9880,8988,120
27-10-2020,kallakurichi,242,22,23,1,240,9767,22,404,0,10193,9850,103
27-10-2020,kancheepuram,464,98,113,0,449,25183,98,3,0,25284,24458,377
27-10-2020,kanyakumari,572,48,54,0,566,14615,48,109,0,14772,13964,242
27-10-2020,karur,292,25,38,0,279,3965,25,46,0,4036,3714,43
27-10-2020,krishnagiri,543,28,109,1,461,6202,28,165,0,6395,5828,106
27-10-2020,madurai,600,57,58,2,597,18354,57,153,0,18564,17550,417
27-10-2020,nagapattinam,362,35,47,0,350,6430,35,88,0,6553,6092,111
27-10-2020,namakkal,705,68,64,0,709,8662,68,98,0,8828,8026,93
27-10-2020,nilgiris,244,81,29,0,296,6390,81,19,0,6490,6156,38
27-10-2020,perambalur,74,3,6,0,71,2116,3,2,0,2121,2029,21
27-10-2020,pudukottai,215,25,24,0,216,10431,25,33,0,10489,10124,149
27-10-2020,ramanathapuram,137,3,23,1,116,5831,3,133,0,5967,5722,129
27-10-2020,ranipet,271,20,26,0,265,14669,20,49,0,14738,14297,176
27-10-2020,salem,1826,146,191,3,1778,26126,146,419,0,26691,24504,409
27-10-2020,sivagangai,135,19,22,1,131,5754,19,60,0,5833,5576,126
27-10-2020,tenkasi,127,5,29,0,103,7744,5,49,0,7798,7542,153
27-10-2020,thanjavur,371,61,101,0,331,15037,61,22,0,15120,14573,216
27-10-2020,theni,129,19,42,0,106,16100,19,45,0,16164,15867,191
27-10-2020,thirupathur,288,38,31,0,295,6378,38,110,0,6526,6113,118
27-10-2020,thiruvallur,1214,115,163,0,1166,37241,115,8,0,37364,35584,614
27-10-2020,thiruvannamalai,504,23,64,0,463,17033,23,393,0,17449,16726,260
27-10-2020,thiruvarur,402,40,52,0,390,9410,40,37,0,9487,9006,91
27-10-2020,thoothukudi,500,39,46,0,493,14548,39,269,0,14856,14234,129
27-10-2020,tirunelveli,309,28,47,0,290,13686,28,420,0,14134,13636,208
27-10-2020,tiruppur,976,99,92,5,978,12176,99,11,0,12286,11123,185
27-10-2020,trichy,493,42,61,0,474,12273,42,18,0,12333,11692,167
27-10-2020,vellore,424,68,54,0,438,17349,68,218,0,17635,16894,303
27-10-2020,villupuram,459,39,101,0,397,13374,39,174,0,13587,13084,106
27-10-2020,virudhunagar,187,27,20,0,194,15240,27,104,0,15371,14957,220
27-10-2020,airport surveillance (international),2,0,0,0,2,0,0,925,0,925,922,1
27-10-2020,airport surveillance (domestic),0,0,0,0,0,0,0,982,0,982,981,1
27-10-2020,railway surveillance,0,0,0,0,0,0,0,428,0,428,428,0
28-10-2020,ariyalur,78,12,12,1,77,4315,12,20,0,4347,4223,47
28-10-2020,chengalpattu,1267,150,231,2,1184,43010,150,5,0,43165,41312,669
28-10-2020,chennai,8082,688,957,9,7804,197028,688,35,0,197751,186331,3616
28-10-2020,coimbatore,3592,218,685,7,3118,42250,218,48,0,42516,38851,547
28-10-2020,cuddalore,710,35,90,1,654,22841,35,202,0,23078,22155,269
28-10-2020,dharmapuri,416,24,65,0,375,5302,24,214,0,5540,5117,48
28-10-2020,dindigul,228,8,23,0,213,9664,8,77,0,9749,9352,184
28-10-2020,erode,752,155,106,0,801,9766,155,94,0,10015,9094,120
28-10-2020,kallakurichi,240,20,16,0,244,9789,20,404,0,10213,9866,103
28-10-2020,kancheepuram,401,86,88,1,398,25233,86,3,0,25322,24546,378
28-10-2020,kanyakumari,566,38,62,0,542,14663,38,109,0,14810,14026,242
28-10-2020,karur,278,21,57,1,241,3989,21,46,0,4056,3771,44
28-10-2020,krishnagiri,461,27,43,0,445,6230,27,165,0,6422,5871,106
28-10-2020,madurai,593,51,80,0,564,18407,51,153,0,18611,17630,417
28-10-2020,nagapattinam,356,41,56,0,341,6471,41,88,0,6600,6148,111
28-10-2020,namakkal,716,52,121,1,646,8737,52,98,0,8887,8147,94
28-10-2020,nilgiris,296,30,49,0,277,6471,30,19,0,6520,6205,38
28-10-2020,perambalur,71,4,8,0,67,2119,4,2,0,2125,2037,21
28-10-2020,pudukottai,218,32,25,0,225,10458,32,33,0,10523,10149,149
28-10-2020,ramanathapuram,116,10,17,0,109,5834,10,133,0,5977,5739,129
28-10-2020,ranipet,260,28,25,1,262,14684,28,49,0,14761,14322,177
28-10-2020,salem,1778,147,186,2,1737,26272,147,419,0,26838,24690,411
28-10-2020,sivagangai,131,17,17,0,131,5773,17,60,0,5850,5593,126
28-10-2020,tenkasi,101,6,3,0,104,7747,6,49,0,7802,7545,153
28-10-2020,thanjavur,332,51,72,0,311,15099,51,22,0,15172,14645,216
28-10-2020,theni,107,18,28,0,97,16120,18,45,0,16183,15895,191
28-10-2020,thirupathur,296,34,51,1,278,6417,34,110,0,6561,6164,119
28-10-2020,thiruvallur,1151,138,171,2,1116,37341,138,8,0,37487,35755,616
28-10-2020,thiruvannamalai,464,21,63,1,421,17057,21,393,0,17471,16789,261
28-10-2020,thiruvarur,389,34,47,0,376,9449,34,37,0,9520,9053,91
28-10-2020,thoothukudi,493,31,49,1,474,14587,31,269,0,14887,14283,130
28-10-2020,tirunelveli,291,21,40,0,272,13715,21,420,0,14156,13676,208
28-10-2020,tiruppur,993,96,111,2,976,12290,96,11,0,12397,11234,187
28-10-2020,trichy,472,48,10,0,510,12313,48,18,0,12379,11702,167
28-10-2020,vellore,445,72,79,1,437,17424,72,218,0,17714,16973,304
28-10-2020,villupuram,397,33,91,1,338,13413,33,174,0,13620,13175,107
28-10-2020,virudhunagar,195,19,25,0,189,15268,19,104,0,15391,14982,220
28-10-2020,airport surveillance (international),2,0,0,0,2,0,0,925,0,925,922,1
28-10-2020,airport surveillance (domestic),0,0,0,0,0,0,0,982,0,982,981,1
28-10-2020,railway surveillance,0,0,0,0,0,0,0,428,0,428,428,0
29-10-2020,ariyalur,77,9,8,0,78,4327,9,20,0,4356,4231,47
29-10-2020,chengalpattu,1187,148,197,2,1136,43163,148,5,0,43316,41509,671
29-10-2020,chennai,7783,756,902,9,7628,197696,756,35,0,198487,187233,3626
29-10-2020,coimbatore,3127,251,633,6,2739,42477,251,48,0,42776,39484,553
29-10-2020,cuddalore,655,31,266,0,420,22877,31,202,0,23110,22421,269
29-10-2020,dharmapuri,375,21,48,0,348,5326,21,214,0,5561,5165,48
29-10-2020,dindigul,217,5,88,0,134,9676,5,77,0,9758,9440,184
29-10-2020,erode,789,124,83,1,829,9909,124,94,0,10127,9177,121
29-10-2020,kallakurichi,242,15,57,0,200,9807,15,404,0,10226,9923,103
29-10-2020,kancheepuram,407,89,59,2,435,25328,89,3,0,25420,24605,380
29-10-2020,kanyakumari,538,35,71,0,502,14697,35,109,0,14841,14097,242
29-10-2020,karur,243,28,22,0,249,4012,28,46,0,4086,3793,44
29-10-2020,krishnagiri,446,28,148,0,326,6258,28,165,0,6451,6019,106
29-10-2020,madurai,561,51,56,0,556,18455,51,153,0,18659,17686,417
29-10-2020,nagapattinam,344,37,38,2,341,6515,37,88,0,6640,6186,113
29-10-2020,namakkal,652,46,93,0,605,8795,46,98,0,8939,8240,94
29-10-2020,nilgiris,274,39,66,0,247,6498,39,19,0,6556,6271,38
29-10-2020,perambalur,68,2,16,0,54,2124,2,2,0,2128,2053,21
29-10-2020,pudukottai,228,28,36,0,220,10493,28,33,0,10554,10185,149
29-10-2020,ramanathapuram,110,10,21,1,98,5845,10,133,0,5988,5760,130
29-10-2020,ranipet,264,24,20,0,268,14714,24,49,0,14787,14342,177
29-10-2020,salem,1736,170,197,2,1707,26418,170,419,0,27007,24887,413
29-10-2020,sivagangai,131,15,15,0,131,5790,15,60,0,5865,5608,126
29-10-2020,tenkasi,105,7,41,0,71,7754,7,49,0,7810,7586,153
29-10-2020,thanjavur,313,88,66,1,334,15152,88,22,0,15262,14711,217
29-10-2020,theni,97,24,26,1,94,16138,24,45,0,16207,15921,192
29-10-2020,thirupathur,279,26,52,0,253,6452,26,110,0,6588,6216,119
29-10-2020,thiruvallur,1102,146,191,1,1056,37464,146,8,0,37618,35946,616
29-10-2020,thiruvannamalai,425,22,74,0,373,17082,22,393,0,17497,16863,261
29-10-2020,thiruvarur,370,45,27,4,384,9477,45,37,0,9559,9080,95
29-10-2020,thoothukudi,476,57,65,0,468,14620,57,269,0,14946,14348,130
29-10-2020,tirunelveli,272,20,72,0,220,13736,20,420,0,14176,13748,208
29-10-2020,tiruppur,982,94,114,2,960,12392,94,11,0,12497,11348,189
29-10-2020,trichy,510,47,67,0,490,12361,47,18,0,12426,11769,167
29-10-2020,vellore,435,59,78,1,415,17494,59,218,0,17771,17051,305
29-10-2020,villupuram,344,42,45,0,341,13452,42,174,0,13668,13220,107
29-10-2020,virudhunagar,190,13,29,0,174,15288,13,104,0,15405,15011,220
29-10-2020,airport surveillance (international),2,0,0,0,2,0,0,925,0,925,922,1
29-10-2020,airport surveillance (domestic),0,0,0,0,0,0,0,982,0,982,981,1
29-10-2020,railway surveillance,0,0,0,0,0,0,0,428,0,428,428,0
30-10-2020,ariyalur,78,8,19,0,67,4336,8,20,0,4364,4250,47
30-10-2020,chengalpattu,1143,158,214,1,1086,43318,158,5,0,43481,41723,672
30-10-2020,chennai,7591,723,1047,13,7254,198415,723,35,0,199173,188280,3639
30-10-2020,coimbatore,2743,228,557,3,2411,42732,228,48,0,43008,40041,556
30-10-2020,cuddalore,424,48,190,1,281,22912,48,202,0,23162,22611,270
30-10-2020,dharmapuri,348,14,97,0,265,5347,14,214,0,5575,5262,48
30-10-2020,dindigul,134,9,50,1,92,9681,9,77,0,9767,9490,185
30-10-2020,erode,825,115,39,0,901,10029,115,94,0,10238,9216,121
30-10-2020,kallakurichi,200,13,51,0,162,9822,13,404,0,10239,9974,103
30-10-2020,kancheepuram,447,91,50,1,487,25429,91,3,0,25523,24655,381
30-10-2020,kanyakumari,504,36,75,2,463,14734,36,109,0,14879,14172,244
30-10-2020,karur,244,27,17,0,254,4035,27,46,0,4108,3810,44
30-10-2020,krishnagiri,327,39,132,0,234,6287,39,165,0,6491,6151,106
30-10-2020,madurai,550,38,63,1,524,18500,38,153,0,18691,17749,418
30-10-2020,nagapattinam,341,34,44,2,329,6552,34,88,0,6674,6230,115
30-10-2020,namakkal,604,79,74,0,609,8840,79,98,0,9017,8314,94
30-10-2020,nilgiris,247,33,26,1,253,6537,33,19,0,6589,6297,39
30-10-2020,perambalur,56,5,19,0,42,2128,5,2,0,2135,2072,21
30-10-2020,pudukottai,220,19,48,0,191,10521,19,33,0,10573,10233,149
30-10-2020,ramanathapuram,99,4,11,0,92,5856,4,133,0,5993,5771,130
30-10-2020,ranipet,269,34,60,0,243,14739,34,49,0,14822,14402,177
30-10-2020,salem,1715,114,189,2,1638,26596,114,419,0,27129,25076,415
30-10-2020,sivagangai,136,12,10,0,138,5810,12,60,0,5882,5618,126
30-10-2020,tenkasi,71,4,21,0,54,7761,4,49,0,7814,7607,153
30-10-2020,thanjavur,336,47,95,3,285,15242,47,22,0,15311,14806,220
30-10-2020,theni,94,16,43,1,66,16162,16,45,0,16223,15964,193
30-10-2020,thirupathur,250,27,30,0,247,6475,27,110,0,6612,6246,119
30-10-2020,thiruvallur,1049,149,144,2,1052,37603,149,8,0,37760,36090,618
30-10-2020,thiruvannamalai,376,63,89,0,350,17107,63,393,0,17563,16952,261
30-10-2020,thiruvarur,383,37,28,2,390,9521,37,37,0,9595,9108,97
30-10-2020,thoothukudi,468,71,64,0,475,14677,71,269,0,15017,14412,130
30-10-2020,tirunelveli,220,18,40,0,198,13756,18,420,0,14194,13788,208
30-10-2020,tiruppur,962,145,100,2,1005,12488,145,11,0,12644,11448,191
30-10-2020,trichy,497,34,58,0,473,12415,34,18,0,12467,11827,167
30-10-2020,vellore,417,61,65,0,413,17555,61,218,0,17834,17116,305
30-10-2020,villupuram,342,41,50,0,333,13495,41,174,0,13710,13270,107
30-10-2020,virudhunagar,174,14,15,0,173,15301,14,104,0,15419,15026,220
30-10-2020,airport surveillance (international),2,0,0,0,2,0,0,925,0,925,922,1
30-10-2020,airport surveillance (domestic),0,0,0,0,0,0,0,982,0,982,981,1
30-10-2020,railway surveillance,0,0,0,0,0,0,0,428,0,428,428,0
31-10-2020,ariyalur,67,10,16,0,61,4344,10,20,0,4374,4266,47
31-10-2020,chengalpattu,1111,148,225,2,1032,43501,148,5,0,43654,41948,674
31-10-2020,chennai,7307,690,794,12,7191,199191,690,35,0,199916,189074,3651
31-10-2020,coimbatore,2414,241,605,1,2049,42963,241,48,0,43252,40646,557
31-10-2020,cuddalore,280,37,150,0,167,22959,37,202,0,23198,22761,270
31-10-2020,dharmapuri,266,28,61,0,233,5362,28,214,0,5604,5323,48
31-10-2020,dindigul,93,7,60,0,40,9691,7,77,0,9775,9550,185
31-10-2020,erode,887,79,151,3,812,10130,79,94,0,10303,9367,124
31-10-2020,kallakurichi,161,25,58,0,128,9834,25,404,0,10263,10032,103
31-10-2020,kancheepuram,458,92,55,1,494,25491,92,3,0,25586,24710,382
31-10-2020,kanyakumari,462,25,95,0,392,14769,25,109,0,14903,14267,244
31-10-2020,karur,253,31,39,0,245,4061,31,46,0,4138,3849,44
31-10-2020,krishnagiri,234,44,73,0,205,6326,44,165,0,6535,6224,106
31-10-2020,madurai,518,51,60,1,508,18532,51,153,0,18736,17809,419
31-10-2020,nagapattinam,333,43,50,0,326,6590,43,88,0,6721,6280,115
31-10-2020,namakkal,608,67,66,0,609,8918,67,98,0,9083,8380,94
31-10-2020,nilgiris,254,26,38,1,241,6571,26,19,0,6616,6335,40
31-10-2020,perambalur,42,4,14,0,32,2133,4,2,0,2139,2086,21
31-10-2020,pudukottai,191,22,29,0,184,10540,22,33,0,10595,10262,149
31-10-2020,ramanathapuram,95,8,27,0,76,5863,8,133,0,6004,5798,130
31-10-2020,ranipet,234,61,74,0,221,14764,61,49,0,14874,14476,177
31-10-2020,salem,1639,145,179,0,1605,26711,145,419,0,27275,25255,415
31-10-2020,sivagangai,138,19,19,0,138,5822,19,60,0,5901,5637,126
31-10-2020,tenkasi,53,10,32,0,31,7764,10,49,0,7823,7639,153
31-10-2020,thanjavur,285,32,57,0,260,15289,32,22,0,15343,14863,220
31-10-2020,theni,66,10,19,0,57,16178,10,45,0,16233,15983,193
31-10-2020,thirupathur,241,34,21,0,254,6496,34,110,0,6640,6267,119
31-10-2020,thiruvallur,1010,133,191,4,948,37710,133,8,0,37851,36281,622
31-10-2020,thiruvannamalai,352,54,87,0,319,17172,54,393,0,17619,17039,261
31-10-2020,thiruvarur,385,42,60,2,365,9553,42,37,0,9632,9168,99
31-10-2020,thoothukudi,476,42,65,0,453,14749,42,269,0,15060,14477,130
31-10-2020,tirunelveli,198,15,43,0,170,13774,15,420,0,14209,13831,208
31-10-2020,tiruppur,1015,91,121,3,982,12643,91,11,0,12745,11569,194
31-10-2020,trichy,479,32,64,1,446,12455,32,18,0,12505,11891,168
31-10-2020,vellore,418,60,71,0,407,17621,60,218,0,17899,17187,305
31-10-2020,villupuram,333,36,39,0,330,13536,36,174,0,13746,13309,107
31-10-2020,virudhunagar,174,17,40,0,151,15316,17,104,0,15437,15066,220
31-10-2020,airport surveillance (international),2,0,0,0,2,0,0,925,0,925,922,1
31-10-2020,airport surveillance (domestic),0,0,0,0,0,0,0,982,0,982,981,1
31-10-2020,railway surveillance,0,0,0,0,0,0,0,428,0,428,428,0
01-11-2020,ariyalur,64,8,16,0,56,4357,8,20,0,4385,4282,47
01-11-2020,chengalpattu,1074,145,175,2,1042,43690,145,5,0,43840,42123,675
01-11-2020,chennai,7122,686,792,11,7005,199812,686,35,0,200533,189866,3662
01-11-2020,coimbatore,2053,248,573,0,1728,43208,248,48,0,43504,41219,557
01-11-2020,cuddalore,169,46,52,1,162,22998,46,202,0,23246,22813,271
01-11-2020,dharmapuri,231,18,66,0,183,5388,18,214,0,5620,5389,48
01-11-2020,dindigul,38,29,19,0,48,9696,29,77,0,9802,9569,185
01-11-2020,erode,804,98,101,0,801,10201,98,94,0,10393,9468,124
01-11-2020,kallakurichi,128,28,33,0,123,9860,28,404,0,10292,10065,104
01-11-2020,kancheepuram,472,65,110,5,422,25561,65,3,0,25629,24820,387
01-11-2020,kanyakumari,393,43,113,0,323,14795,43,109,0,14947,14380,244
01-11-2020,karur,245,32,27,1,249,4092,32,46,0,4170,3876,45
01-11-2020,krishnagiri,207,37,37,0,207,6372,37,165,0,6574,6261,106
01-11-2020,madurai,507,43,64,0,486,18582,43,153,0,18778,17873,419
01-11-2020,nagapattinam,332,25,40,2,315,6639,25,88,0,6752,6320,117
01-11-2020,namakkal,613,64,144,1,532,8989,64,98,0,9151,8524,95
01-11-2020,nilgiris,241,45,11,0,275,6597,45,19,0,6661,6346,40
01-11-2020,perambalur,33,6,14,0,25,2138,6,2,0,2146,2100,21
01-11-2020,pudukottai,184,19,34,0,169,10562,19,33,0,10614,10296,149
01-11-2020,ramanathapuram,76,3,26,0,53,5871,3,133,0,6007,5824,130
01-11-2020,ranipet,204,47,46,0,205,14808,47,49,0,14904,14522,177
01-11-2020,salem,1608,110,286,0,1432,26859,110,419,0,27388,25541,415
01-11-2020,sivagangai,139,10,25,0,124,5842,10,60,0,5912,5662,126
01-11-2020,tenkasi,31,3,6,2,26,7774,3,49,0,7826,7645,155
01-11-2020,thanjavur,257,52,36,1,272,15318,52,22,0,15392,14899,221
01-11-2020,theni,57,17,20,0,54,16188,17,45,0,16250,16003,193
01-11-2020,thirupathur,248,47,54,0,241,6524,47,110,0,6681,6321,119
01-11-2020,thiruvallur,984,136,139,0,981,37879,136,8,0,38023,36420,622
01-11-2020,thiruvannamalai,323,64,81,0,306,17230,64,393,0,17687,17120,261
01-11-2020,thiruvarur,362,51,93,0,320,9592,51,37,0,9680,9261,99
01-11-2020,thoothukudi,455,25,24,0,456,14793,25,269,0,15087,14501,130
01-11-2020,tirunelveli,168,28,38,0,158,13787,28,420,0,14235,13869,208
01-11-2020,tiruppur,989,85,114,0,960,12741,85,11,0,12837,11683,194
01-11-2020,trichy,450,34,57,1,426,12491,34,18,0,12543,11948,169
01-11-2020,vellore,418,62,89,2,389,17692,62,218,0,17972,17276,307
01-11-2020,villupuram,332,27,49,1,309,13574,27,174,0,13775,13358,108
01-11-2020,virudhunagar,151,18,40,0,129,15333,18,104,0,15455,15106,220
01-11-2020,airport surveillance (international),2,0,0,0,2,0,0,925,0,925,922,1
01-11-2020,airport surveillance (domestic),0,0,0,0,0,0,0,982,0,982,981,1
01-11-2020,railway surveillance,0,0,0,0,0,0,0,428,0,428,428,0
02-11-2020,ariyalur,57,7,24,0,40,4366,7,20,0,4393,4306,47
02-11-2020,chengalpattu,1063,136,150,6,1043,43858,136,5,0,43999,42273,683
02-11-2020,chennai,6998,671,1238,9,6422,200489,671,35,0,201195,191104,3669
02-11-2020,coimbatore,1732,243,652,5,1318,43460,243,48,0,43751,41871,562
02-11-2020,cuddalore,165,41,49,0,157,23047,41,202,0,23290,22862,271
02-11-2020,dharmapuri,184,16,57,0,143,5407,16,214,0,5637,5446,48
02-11-2020,dindigul,48,19,5,0,62,9725,19,77,0,9821,9574,185
02-11-2020,erode,795,91,100,1,785,10293,91,94,0,10478,9568,125
02-11-2020,kallakurichi,124,27,25,0,126,9889,27,404,0,10320,10090,104
02-11-2020,kancheepuram,403,78,91,3,387,25610,78,3,0,25691,24911,393
02-11-2020,kanyakumari,323,40,102,1,260,14838,40,109,0,14987,14482,245
02-11-2020,karur,251,22,50,0,223,4126,22,46,0,4194,3926,45
02-11-2020,krishnagiri,206,25,26,0,205,6408,25,165,0,6598,6287,106
02-11-2020,madurai,484,37,46,1,474,18623,37,153,0,18813,17919,420
02-11-2020,nagapattinam,315,23,45,0,293,6664,23,88,0,6775,6365,117
02-11-2020,namakkal,528,59,124,0,463,9049,59,98,0,9206,8648,95
02-11-2020,nilgiris,275,62,47,0,290,6642,62,19,0,6723,6393,40
02-11-2020,perambalur,28,4,3,0,29,2147,4,2,0,2153,2103,21
02-11-2020,pudukottai,173,17,28,0,162,10585,17,33,0,10635,10324,149
02-11-2020,ramanathapuram,55,12,17,0,50,5876,12,133,0,6021,5841,130
02-11-2020,ranipet,208,35,10,0,233,14858,35,49,0,14942,14532,177
02-11-2020,salem,1433,125,238,2,1318,26970,125,419,0,27514,25779,417
02-11-2020,sivagangai,123,11,31,0,103,5851,11,60,0,5922,5693,126
02-11-2020,tenkasi,26,4,3,0,27,7777,4,49,0,7830,7648,155
02-11-2020,thanjavur,274,48,66,0,256,15372,48,22,0,15442,14965,221
02-11-2020,theni,57,15,17,0,55,16208,15,45,0,16268,16020,193
02-11-2020,thirupathur,241,38,61,0,218,6571,38,110,0,6719,6382,119
02-11-2020,thiruvallur,962,115,152,1,924,37993,115,8,0,38116,36572,620
02-11-2020,thiruvannamalai,308,41,32,0,317,17296,41,393,0,17730,17152,261
02-11-2020,thiruvarur,321,49,88,0,282,9644,49,37,0,9730,9349,99
02-11-2020,thoothukudi,458,39,50,0,447,14820,39,269,0,15128,14551,130
02-11-2020,tirunelveli,158,25,32,0,151,13815,25,420,0,14260,13901,208
02-11-2020,tiruppur,966,149,75,0,1040,12832,149,11,0,12992,11758,194
02-11-2020,trichy,422,31,75,0,378,12521,31,18,0,12570,12023,169
02-11-2020,vellore,387,67,49,1,404,17752,67,218,0,18037,17325,308
02-11-2020,villupuram,312,43,45,0,310,13604,43,174,0,13821,13403,108
02-11-2020,virudhunagar,129,16,37,1,107,15351,16,104,0,15471,15143,221
02-11-2020,airport surveillance (international),2,0,0,0,2,0,0,925,0,925,922,1
02-11-2020,airport surveillance (domestic),0,0,0,0,0,0,0,982,0,982,981,1
02-11-2020,railway surveillance,0,0,0,0,0,0,0,428,0,428,428,0
03-11-2020,ariyalur,41,8,4,0,45,4374,8,20,0,4402,4310,47
03-11-2020,chengalpattu,1044,136,192,1,987,43995,136,5,0,44136,42465,684
03-11-2020,chennai,6406,669,683,8,6384,201144,669,35,0,201848,191787,3677
03-11-2020,coimbatore,1317,238,490,1,1064,43703,238,48,0,43989,42361,564
03-11-2020,cuddalore,159,48,17,1,189,23090,48,202,0,23340,22879,272
03-11-2020,dharmapuri,142,24,7,1,158,5422,24,214,0,5660,5453,49
03-11-2020,dindigul,63,21,2,0,82,9745,21,77,0,9843,9576,185
03-11-2020,erode,780,88,98,2,768,10379,88,94,0,10561,9666,127
03-11-2020,kallakurichi,126,26,6,1,145,9916,26,404,0,10346,10096,105
03-11-2020,kancheepuram,389,90,59,2,418,25690,90,3,0,25783,24970,395
03-11-2020,kanyakumari,260,36,56,1,239,14878,36,109,0,15023,14538,246
03-11-2020,karur,223,31,37,0,217,4148,31,46,0,4225,3963,45
03-11-2020,krishnagiri,206,43,20,0,229,6434,43,165,0,6642,6307,106
03-11-2020,madurai,471,44,50,0,465,18657,44,153,0,18854,17969,420
03-11-2020,nagapattinam,293,33,38,1,287,6687,33,88,0,6808,6403,118
03-11-2020,namakkal,459,65,43,1,480,9104,65,98,0,9267,8691,96
03-11-2020,nilgiris,291,52,33,0,310,6704,52,19,0,6775,6426,39
03-11-2020,perambalur,29,7,8,0,28,2151,7,2,0,2160,2111,21
03-11-2020,pudukottai,164,26,11,0,179,10604,26,33,0,10663,10335,149
03-11-2020,ramanathapuram,50,9,8,0,51,5888,9,133,0,6030,5849,130
03-11-2020,ranipet,233,30,4,0,259,14893,30,49,0,14972,14536,177
03-11-2020,salem,1325,97,172,4,1246,27102,97,419,0,27618,25951,421
03-11-2020,sivagangai,103,13,9,0,107,5862,13,60,0,5935,5702,126
03-11-2020,tenkasi,27,19,3,0,43,7781,19,49,0,7849,7651,155
03-11-2020,thanjavur,258,45,31,0,272,15422,45,22,0,15489,14996,221
03-11-2020,theni,55,12,10,0,57,16223,12,45,0,16280,16030,193
03-11-2020,thirupathur,214,37,37,0,214,6605,37,110,0,6752,6419,119
03-11-2020,thiruvallur,927,113,120,3,917,38111,113,8,0,38232,36692,623
03-11-2020,thiruvannamalai,319,35,11,1,342,17339,35,393,0,17767,17163,262
03-11-2020,thiruvarur,283,39,42,1,279,9694,39,37,0,9770,9391,100
03-11-2020,thoothukudi,447,26,54,0,419,14859,26,269,0,15154,14605,130
03-11-2020,tirunelveli,151,29,28,0,152,13840,29,420,0,14289,13929,208
03-11-2020,tiruppur,1043,98,117,0,1024,12984,98,11,0,13093,11875,194
03-11-2020,trichy,377,48,70,0,355,12551,48,18,0,12617,12093,169
03-11-2020,vellore,408,55,68,1,394,17823,55,218,0,18096,17393,309
03-11-2020,villupuram,312,25,39,0,298,13649,25,174,0,13848,13442,108
03-11-2020,virudhunagar,107,20,30,1,96,15367,20,104,0,15491,15173,222
03-11-2020,airport surveillance (international),2,0,0,0,2,0,0,925,0,925,922,1
03-11-2020,airport surveillance (domestic),0,0,0,0,0,0,0,982,0,982,981,1
03-11-2020,railway surveillance,0,0,0,0,0,0,0,428,0,428,428,0
04-11-2020,ariyalur,43,9,4,0,48,4380,9,20,0,4409,4314,47
04-11-2020,chengalpattu,996,151,132,1,1014,44140,151,5,0,44296,42597,685
04-11-2020,chennai,6374,657,844,5,6182,201803,657,35,0,202495,192631,3682
04-11-2020,coimbatore,1064,220,240,4,1040,43941,220,48,0,44209,42601,568
04-11-2020,cuddalore,191,40,16,0,215,23140,40,202,0,23382,22895,272
04-11-2020,dharmapuri,159,27,6,0,180,5447,27,214,0,5688,5459,49
04-11-2020,dindigul,78,19,1,0,96,9762,19,77,0,9858,9577,185
04-11-2020,erode,767,110,70,3,804,10466,110,94,0,10670,9736,130
04-11-2020,kallakurichi,141,23,6,0,158,9938,23,404,0,10365,10102,105
04-11-2020,kancheepuram,426,116,62,4,476,25788,116,3,0,25907,25032,399
04-11-2020,kanyakumari,240,45,16,0,269,14915,45,109,0,15069,14554,246
04-11-2020,karur,217,34,3,0,248,4179,34,46,0,4259,3966,45
04-11-2020,krishnagiri,232,45,3,0,274,6480,45,165,0,6690,6310,106
04-11-2020,madurai,462,49,80,2,429,18698,49,153,0,18900,18049,422
04-11-2020,nagapattinam,290,35,30,2,293,6723,35,88,0,6846,6433,120
04-11-2020,namakkal,479,54,86,0,447,9168,54,98,0,9320,8777,96
04-11-2020,nilgiris,310,25,53,0,282,6756,25,19,0,6800,6479,39
04-11-2020,perambalur,29,7,4,0,32,2159,7,2,0,2168,2115,21
04-11-2020,pudukottai,179,25,4,0,200,10630,25,33,0,10688,10339,149
04-11-2020,ramanathapuram,51,13,6,0,58,5897,13,133,0,6043,5855,130
04-11-2020,ranipet,259,36,40,0,255,14923,36,49,0,15008,14576,177
04-11-2020,salem,1246,103,125,1,1223,27199,103,419,0,27721,26076,422
04-11-2020,sivagangai,107,24,4,0,127,5875,24,60,0,5959,5706,126
04-11-2020,tenkasi,45,17,2,0,60,7802,17,49,0,7868,7653,155
04-11-2020,thanjavur,273,54,47,0,280,15468,54,22,0,15544,15043,221
04-11-2020,theni,57,19,1,0,75,16235,19,45,0,16299,16031,193
04-11-2020,thirupathur,211,22,33,0,200,6639,22,110,0,6771,6452,119
04-11-2020,thiruvallur,901,107,126,3,879,38208,107,8,0,38323,36818,626
04-11-2020,thiruvannamalai,345,27,45,1,326,17377,27,393,0,17797,17208,263
04-11-2020,thiruvarur,278,37,44,0,271,9732,37,37,0,9806,9435,100
04-11-2020,thoothukudi,421,42,39,0,424,14887,42,269,0,15198,14644,130
04-11-2020,tirunelveli,155,21,2,0,174,13872,21,420,0,14313,13931,208
04-11-2020,tiruppur,1024,122,106,1,1039,13082,122,11,0,13215,11981,195
04-11-2020,trichy,356,45,54,0,347,12600,45,18,0,12663,12147,169
04-11-2020,vellore,397,51,69,2,377,17881,51,218,0,18150,17462,311
04-11-2020,villupuram,300,41,81,1,259,13676,41,174,0,13891,13523,109
04-11-2020,virudhunagar,96,15,20,0,91,15387,15,104,0,15506,15193,222
04-11-2020,airport surveillance (international),2,0,0,0,2,0,0,925,0,925,922,1
04-11-2020,airport surveillance (domestic),0,0,0,0,0,0,0,982,0,982,981,1
04-11-2020,railway surveillance,0,0,0,0,0,0,0,428,0,428,428,0
05-11-2020,ariyalur,48,10,8,0,50,4389,10,20,0,4419,4322,47
05-11-2020,chengalpattu,1022,112,79,3,1052,44299,112,5,0,44416,42676,688
05-11-2020,chennai,6152,621,681,12,6080,202429,621,35,0,203085,193312,3693
05-11-2020,coimbatore,1042,238,270,1,1009,44163,238,48,0,44449,42871,569
05-11-2020,cuddalore,214,38,32,0,220,23179,38,202,0,23419,22927,272
05-11-2020,dharmapuri,180,22,13,1,188,5473,22,214,0,5709,5472,49
05-11-2020,dindigul,93,18,6,0,105,9778,18,77,0,9873,9583,185
05-11-2020,erode,801,98,99,1,799,10573,98,94,0,10765,9835,131
05-11-2020,kallakurichi,158,16,21,0,153,9961,16,404,0,10381,10123,105
05-11-2020,kancheepuram,487,102,103,2,484,25915,102,3,0,26020,25135,401
05-11-2020,kanyakumari,271,39,53,0,257,14962,39,109,0,15110,14607,246
05-11-2020,karur,247,29,19,0,257,4212,29,46,0,4287,3985,45
05-11-2020,krishnagiri,274,24,8,0,290,6525,24,165,0,6714,6318,106
05-11-2020,madurai,427,45,48,1,423,18745,45,153,0,18943,18097,423
05-11-2020,nagapattinam,294,35,25,0,304,6759,35,88,0,6882,6458,120
05-11-2020,namakkal,446,39,64,0,421,9221,39,98,0,9358,8841,96
05-11-2020,nilgiris,282,33,35,1,279,6781,33,19,0,6833,6514,40
05-11-2020,perambalur,33,9,5,0,37,2167,9,2,0,2178,2120,21
05-11-2020,pudukottai,201,24,10,2,213,10656,24,33,0,10713,10349,151
05-11-2020,ramanathapuram,59,13,4,0,68,5911,13,133,0,6057,5859,130
05-11-2020,ranipet,251,11,4,0,258,14955,11,49,0,15015,14580,177
05-11-2020,salem,1229,130,135,0,1224,27309,130,419,0,27858,26211,423
05-11-2020,sivagangai,127,12,13,0,126,5899,12,60,0,5971,5719,126
05-11-2020,tenkasi,59,6,3,0,62,7818,6,49,0,7873,7656,155
05-11-2020,thanjavur,277,48,64,0,261,15519,48,22,0,15589,15107,221
05-11-2020,theni,77,14,9,0,82,16256,14,45,0,16315,16040,193
05-11-2020,thirupathur,200,15,63,0,152,6661,15,110,0,6786,6515,119
05-11-2020,thiruvallur,884,148,90,1,941,38320,148,8,0,38476,36908,627
05-11-2020,thiruvannamalai,327,43,72,0,298,17406,43,393,0,17842,17280,264
05-11-2020,thiruvarur,276,40,24,1,291,9774,40,37,0,9851,9459,101
05-11-2020,thoothukudi,425,28,50,1,402,14930,28,269,0,15227,14694,131
05-11-2020,tirunelveli,174,15,10,0,179,13893,15,420,0,14328,13941,208
05-11-2020,tiruppur,1039,110,117,0,1032,13204,110,11,0,13325,12098,195
05-11-2020,trichy,347,30,45,0,332,12645,30,18,0,12693,12192,169
05-11-2020,vellore,378,59,62,1,374,17933,59,218,0,18210,17524,312
05-11-2020,villupuram,259,58,53,0,264,13717,58,174,0,13949,13576,109
05-11-2020,virudhunagar,92,16,16,0,92,15403,16,104,0,15523,15209,222
05-11-2020,airport surveillance (international),2,0,0,0,2,0,0,925,0,925,922,1
05-11-2020,airport surveillance (domestic),0,0,0,0,0,0,0,982,0,982,981,1
05-11-2020,railway surveillance,0,0,0,0,0,0,0,428,0,428,428,0
06-11-2020,ariyalur,47,13,1,0,59,4396,13,20,0,4429,4323,47
06-11-2020,chengalpattu,1116,127,224,0,1019,44475,127,5,0,44607,42900,688
06-11-2020,chennai,6068,612,650,13,6017,203038,612,35,0,203685,193962,3706
06-11-2020,coimbatore,1014,222,233,2,1001,44406,222,48,0,44676,43104,571
06-11-2020,cuddalore,221,34,30,0,225,23218,34,202,0,23454,22957,272
06-11-2020,dharmapuri,187,18,6,0,199,5494,18,214,0,5726,5478,49
06-11-2020,dindigul,115,16,4,2,125,9806,16,77,0,9899,9587,187
06-11-2020,erode,795,116,108,2,801,10667,116,94,0,10877,9943,133
06-11-2020,kallakurichi,151,12,11,0,152,9975,12,404,0,10391,10134,105
06-11-2020,kancheepuram,408,88,94,0,402,25941,88,3,0,26032,25229,401
06-11-2020,kanyakumari,258,37,48,1,246,15002,37,109,0,15148,14655,247
06-11-2020,karur,257,31,14,0,274,4241,31,46,0,4318,3999,45
06-11-2020,krishnagiri,291,45,18,1,317,6550,45,165,0,6760,6336,107
06-11-2020,madurai,417,41,53,0,405,18784,41,153,0,18978,18150,423
06-11-2020,nagapattinam,307,36,25,0,318,6797,36,88,0,6921,6483,120
06-11-2020,namakkal,420,53,83,0,390,9259,53,98,0,9410,8924,96
06-11-2020,nilgiris,279,34,24,0,289,6814,34,19,0,6867,6538,40
06-11-2020,perambalur,37,5,4,0,38,2176,5,2,0,2183,2124,21
06-11-2020,pudukottai,215,26,27,1,213,10682,26,33,0,10741,10376,152
06-11-2020,ramanathapuram,68,9,8,0,69,5924,9,133,0,6066,5867,130
06-11-2020,ranipet,275,30,21,0,284,14983,30,49,0,15062,14601,177
06-11-2020,salem,1225,108,128,1,1204,27440,108,419,0,27967,26339,424
06-11-2020,sivagangai,125,19,18,0,126,5910,19,60,0,5989,5737,126
06-11-2020,tenkasi,61,4,2,0,63,7823,4,49,0,7876,7658,155
06-11-2020,thanjavur,262,49,39,0,272,15568,49,22,0,15639,15146,221
06-11-2020,theni,82,8,19,0,71,16270,8,45,0,16323,16059,193
06-11-2020,thirupathur,153,31,30,0,154,6677,31,110,0,6818,6545,119
06-11-2020,thiruvallur,948,143,99,1,991,38475,143,8,0,38626,37007,628
06-11-2020,thiruvannamalai,301,38,19,1,319,17452,38,393,0,17883,17299,265
06-11-2020,thiruvarur,291,32,17,0,306,9814,32,37,0,9883,9476,101
06-11-2020,thoothukudi,405,33,48,1,389,14961,33,269,0,15263,14742,132
06-11-2020,tirunelveli,180,36,8,0,208,13909,36,420,0,14365,13949,208
06-11-2020,tiruppur,1034,118,122,0,1030,13316,118,11,0,13445,12220,195
06-11-2020,trichy,334,45,41,0,338,12677,45,18,0,12740,12233,169
06-11-2020,vellore,352,53,58,1,346,17970,53,218,0,18241,17582,313
06-11-2020,villupuram,266,36,51,0,251,13777,36,174,0,13987,13627,109
06-11-2020,virudhunagar,94,12,17,0,89,15421,12,104,0,15537,15226,222
06-11-2020,airport surveillance (international),2,0,0,0,2,0,0,925,0,925,922,1
06-11-2020,airport surveillance (domestic),0,0,0,0,0,0,0,982,0,982,981,1
06-11-2020,railway surveillance,0,0,0,0,0,0,0,428,0,428,428,0
07-11-2020,ariyalur,58,11,9,0,60,4408,11,20,0,4439,4332,47
07-11-2020,chengalpattu,1029,112,198,5,938,44612,112,5,0,44729,43098,693
07-11-2020,chennai,5988,603,654,6,5931,203620,603,35,0,204258,194616,3711
07-11-2020,coimbatore,1001,213,213,1,1000,44628,213,48,0,44889,43317,572
07-11-2020,cuddalore,228,37,45,0,220,23255,37,202,0,23494,23002,272
07-11-2020,dharmapuri,200,21,11,1,209,5513,21,214,0,5748,5489,50
07-11-2020,dindigul,125,17,18,0,124,9822,17,77,0,9916,9605,187
07-11-2020,erode,799,108,108,0,799,10781,108,94,0,10983,10051,133
07-11-2020,kallakurichi,152,14,16,0,150,9987,14,404,0,10405,10150,105
07-11-2020,kancheepuram,406,85,78,2,411,26033,85,3,0,26121,25307,403
07-11-2020,kanyakumari,247,39,37,0,249,15040,39,109,0,15188,14692,247
07-11-2020,karur,274,35,9,0,300,4272,35,46,0,4353,4008,45
07-11-2020,krishnagiri,318,44,33,0,329,6596,44,165,0,6805,6369,107
07-11-2020,madurai,404,39,30,1,412,18824,39,153,0,19016,18180,424
07-11-2020,nagapattinam,319,33,26,1,325,6834,33,88,0,6955,6509,121
07-11-2020,namakkal,392,57,34,0,415,9314,57,98,0,9469,8958,96
07-11-2020,nilgiris,289,33,39,0,283,6848,33,19,0,6900,6577,40
07-11-2020,perambalur,39,7,2,0,44,2182,7,2,0,2191,2126,21
07-11-2020,pudukottai,214,27,40,0,201,10709,27,33,0,10769,10416,152
07-11-2020,ramanathapuram,69,11,8,0,72,5933,11,133,0,6077,5875,130
07-11-2020,ranipet,284,38,33,0,289,15013,38,49,0,15100,14634,177
07-11-2020,salem,1206,106,114,1,1197,27550,106,419,0,28075,26453,425
07-11-2020,sivagangai,127,23,17,0,133,5930,23,60,0,6013,5754,126
07-11-2020,tenkasi,63,6,7,0,62,7827,6,49,0,7882,7665,155
07-11-2020,thanjavur,271,47,48,0,270,15616,47,22,0,15685,15194,221
07-11-2020,theni,71,10,19,0,62,16278,10,45,0,16333,16078,193
07-11-2020,thirupathur,154,29,21,0,162,6708,29,110,0,6847,6566,119
07-11-2020,thiruvallur,996,137,120,1,1012,38624,137,8,0,38769,37127,630
07-11-2020,thiruvannamalai,320,36,28,0,328,17491,36,393,0,17920,17327,265
07-11-2020,thiruvarur,308,37,22,0,323,9848,37,37,0,9922,9498,101
07-11-2020,thoothukudi,389,31,45,1,374,14994,31,269,0,15294,14787,133
07-11-2020,tirunelveli,207,34,4,0,237,13944,34,420,0,14398,13953,208
07-11-2020,tiruppur,1030,114,106,1,1037,13434,114,11,0,13559,12326,196
07-11-2020,trichy,334,41,41,1,333,12718,41,18,0,12777,12274,170
07-11-2020,vellore,347,51,65,2,331,18024,51,218,0,18293,17647,315
07-11-2020,villupuram,251,41,38,1,253,13813,41,174,0,14028,13665,110
07-11-2020,virudhunagar,91,14,16,0,89,15435,14,104,0,15553,15242,222
07-11-2020,airport surveillance (international),2,0,0,0,2,0,0,925,0,925,922,1
07-11-2020,airport surveillance (domestic),0,0,0,0,0,0,0,982,0,982,981,1
07-11-2020,railway surveillance,0,0,0,0,0,0,0,428,0,428,428,0
08-11-2020,ariyalur,60,12,5,0,67,4419,12,20,0,4451,4337,47
08-11-2020,chengalpattu,938,120,161,0,897,44724,120,5,0,44849,43259,693
08-11-2020,chennai,5934,601,675,5,5855,204226,601,35,0,204862,195291,3716
08-11-2020,coimbatore,1000,205,215,4,986,44841,205,48,0,45094,43532,576
08-11-2020,cuddalore,220,43,43,0,220,23292,43,202,0,23537,23045,272
08-11-2020,dharmapuri,207,23,19,0,211,5532,23,214,0,5769,5508,50
08-11-2020,dindigul,120,21,4,1,136,9835,21,77,0,9933,9609,188
08-11-2020,erode,795,103,103,1,794,10885,103,94,0,11082,10154,134
08-11-2020,kallakurichi,150,11,27,0,134,10001,11,404,0,10416,10177,105
08-11-2020,kancheepuram,417,89,65,1,440,26124,89,3,0,26216,25372,404
08-11-2020,kanyakumari,249,33,48,0,234,15079,33,109,0,15221,14740,247
08-11-2020,karur,300,28,6,0,322,4307,28,46,0,4381,4014,45
08-11-2020,krishnagiri,330,34,46,0,318,6641,34,165,0,6840,6415,107
08-11-2020,madurai,410,37,51,0,396,18861,37,153,0,19051,18231,424
08-11-2020,nagapattinam,327,38,44,0,321,6869,38,88,0,6995,6553,121
08-11-2020,namakkal,416,59,54,0,421,9372,59,98,0,9529,9012,96
08-11-2020,nilgiris,283,39,28,0,294,6881,39,19,0,6939,6605,40
08-11-2020,perambalur,44,8,3,0,49,2189,8,2,0,2199,2129,21
08-11-2020,pudukottai,203,25,36,1,191,10738,25,33,0,10796,10452,153
08-11-2020,ramanathapuram,72,7,10,0,69,5944,7,133,0,6084,5885,130
08-11-2020,ranipet,286,34,30,0,290,15048,34,49,0,15131,14664,177
08-11-2020,salem,1198,102,115,1,1184,27657,102,419,0,28178,26568,426
08-11-2020,sivagangai,135,21,6,0,150,5955,21,60,0,6036,5760,126
08-11-2020,tenkasi,62,9,1,0,70,7833,9,49,0,7891,7666,155
08-11-2020,thanjavur,269,45,55,0,259,15662,45,22,0,15729,15249,221
08-11-2020,theni,62,13,11,0,64,16288,13,45,0,16346,16089,193
08-11-2020,thirupathur,162,27,29,0,160,6737,27,110,0,6874,6595,119
08-11-2020,thiruvallur,1003,133,120,4,1012,38752,133,8,0,38893,37247,634
08-11-2020,thiruvannamalai,329,41,23,0,347,17528,41,393,0,17962,17350,265
08-11-2020,thiruvarur,321,38,37,0,322,9883,38,37,0,9958,9535,101
08-11-2020,thoothukudi,374,33,25,0,382,15025,33,269,0,15327,14812,133
08-11-2020,tirunelveli,236,29,17,0,248,13977,29,420,0,14426,13970,208
08-11-2020,tiruppur,1039,119,99,0,1059,13550,119,11,0,13680,12425,196
08-11-2020,trichy,335,38,49,0,324,12761,38,18,0,12817,12323,170
08-11-2020,vellore,334,55,69,2,318,18078,55,218,0,18351,17716,317
08-11-2020,villupuram,255,45,40,0,260,13856,45,174,0,14075,13705,110
08-11-2020,virudhunagar,89,16,17,0,88,15449,16,104,0,15569,15259,222
08-11-2020,airport surveillance (international),2,0,0,0,2,0,0,925,0,925,922,1
08-11-2020,airport surveillance (domestic),0,0,0,0,0,0,0,982,0,982,981,1
08-11-2020,railway surveillance,0,0,0,0,0,0,0,428,0,428,428,0
09-11-2020,ariyalur,67,11,7,0,71,4431,11,20,0,4462,4344,47
09-11-2020,chengalpattu,934,113,128,0,919,44881,113,5,0,44999,43387,693
09-11-2020,chennai,5827,585,589,10,5813,204799,585,35,0,205419,195880,3726
09-11-2020,coimbatore,990,189,179,0,1000,45050,189,48,0,45287,43711,576
09-11-2020,cuddalore,221,38,41,0,218,23336,38,202,0,23576,23086,272
09-11-2020,dharmapuri,210,19,20,0,209,5554,19,214,0,5787,5528,50
09-11-2020,dindigul,132,17,3,0,146,9852,17,77,0,9946,9612,188
09-11-2020,erode,792,98,96,0,794,10985,98,94,0,11177,10250,133
09-11-2020,kallakurichi,134,15,10,0,139,10012,15,404,0,10431,10187,105
09-11-2020,kancheepuram,415,78,74,1,418,26188,78,3,0,26269,25446,405
09-11-2020,kanyakumari,235,35,21,1,248,15113,35,109,0,15257,14761,248
09-11-2020,karur,322,36,19,0,339,4335,36,46,0,4417,4033,45
09-11-2020,krishnagiri,317,20,27,0,310,6674,20,165,0,6859,6442,107
09-11-2020,madurai,394,46,29,0,411,18896,46,153,0,19095,18260,424
09-11-2020,nagapattinam,324,23,10,1,336,6910,23,88,0,7021,6563,122
09-11-2020,namakkal,417,54,27,0,444,9428,54,98,0,9580,9039,97
09-11-2020,nilgiris,294,36,43,0,287,6920,36,19,0,6975,6648,40
09-11-2020,perambalur,49,6,3,0,52,2197,6,2,0,2205,2132,21
09-11-2020,pudukottai,194,20,19,0,195,10766,20,33,0,10819,10471,153
09-11-2020,ramanathapuram,70,4,4,0,70,5952,4,133,0,6089,5889,130
09-11-2020,ranipet,291,22,55,0,258,15083,22,49,0,15154,14719,177
09-11-2020,salem,1189,105,255,1,1038,27764,105,419,0,28288,26823,427
09-11-2020,sivagangai,149,19,33,0,135,5975,19,60,0,6054,5793,126
09-11-2020,tenkasi,67,7,5,0,69,7839,7,49,0,7895,7671,155
09-11-2020,thanjavur,259,42,57,0,244,15707,42,22,0,15771,15306,221
09-11-2020,theni,64,23,8,0,79,16301,23,45,0,16369,16097,193
09-11-2020,thirupathur,160,29,29,0,160,6764,29,110,0,6903,6624,119
09-11-2020,thiruvallur,1024,125,112,1,1036,38897,125,8,0,39030,37359,635
09-11-2020,thiruvannamalai,348,69,35,0,382,17570,69,393,0,18032,17385,265
09-11-2020,thiruvarur,320,32,45,0,307,9919,32,37,0,9988,9580,101
09-11-2020,thoothukudi,385,31,43,0,373,15061,31,269,0,15361,14855,133
09-11-2020,tirunelveli,247,27,21,1,252,14005,27,420,0,14452,13991,209
09-11-2020,tiruppur,1061,112,125,1,1047,13671,112,11,0,13794,12550,197
09-11-2020,trichy,321,43,32,0,332,12796,43,18,0,12857,12355,170
09-11-2020,vellore,321,48,56,0,313,18136,48,218,0,18402,17772,317
09-11-2020,villupuram,260,68,26,1,301,13901,68,174,0,14143,13731,111
09-11-2020,virudhunagar,88,12,22,0,78,15465,12,104,0,15581,15281,222
09-11-2020,airport surveillance (international),2,0,0,0,2,0,0,925,0,925,922,1
09-11-2020,airport surveillance (domestic),0,0,0,0,0,0,0,982,0,982,981,1
09-11-2020,railway surveillance,0,0,0,0,0,0,0,428,0,428,428,0
10-11-2020,ariyalur,71,10,3,0,78,4442,10,20,0,4472,4347,47
10-11-2020,chengalpattu,938,104,154,1,887,45013,104,5,0,45122,43541,694
10-11-2020,chennai,5841,577,591,8,5819,205412,577,35,0,206024,196471,3734
10-11-2020,coimbatore,1009,196,186,1,1018,45248,196,48,0,45492,43897,577
10-11-2020,cuddalore,219,32,14,1,236,23375,32,202,0,23609,23100,273
10-11-2020,dharmapuri,209,13,14,0,208,5573,13,214,0,5800,5542,50
10-11-2020,dindigul,143,21,9,0,155,9866,21,77,0,9964,9621,188
10-11-2020,erode,813,77,90,0,800,11103,77,94,0,11274,10340,134
10-11-2020,kallakurichi,134,15,15,0,134,10022,15,404,0,10441,10202,105
10-11-2020,kancheepuram,416,91,56,1,450,26264,91,3,0,26358,25502,406
10-11-2020,kanyakumari,249,30,22,0,257,15149,30,109,0,15288,14783,248
10-11-2020,karur,338,29,63,1,303,4370,29,46,0,4445,4096,46
10-11-2020,krishnagiri,312,33,32,1,312,6696,33,165,0,6894,6474,108
10-11-2020,madurai,409,43,27,0,425,18940,43,153,0,19136,18287,424
10-11-2020,nagapattinam,340,43,33,0,350,6937,43,88,0,7068,6596,122
10-11-2020,namakkal,459,56,62,1,452,9497,56,98,0,9651,9101,98
10-11-2020,nilgiris,283,29,47,0,265,6952,29,19,0,7000,6695,40
10-11-2020,perambalur,52,5,9,0,48,2203,5,2,0,2210,2141,21
10-11-2020,pudukottai,193,23,16,0,200,10784,23,33,0,10840,10487,153
10-11-2020,ramanathapuram,70,3,9,0,64,5956,3,133,0,6092,5898,130
10-11-2020,ranipet,257,20,23,0,254,15104,20,49,0,15173,14742,177
10-11-2020,salem,1046,97,110,0,1033,27877,97,419,0,28393,26933,427
10-11-2020,sivagangai,136,17,12,0,141,5995,17,60,0,6072,5805,126
10-11-2020,tenkasi,67,8,6,0,69,7844,8,49,0,7901,7677,155
10-11-2020,thanjavur,242,67,42,2,265,15747,67,22,0,15836,15348,223
10-11-2020,theni,79,16,8,0,87,16324,16,45,0,16385,16105,193
10-11-2020,thirupathur,152,25,24,1,152,6785,25,110,0,6920,6648,120
10-11-2020,thiruvallur,999,107,124,1,981,38985,107,8,0,39100,37483,636
10-11-2020,thiruvannamalai,384,47,29,3,399,17641,47,393,0,18081,17414,268
10-11-2020,thiruvarur,306,31,51,0,286,9950,31,37,0,10018,9631,101
10-11-2020,thoothukudi,363,24,30,0,357,15082,24,269,0,15375,14885,133
10-11-2020,tirunelveli,254,21,19,1,255,14034,21,420,0,14475,14010,210
10-11-2020,tiruppur,1041,98,150,2,987,13777,98,11,0,13886,12700,199
10-11-2020,trichy,320,39,38,0,321,12827,39,18,0,12884,12393,170
10-11-2020,vellore,319,45,72,0,292,18190,45,218,0,18453,17844,317
10-11-2020,villupuram,281,35,42,0,274,13948,35,174,0,14157,13773,110
10-11-2020,virudhunagar,79,19,5,0,93,15478,19,104,0,15601,15286,222
10-11-2020,airport surveillance (international),2,0,0,0,2,0,0,925,0,925,922,1
10-11-2020,airport surveillance (domestic),0,0,0,0,0,0,0,982,0,982,981,1
10-11-2020,railway surveillance,0,0,0,0,0,0,0,428,0,428,428,0
11-11-2020,ariyalur,78,7,10,0,75,4452,7,20,0,4479,4357,47
11-11-2020,chengalpattu,875,142,151,0,866,45105,142,5,0,45252,43692,694
11-11-2020,chennai,5812,571,620,13,5750,205982,571,35,0,206588,197091,3747
11-11-2020,coimbatore,1022,189,168,5,1038,45448,189,48,0,45685,44065,582
11-11-2020,cuddalore,240,51,44,1,246,23411,51,202,0,23664,23144,274
11-11-2020,dharmapuri,207,11,18,0,200,5585,11,214,0,5810,5560,50
11-11-2020,dindigul,161,17,10,0,168,9893,17,77,0,9987,9631,188
11-11-2020,erode,795,96,108,0,783,11175,96,94,0,11365,10448,134
11-11-2020,kallakurichi,138,12,10,0,140,10041,12,404,0,10457,10212,105
11-11-2020,kancheepuram,457,87,50,0,494,26362,87,3,0,26452,25552,406
11-11-2020,kanyakumari,257,25,30,1,251,15179,25,109,0,15313,14813,249
11-11-2020,karur,305,23,17,0,311,4401,23,46,0,4470,4113,46
11-11-2020,krishnagiri,312,55,31,1,335,6729,55,165,0,6949,6505,109
11-11-2020,madurai,421,39,54,0,406,18979,39,153,0,19171,18341,424
11-11-2020,nagapattinam,350,42,25,0,367,6980,42,88,0,7110,6621,122
11-11-2020,namakkal,452,50,49,0,453,9553,50,98,0,9701,9150,98
11-11-2020,nilgiris,265,13,32,0,246,6981,13,19,0,7013,6727,40
11-11-2020,perambalur,48,4,3,0,49,2208,4,2,0,2214,2144,21
11-11-2020,pudukottai,201,27,24,1,203,10808,27,33,0,10868,10511,154
11-11-2020,ramanathapuram,64,2,5,0,61,5959,2,133,0,6094,5903,130
11-11-2020,ranipet,259,16,23,0,252,15129,16,49,0,15194,14765,177
11-11-2020,salem,1037,87,106,1,1017,27978,87,419,0,28484,27039,428
11-11-2020,sivagangai,138,24,15,0,147,6009,24,60,0,6093,5820,126
11-11-2020,tenkasi,70,13,4,0,79,7853,13,49,0,7915,7681,155
11-11-2020,thanjavur,260,41,36,0,265,15809,41,22,0,15872,15384,223
11-11-2020,theni,87,14,17,0,84,16340,14,45,0,16399,16122,193
11-11-2020,thirupathur,147,19,28,0,138,6805,19,110,0,6934,6676,120
11-11-2020,thiruvallur,974,148,115,0,1007,39085,148,8,0,39241,37598,636
11-11-2020,thiruvannamalai,401,21,49,0,373,17690,21,393,0,18104,17463,268
11-11-2020,thiruvarur,289,23,31,1,280,9984,23,37,0,10044,9662,102
11-11-2020,thoothukudi,357,14,37,0,334,15106,14,269,0,15389,14922,133
11-11-2020,tirunelveli,255,25,25,0,255,14055,25,420,0,14500,14035,210
11-11-2020,tiruppur,990,94,102,0,982,13878,94,11,0,13983,12802,199
11-11-2020,trichy,317,39,47,1,308,12862,39,18,0,12919,12440,171
11-11-2020,vellore,297,91,69,2,317,18240,91,218,0,18549,17913,319
11-11-2020,villupuram,275,39,36,0,278,13984,39,174,0,14197,13809,110
11-11-2020,virudhunagar,94,13,11,1,95,15498,13,104,0,15615,15297,223
11-11-2020,airport surveillance (international),2,0,0,0,2,0,0,925,0,925,922,1
11-11-2020,airport surveillance (domestic),0,0,0,0,0,0,0,982,0,982,981,1
11-11-2020,railway surveillance,0,0,0,0,0,0,0,428,0,428,428,0
12-11-2020,ariyalur,75,9,9,0,75,4459,9,20,0,4488,4366,47
12-11-2020,chengalpattu,869,148,161,1,855,45250,148,5,0,45403,43853,695
12-11-2020,chennai,5770,565,681,6,5648,206573,565,35,0,207173,197772,3753
12-11-2020,coimbatore,1038,190,192,1,1035,45637,190,48,0,45875,44257,583
12-11-2020,cuddalore,250,43,53,0,240,23465,43,202,0,23710,23197,273
12-11-2020,dharmapuri,199,18,16,0,201,5595,18,214,0,5827,5576,50
12-11-2020,dindigul,167,15,21,1,160,9909,15,77,0,10001,9652,189
12-11-2020,erode,781,65,83,0,763,11269,65,94,0,11428,10531,134
12-11-2020,kallakurichi,142,14,12,0,144,10056,14,404,0,10474,10224,106
12-11-2020,kancheepuram,498,97,47,5,543,26453,97,3,0,26553,25599,411
12-11-2020,kanyakumari,246,39,33,0,252,15199,39,109,0,15347,14846,249
12-11-2020,karur,311,20,24,0,307,4424,20,46,0,4490,4137,46
12-11-2020,krishnagiri,337,42,41,0,338,6786,42,165,0,6993,6546,109
12-11-2020,madurai,405,32,31,2,404,19017,32,153,0,19202,18372,426
12-11-2020,nagapattinam,368,25,62,1,330,7023,25,88,0,7136,6683,123
12-11-2020,namakkal,453,48,72,1,428,9603,48,98,0,9749,9222,99
12-11-2020,nilgiris,246,23,26,0,243,6994,23,19,0,7036,6753,40
12-11-2020,perambalur,49,5,5,0,49,2212,5,2,0,2219,2149,21
12-11-2020,pudukottai,203,17,23,0,197,10835,17,33,0,10885,10534,154
12-11-2020,ramanathapuram,61,6,13,0,54,5961,6,133,0,6100,5916,130
12-11-2020,ranipet,253,26,34,0,245,15146,26,49,0,15221,14799,177
12-11-2020,salem,1016,66,131,1,950,28064,66,419,0,28549,27170,429
12-11-2020,sivagangai,148,19,20,0,147,6034,19,60,0,6113,5840,126
12-11-2020,tenkasi,78,8,5,0,81,7865,8,49,0,7922,7686,155
12-11-2020,thanjavur,265,38,27,1,275,15850,38,22,0,15910,15411,224
12-11-2020,theni,84,11,10,0,85,16354,11,45,0,16410,16132,193
12-11-2020,thirupathur,136,30,25,0,141,6822,30,110,0,6962,6701,120
12-11-2020,thiruvallur,983,120,113,1,989,39209,120,8,0,39337,37711,637
12-11-2020,thiruvannamalai,375,64,35,1,403,17713,64,393,0,18170,17498,269
12-11-2020,thiruvarur,281,21,35,0,267,10008,21,37,0,10066,9697,102
12-11-2020,thoothukudi,333,26,33,0,326,15120,26,269,0,15415,14955,134
12-11-2020,tirunelveli,260,26,17,0,269,14084,26,420,0,14530,14052,209
12-11-2020,tiruppur,983,81,101,1,962,13973,81,11,0,14065,12903,200
12-11-2020,trichy,308,37,31,0,314,12901,37,18,0,12956,12471,171
12-11-2020,vellore,319,56,72,1,302,18333,56,218,0,18607,17985,320
12-11-2020,villupuram,268,42,37,0,273,14013,42,174,0,14229,13846,110
12-11-2020,virudhunagar,95,20,16,1,98,15511,20,104,0,15635,15313,224
12-11-2020,airport surveillance (international),2,0,0,0,2,0,0,925,0,925,922,1
12-11-2020,airport surveillance (domestic),0,0,0,0,0,0,0,982,0,982,981,1
12-11-2020,railway surveillance,0,0,0,0,0,0,0,428,0,428,428,0
13-11-2020,ariyalur,75,6,12,1,68,4468,6,20,0,4494,4378,48
13-11-2020,chengalpattu,897,145,141,0,901,45440,145,5,0,45590,43994,695
13-11-2020,chennai,5649,512,687,5,5469,207139,512,35,0,207686,198459,3758
13-11-2020,coimbatore,1036,179,243,1,971,45828,179,48,0,46055,44500,584
13-11-2020,cuddalore,242,24,43,1,222,23510,24,202,0,23736,23240,274
13-11-2020,dharmapuri,201,19,16,0,204,5613,19,214,0,5846,5592,50
13-11-2020,dindigul,160,16,26,0,150,9924,16,77,0,10017,9678,189
13-11-2020,erode,765,50,90,0,725,11336,50,94,0,11480,10621,134
13-11-2020,kallakurichi,146,10,30,0,126,10072,10,404,0,10486,10254,106
13-11-2020,kancheepuram,502,98,70,0,530,26509,98,3,0,26610,25669,411
13-11-2020,kanyakumari,250,21,25,0,246,15236,21,109,0,15366,14871,249
13-11-2020,karur,306,22,14,0,314,4443,22,46,0,4511,4151,46
13-11-2020,krishnagiri,340,36,25,0,351,6830,36,165,0,7031,6571,109
13-11-2020,madurai,402,46,42,0,406,19047,46,153,0,19246,18414,426
13-11-2020,nagapattinam,334,39,24,0,349,7052,39,88,0,7179,6707,123
13-11-2020,namakkal,437,51,64,0,424,9660,51,98,0,9809,9286,99
13-11-2020,nilgiris,244,32,57,1,218,7018,32,19,0,7069,6810,41
13-11-2020,perambalur,49,4,3,0,50,2217,4,2,0,2223,2152,21
13-11-2020,pudukottai,198,19,25,0,192,10853,19,33,0,10905,10559,154
13-11-2020,ramanathapuram,56,11,5,0,62,5969,11,133,0,6113,5921,130
13-11-2020,ranipet,270,30,65,0,235,15197,30,49,0,15276,14864,177
13-11-2020,salem,918,96,142,0,872,28098,96,419,0,28613,27312,429
13-11-2020,sivagangai,147,14,9,0,152,6053,14,60,0,6127,5849,126
13-11-2020,tenkasi,82,3,5,0,80,7874,3,49,0,7926,7691,155
13-11-2020,thanjavur,273,33,48,1,257,15886,33,22,0,15941,15459,225
13-11-2020,theni,84,10,15,0,79,16364,10,45,0,16419,16147,193
13-11-2020,thirupathur,142,26,38,0,130,6853,26,110,0,6989,6739,120
13-11-2020,thiruvallur,992,97,112,3,974,39332,97,8,0,39437,37823,640
13-11-2020,thiruvannamalai,404,25,42,0,387,17778,25,393,0,18196,17540,269
13-11-2020,thiruvarur,269,24,52,0,241,10031,24,37,0,10092,9749,102
13-11-2020,thoothukudi,326,19,47,1,297,15146,19,269,0,15434,15002,135
13-11-2020,tirunelveli,270,28,31,0,267,14111,28,420,0,14559,14083,209
13-11-2020,tiruppur,965,80,156,0,889,14057,80,11,0,14148,13059,200
13-11-2020,trichy,312,29,36,0,305,12936,29,18,0,12983,12507,171
13-11-2020,vellore,279,49,77,0,251,18366,49,218,0,18633,18062,320
13-11-2020,villupuram,273,18,37,0,254,14055,18,174,0,14247,13883,110
13-11-2020,virudhunagar,98,18,18,0,98,15531,18,104,0,15653,15331,224
13-11-2020,airport surveillance (international),2,0,0,0,2,0,0,925,0,925,922,1
13-11-2020,airport surveillance (domestic),0,0,0,0,0,0,0,982,0,982,981,1
13-11-2020,railway surveillance,0,0,0,0,0,0,0,428,0,428,428,0
16-11-2020,ariyalur,57,3,7,0,53,4482,3,20,0,4505,4404,48
16-11-2020,chengalpattu,924,118,129,1,912,45904,118,5,0,46027,44419,696
16-11-2020,chennai,5100,497,612,7,4978,208635,497,35,0,209167,200417,3772
16-11-2020,coimbatore,891,174,181,1,883,46365,174,48,0,46587,45117,587
16-11-2020,cuddalore,219,28,31,0,216,23612,28,202,0,23842,23351,275
16-11-2020,dharmapuri,176,10,11,0,175,5660,10,214,0,5884,5659,50
16-11-2020,dindigul,140,15,20,0,135,9974,15,77,0,10066,9742,189
16-11-2020,erode,624,64,108,0,580,11504,64,94,0,11662,10946,136
16-11-2020,kallakurichi,119,12,29,0,102,10112,12,404,0,10528,10320,106
16-11-2020,kancheepuram,485,79,80,1,483,26740,79,3,0,26822,25926,413
16-11-2020,kanyakumari,209,26,24,1,210,15303,26,109,0,15438,14978,250
16-11-2020,karur,324,22,48,1,297,4525,22,46,0,4593,4249,47
16-11-2020,krishnagiri,346,26,48,0,324,6924,26,165,0,7115,6680,111
16-11-2020,madurai,365,28,44,3,346,19168,28,153,0,19349,18571,432
16-11-2020,nagapattinam,331,17,49,0,299,7141,17,88,0,7246,6824,123
16-11-2020,namakkal,438,40,59,0,419,9799,40,98,0,9937,9419,99
16-11-2020,nilgiris,191,19,15,0,195,7092,19,19,0,7130,6894,41
16-11-2020,perambalur,45,0,12,0,33,2226,0,2,0,2228,2174,21
16-11-2020,pudukottai,177,12,18,0,171,10906,12,33,0,10951,10626,154
16-11-2020,ramanathapuram,61,5,17,0,49,5991,5,133,0,6129,5950,130
16-11-2020,ranipet,166,34,36,0,164,15278,34,49,0,15361,15020,177
16-11-2020,salem,821,74,114,0,781,28376,74,419,0,28869,27659,429
16-11-2020,sivagangai,142,8,17,0,133,6088,8,60,0,6156,5897,126
16-11-2020,tenkasi,73,2,2,0,73,7888,2,49,0,7939,7711,155
16-11-2020,thanjavur,261,34,40,0,255,16000,34,22,0,16056,15576,225
16-11-2020,theni,65,10,5,1,69,16394,10,45,0,16449,16186,194
16-11-2020,thirupathur,130,20,39,0,111,6931,20,110,0,7061,6830,120
16-11-2020,thiruvallur,834,83,163,1,753,39605,83,8,0,39696,38299,644
16-11-2020,thiruvannamalai,336,44,44,0,336,17863,44,393,0,18300,17695,269
16-11-2020,thiruvarur,229,23,54,0,198,10104,23,37,0,10164,9864,102
16-11-2020,thoothukudi,274,7,50,0,231,15198,7,269,0,15474,15108,135
16-11-2020,tirunelveli,274,16,30,0,260,14184,16,420,0,14620,14151,209
16-11-2020,tiruppur,766,69,115,0,720,14288,69,11,0,14368,13448,200
16-11-2020,trichy,297,26,48,0,275,13030,26,18,0,13074,12628,171
16-11-2020,vellore,233,41,38,0,236,18510,41,218,0,18769,18211,322
16-11-2020,villupuram,222,25,31,0,216,14124,25,174,0,14323,13997,110
16-11-2020,virudhunagar,94,10,16,0,88,15578,10,104,0,15692,15379,225
16-11-2020,airport surveillance (international),2,0,0,0,2,0,0,925,0,925,922,1
16-11-2020,airport surveillance (domestic),0,4,0,0,4,0,0,982,4,986,981,1
16-11-2020,railway surveillance,0,0,0,0,0,0,0,428,0,428,428,0
17-11-2020,ariyalur,53,7,14,0,46,4485,7,20,0,4512,4418,48
17-11-2020,chengalpattu,919,112,117,0,914,46029,112,5,0,46146,44536,696
17-11-2020,chennai,4964,492,624,10,4822,209119,492,35,0,209646,201041,3783
17-11-2020,coimbatore,882,170,188,4,860,46539,170,48,0,46757,45305,592
17-11-2020,cuddalore,216,24,38,0,202,23640,24,202,0,23866,23389,275
17-11-2020,dharmapuri,177,19,21,0,175,5672,19,214,0,5905,5680,50
17-11-2020,dindigul,136,11,14,1,132,9990,11,77,0,10078,9756,190
17-11-2020,erode,575,47,104,0,518,11563,47,94,0,11704,11050,136
17-11-2020,kallakurichi,102,19,16,0,105,10124,19,404,0,10547,10336,106
17-11-2020,kancheepuram,484,76,81,0,479,26820,76,3,0,26899,26007,413
17-11-2020,kanyakumari,210,21,39,0,192,15329,21,109,0,15459,15017,250
17-11-2020,karur,296,20,37,0,279,4546,20,46,0,4612,4286,47
17-11-2020,krishnagiri,325,24,31,0,318,6951,24,165,0,7140,6711,111
17-11-2020,madurai,346,22,50,0,318,19196,22,153,0,19371,18621,432
17-11-2020,nagapattinam,299,25,38,0,286,7158,25,88,0,7271,6862,123
17-11-2020,namakkal,424,36,56,1,403,9844,36,98,0,9978,9475,100
17-11-2020,nilgiris,196,14,40,0,170,7111,14,19,0,7144,6934,40
17-11-2020,perambalur,33,0,3,0,30,2226,0,2,0,2228,2177,21
17-11-2020,pudukottai,172,9,28,0,153,10919,9,33,0,10961,10654,154
17-11-2020,ramanathapuram,50,4,12,0,42,5997,4,133,0,6134,5962,130
17-11-2020,ranipet,164,30,40,0,154,15312,30,49,0,15391,15060,177
17-11-2020,salem,774,69,117,1,725,28443,69,419,0,28931,27776,430
17-11-2020,sivagangai,133,6,22,0,117,6096,6,60,0,6162,5919,126
17-11-2020,tenkasi,73,10,6,0,77,7890,10,49,0,7949,7717,155
17-11-2020,thanjavur,255,29,40,0,244,16034,29,22,0,16085,15616,225
17-11-2020,theni,69,8,14,0,63,16404,8,45,0,16457,16200,194
17-11-2020,thirupathur,111,18,23,0,106,6951,18,110,0,7079,6853,120
17-11-2020,thiruvallur,758,97,121,1,733,39692,97,8,0,39797,38420,644
17-11-2020,thiruvannamalai,336,36,39,0,333,17907,36,393,0,18336,17734,269
17-11-2020,thiruvarur,198,28,37,0,189,10127,28,37,0,10192,9901,102
17-11-2020,thoothukudi,232,5,31,0,206,15206,5,269,0,15480,15139,135
17-11-2020,tirunelveli,260,19,20,0,259,14200,19,420,0,14639,14171,209
17-11-2020,tiruppur,724,61,87,0,698,14361,61,11,0,14433,13535,200
17-11-2020,trichy,273,22,56,0,239,13054,22,18,0,13094,12684,171
17-11-2020,vellore,236,35,58,0,213,18551,35,218,0,18804,18269,322
17-11-2020,villupuram,216,23,39,0,200,14149,23,174,0,14346,14036,110
17-11-2020,virudhunagar,88,4,13,0,79,15588,4,104,0,15696,15392,225
17-11-2020,airport surveillance (international),2,0,0,0,2,0,0,925,0,925,922,1
17-11-2020,airport surveillance (domestic),4,0,0,0,4,0,0,986,0,986,981,1
17-11-2020,railway surveillance,0,0,0,0,0,0,0,428,0,428,428,0
18-11-2020,ariyalur,46,1,4,0,43,4492,1,20,0,4513,4422,48
18-11-2020,chengalpattu,914,129,156,2,885,46141,129,5,0,46275,44692,698
18-11-2020,chennai,4832,479,608,5,4698,209621,479,35,0,210135,201649,3788
18-11-2020,coimbatore,861,162,205,1,817,46710,162,48,0,46920,45510,593
18-11-2020,cuddalore,202,45,39,0,208,23664,45,202,0,23911,23428,275
18-11-2020,dharmapuri,172,5,20,0,157,5688,5,214,0,5907,5700,50
18-11-2020,dindigul,133,8,15,1,125,10002,8,77,0,10087,9771,191
18-11-2020,erode,518,42,102,0,458,11610,42,94,0,11746,11152,136
18-11-2020,kallakurichi,105,11,18,0,98,10143,11,404,0,10558,10354,106
18-11-2020,kancheepuram,479,93,81,2,489,26896,93,3,0,26992,26088,415
18-11-2020,kanyakumari,192,13,33,0,172,15350,13,109,0,15472,15050,250
18-11-2020,karur,280,13,23,0,270,4567,13,46,0,4626,4309,47
18-11-2020,krishnagiri,321,31,25,0,327,6978,31,165,0,7174,6736,111
18-11-2020,madurai,319,30,42,0,307,19219,30,153,0,19402,18663,432
18-11-2020,nagapattinam,286,38,28,0,296,7183,38,88,0,7309,6890,123
18-11-2020,namakkal,400,38,59,0,379,9877,37,98,1,10013,9534,100
18-11-2020,nilgiris,171,17,23,0,165,7126,17,19,0,7162,6957,40
18-11-2020,perambalur,30,2,5,0,27,2226,2,2,0,2230,2182,21
18-11-2020,pudukottai,154,9,13,0,150,10929,9,33,0,10971,10667,154
18-11-2020,ramanathapuram,42,6,9,0,39,6001,6,133,0,6140,5971,130
18-11-2020,ranipet,156,21,36,1,140,15344,21,49,0,15414,15096,178
18-11-2020,salem,725,57,110,0,672,28512,57,419,0,28988,27886,430
18-11-2020,sivagangai,117,11,24,0,104,6102,5,60,6,6173,5943,126
18-11-2020,tenkasi,77,6,17,0,66,7900,6,49,0,7955,7734,155
18-11-2020,thanjavur,244,24,47,0,221,16063,24,22,0,16109,15663,225
18-11-2020,theni,63,7,11,0,59,16412,7,45,0,16464,16211,194
18-11-2020,thirupathur,107,14,26,0,95,6970,14,110,0,7094,6879,120
18-11-2020,thiruvallur,724,112,124,1,711,39780,112,8,0,39900,38544,645
18-11-2020,thiruvannamalai,333,25,75,2,281,17943,25,393,0,18361,17809,271
18-11-2020,thiruvarur,189,21,22,0,188,10155,21,37,0,10213,9923,102
18-11-2020,thoothukudi,207,12,29,0,190,15212,12,269,0,15493,15168,135
18-11-2020,tirunelveli,256,19,27,0,248,14216,19,420,0,14655,14198,209
18-11-2020,tiruppur,698,80,103,2,673,14422,80,11,0,14513,13638,202
18-11-2020,trichy,234,31,38,0,227,13071,31,18,0,13120,12722,171
18-11-2020,vellore,213,71,61,1,222,18586,71,218,0,18875,18330,323
18-11-2020,villupuram,200,17,41,0,176,14172,17,174,0,14363,14077,110
18-11-2020,virudhunagar,79,11,12,0,78,15592,11,104,0,15707,15404,225
18-11-2020,airport surveillance (international),2,0,0,0,2,0,0,925,0,925,922,1
18-11-2020,airport surveillance (domestic),4,3,0,0,7,0,0,986,3,989,981,1
18-11-2020,railway surveillance,0,0,0,0,0,0,0,428,0,428,428,0
19-11-2020,ariyalur,42,8,12,0,38,4492,8,20,0,4520,4434,48
19-11-2020,chengalpattu,909,119,130,3,895,46294,119,5,0,46418,44822,701
19-11-2020,chennai,4693,471,593,4,4567,210095,471,35,0,210601,202242,3792
19-11-2020,coimbatore,819,149,183,0,785,46874,149,48,0,47071,45693,593
19-11-2020,cuddalore,210,34,40,0,204,23711,34,202,0,23947,23468,275
19-11-2020,dharmapuri,156,16,34,0,138,5692,16,214,0,5922,5734,50
19-11-2020,dindigul,125,6,18,1,112,10010,6,77,0,10093,9789,192
19-11-2020,erode,455,37,92,1,399,11649,37,94,0,11780,11244,137
19-11-2020,kallakurichi,99,17,13,0,103,10155,17,404,0,10576,10367,106
19-11-2020,kancheepuram,450,98,42,1,505,26950,98,3,0,27051,26130,416
19-11-2020,kanyakumari,172,13,21,0,164,15363,13,109,0,15485,15071,250
19-11-2020,karur,270,12,28,0,254,4580,12,46,0,4638,4337,47
19-11-2020,krishnagiri,328,22,32,1,317,7010,22,165,0,7197,6768,112
19-11-2020,madurai,305,24,33,2,294,19247,24,153,0,19424,18696,434
19-11-2020,nagapattinam,298,41,30,0,309,7223,41,88,0,7352,6920,123
19-11-2020,namakkal,380,30,81,0,329,9915,30,99,0,10044,9615,100
19-11-2020,nilgiris,163,16,28,0,151,7141,16,19,0,7176,6985,40
19-11-2020,perambalur,27,2,13,0,16,2228,2,2,0,2232,2195,21
19-11-2020,pudukottai,150,13,17,0,146,10938,13,33,0,10984,10684,154
19-11-2020,ramanathapuram,39,7,9,0,37,6007,7,133,0,6147,5980,130
19-11-2020,ranipet,153,16,25,0,144,15378,16,49,0,15443,15121,178
19-11-2020,salem,673,59,106,2,624,28570,59,419,0,29048,27992,432
19-11-2020,sivagangai,105,13,24,0,94,6108,11,66,2,6187,5967,126
19-11-2020,tenkasi,68,5,14,0,59,7908,5,49,0,7962,7748,155
19-11-2020,thanjavur,225,17,46,0,196,16091,17,22,0,16130,15709,225
19-11-2020,theni,60,14,32,0,42,16420,14,45,0,16479,16243,194
19-11-2020,thirupathur,98,10,13,0,95,6987,10,110,0,7107,6892,120
19-11-2020,thiruvallur,710,138,121,2,725,39891,138,8,0,40037,38665,647
19-11-2020,thiruvannamalai,288,24,56,0,256,17975,24,393,0,18392,17865,271
19-11-2020,thiruvarur,190,24,25,0,189,10178,24,37,0,10239,9948,102
19-11-2020,thoothukudi,194,10,44,0,160,15228,10,269,0,15507,15212,135
19-11-2020,tirunelveli,243,13,63,0,193,14230,13,420,0,14663,14261,209
19-11-2020,tiruppur,675,93,72,1,695,14504,93,11,0,14608,13710,203
19-11-2020,trichy,225,30,51,0,204,13100,30,18,0,13148,12773,171
19-11-2020,vellore,209,64,41,1,231,18644,64,218,0,18926,18371,324
19-11-2020,villupuram,177,23,53,0,147,14190,23,174,0,14387,14130,110
19-11-2020,virudhunagar,78,18,16,0,80,15603,18,104,0,15725,15420,225
19-11-2020,airport surveillance (international),2,0,0,0,2,0,0,925,0,925,922,1
19-11-2020,airport surveillance (domestic),7,1,0,0,8,0,0,989,1,990,981,1
19-11-2020,railway surveillance,0,0,0,0,0,0,0,428,0,428,428,0
20-11-2020,ariyalur,37,4,15,0,26,4499,4,20,0,4523,4449,48
20-11-2020,chengalpattu,916,125,161,2,878,46434,125,5,0,46564,44983,703
20-11-2020,chennai,4559,489,418,8,4622,210560,489,35,0,211084,202660,3802
20-11-2020,coimbatore,786,147,152,2,779,47024,147,48,0,47219,45845,595
20-11-2020,cuddalore,205,15,67,0,153,23746,15,202,0,23963,23535,275
20-11-2020,dharmapuri,136,12,17,0,131,5706,12,214,0,5932,5751,50
20-11-2020,dindigul,113,9,37,1,84,10017,9,77,0,10103,9826,193
20-11-2020,erode,401,40,107,0,334,11688,40,94,0,11822,11351,137
20-11-2020,kallakurichi,101,14,12,0,103,10170,14,404,0,10588,10379,106
20-11-2020,kancheepuram,491,102,104,1,488,27034,102,3,0,27139,26234,417
20-11-2020,kanyakumari,164,14,22,0,156,15376,14,109,0,15499,15093,250
20-11-2020,karur,255,15,28,0,242,4593,15,46,0,4654,4365,47
20-11-2020,krishnagiri,317,15,30,0,302,7032,15,165,0,7212,6798,112
20-11-2020,madurai,295,32,52,2,273,19272,32,153,0,19457,18748,436
20-11-2020,nagapattinam,310,29,62,0,277,7265,29,88,0,7382,6982,123
20-11-2020,namakkal,329,21,59,0,291,9945,21,99,0,10065,9674,100
20-11-2020,nilgiris,151,18,24,0,145,7157,18,19,0,7194,7009,40
20-11-2020,perambalur,16,1,9,0,8,2230,1,2,0,2233,2204,21
20-11-2020,pudukottai,147,23,44,0,126,10952,23,33,0,11008,10728,154
20-11-2020,ramanathapuram,37,8,3,0,42,6014,8,133,0,6155,5983,130
20-11-2020,ranipet,143,19,19,0,143,15393,19,49,0,15461,15140,178
20-11-2020,salem,628,78,61,1,644,28633,78,419,0,29130,28053,433
20-11-2020,sivagangai,91,8,20,0,79,6116,8,68,0,6192,5987,126
20-11-2020,tenkasi,59,6,18,0,47,7913,6,49,0,7968,7766,155
20-11-2020,thanjavur,195,25,26,0,194,16107,25,22,0,16154,15735,225
20-11-2020,theni,42,16,24,0,34,16434,16,45,0,16495,16267,194
20-11-2020,thirupathur,96,21,24,0,93,6998,21,110,0,7129,6916,120
20-11-2020,thiruvallur,721,132,146,0,707,40023,132,8,0,40163,38811,645
20-11-2020,thiruvannamalai,256,18,83,0,191,17999,18,393,0,18410,17948,271
20-11-2020,thiruvarur,190,22,35,0,177,10203,22,37,0,10262,9983,102
20-11-2020,thoothukudi,161,4,52,0,113,15239,4,269,0,15512,15264,135
20-11-2020,tirunelveli,193,16,35,0,174,14243,16,420,0,14679,14296,209
20-11-2020,tiruppur,695,82,99,1,677,14597,82,11,0,14690,13809,204
20-11-2020,trichy,198,25,54,0,169,13124,25,18,0,13167,12827,171
20-11-2020,vellore,233,51,0,0,284,18710,51,218,0,18979,18371,324
20-11-2020,villupuram,149,25,25,0,149,14215,25,174,0,14414,14155,110
20-11-2020,virudhunagar,81,5,29,0,57,15622,5,104,0,15731,15449,225
20-11-2020,airport surveillance (international),2,0,0,0,2,0,0,925,0,925,922,1
20-11-2020,airport surveillance (domestic),8,2,0,0,10,0,0,990,2,992,981,1
20-11-2020,railway surveillance,0,0,0,0,0,0,0,428,0,428,428,0
21-11-2020,ariyalur,25,5,2,0,28,4502,5,20,0,4527,4451,48
21-11-2020,chengalpattu,915,116,142,2,887,46596,116,5,0,46717,45125,705
21-11-2020,chennai,4607,486,589,6,4498,211034,486,35,0,211555,203249,3808
21-11-2020,coimbatore,792,148,190,2,748,47184,148,48,0,47380,46035,597
21-11-2020,cuddalore,154,16,33,0,137,23762,16,202,0,23980,23568,275
21-11-2020,dharmapuri,130,16,11,0,135,5717,16,214,0,5947,5762,50
21-11-2020,dindigul,83,12,18,0,77,10025,12,77,0,10114,9844,193
21-11-2020,erode,335,48,97,1,285,11729,48,94,0,11871,11448,138
21-11-2020,kallakurichi,102,13,19,0,96,10183,13,404,0,10600,10398,106
21-11-2020,kancheepuram,456,92,81,0,467,27104,92,3,0,27199,26315,417
21-11-2020,kanyakumari,157,16,23,1,149,15391,16,109,0,15516,15116,251
21-11-2020,karur,242,17,23,0,236,4608,17,46,0,4671,4388,47
21-11-2020,krishnagiri,302,10,52,0,260,7047,10,165,0,7222,6850,112
21-11-2020,madurai,270,25,31,0,264,19301,25,153,0,19479,18779,436
21-11-2020,nagapattinam,277,27,25,0,279,7294,27,88,0,7409,7007,123
21-11-2020,namakkal,288,38,52,0,274,9963,38,99,0,10100,9726,100
21-11-2020,nilgiris,145,8,17,0,136,7175,8,19,0,7202,7026,40
21-11-2020,perambalur,6,0,2,0,4,2229,0,2,0,2231,2206,21
21-11-2020,pudukottai,128,16,21,0,123,10977,16,33,0,11026,10749,154
21-11-2020,ramanathapuram,43,6,4,1,44,6023,6,133,0,6162,5987,131
21-11-2020,ranipet,145,17,20,0,142,15414,17,49,0,15480,15160,178
21-11-2020,salem,647,66,86,0,627,28714,66,419,0,29199,28139,433
21-11-2020,sivagangai,79,13,24,0,68,6124,13,68,0,6205,6011,126
21-11-2020,tenkasi,47,4,5,0,46,7919,4,49,0,7972,7771,155
21-11-2020,thanjavur,194,27,39,1,181,16132,27,22,0,16181,15774,226
21-11-2020,theni,35,3,8,0,30,16451,3,45,0,16499,16275,194
21-11-2020,thirupathur,93,14,15,0,92,7019,14,110,0,7143,6931,120
21-11-2020,thiruvallur,695,114,145,0,664,40143,114,8,0,40265,38956,645
21-11-2020,thiruvannamalai,193,37,20,0,210,18019,37,393,0,18449,17968,271
21-11-2020,thiruvarur,177,16,11,0,182,10225,16,37,0,10278,9994,102
21-11-2020,thoothukudi,114,29,15,0,128,15244,29,269,0,15542,15279,135
21-11-2020,tirunelveli,172,7,31,0,148,14257,7,420,0,14684,14327,209
21-11-2020,tiruppur,680,70,98,2,650,14682,70,11,0,14763,13907,206
21-11-2020,trichy,169,27,47,0,149,13149,27,18,0,13194,12874,171
21-11-2020,vellore,288,41,88,2,239,18765,41,218,0,19024,18459,326
21-11-2020,villupuram,149,32,40,0,141,14240,32,174,0,14446,14195,110
21-11-2020,virudhunagar,58,30,9,0,79,15628,30,104,0,15762,15458,225
21-11-2020,airport surveillance (international),2,0,0,0,2,0,0,925,0,925,922,1
21-11-2020,airport surveillance (domestic),10,1,0,0,11,0,0,992,1,993,981,1
21-11-2020,railway surveillance,0,0,0,0,0,0,0,428,0,428,428,0
22-11-2020,ariyalur,28,7,5,0,30,4507,7,20,0,4534,4456,48
22-11-2020,chengalpattu,896,108,131,0,873,46721,108,5,0,46834,45256,705
22-11-2020,chennai,4468,489,575,8,4374,211490,489,35,0,212014,203824,3816
22-11-2020,coimbatore,749,154,181,2,720,47333,154,48,0,47535,46216,599
22-11-2020,cuddalore,144,31,43,0,132,23785,31,202,0,24018,23611,275
22-11-2020,dharmapuri,136,14,18,0,132,5734,14,214,0,5962,5780,50
22-11-2020,dindigul,77,10,17,0,70,10037,10,77,0,10124,9861,193
22-11-2020,erode,286,58,64,1,279,11778,58,94,0,11930,11512,139
22-11-2020,kallakurichi,98,8,14,0,92,10198,8,404,0,10610,10412,106
22-11-2020,kancheepuram,471,82,96,0,457,27200,82,3,0,27285,26411,417
22-11-2020,kanyakumari,149,17,31,0,135,15407,17,109,0,15533,15147,251
22-11-2020,karur,236,25,14,0,247,4625,25,46,0,4696,4402,47
22-11-2020,krishnagiri,260,16,30,0,246,7057,16,165,0,7238,6880,112
22-11-2020,madurai,261,33,30,0,264,19323,33,153,0,19509,18809,436
22-11-2020,nagapattinam,279,44,28,0,295,7321,44,88,0,7453,7035,123
22-11-2020,namakkal,273,41,51,1,262,10000,41,99,0,10140,9777,101
22-11-2020,nilgiris,136,31,15,0,152,7183,31,19,0,7233,7041,40
22-11-2020,perambalur,4,1,2,0,3,2229,1,2,0,2232,2208,21
22-11-2020,pudukottai,124,8,15,0,117,10994,8,33,0,11035,10764,154
22-11-2020,ramanathapuram,45,7,4,0,48,6030,7,133,0,6170,5991,131
22-11-2020,ranipet,142,9,20,0,131,15431,9,49,0,15489,15180,178
22-11-2020,salem,631,67,66,0,632,28784,67,419,0,29270,28205,433
22-11-2020,sivagangai,69,14,12,0,71,6138,14,68,0,6220,6023,126
22-11-2020,tenkasi,47,23,11,0,59,7924,23,49,0,7996,7782,155
22-11-2020,thanjavur,183,25,36,0,172,16161,25,22,0,16208,15810,226
22-11-2020,theni,31,8,9,1,29,16455,8,45,0,16508,16284,195
22-11-2020,thirupathur,92,3,32,1,62,7033,3,110,0,7146,6963,121
22-11-2020,thiruvallur,665,92,128,2,627,40258,92,8,0,40358,39084,647
22-11-2020,thiruvannamalai,211,16,59,0,168,18057,16,393,0,18466,18027,271
22-11-2020,thiruvarur,182,24,23,0,183,10241,24,37,0,10302,10017,102
22-11-2020,thoothukudi,130,10,23,0,117,15275,10,269,0,15554,15302,135
22-11-2020,tirunelveli,148,9,15,0,142,14264,9,420,0,14693,14342,209
22-11-2020,tiruppur,650,72,87,1,634,14752,72,11,0,14835,13994,207
22-11-2020,trichy,147,21,36,1,131,13174,21,18,0,13213,12910,172
22-11-2020,vellore,238,39,47,1,229,18805,39,218,0,19062,18506,327
22-11-2020,villupuram,138,19,23,0,134,14269,19,174,0,14462,14218,110
22-11-2020,virudhunagar,79,20,19,0,80,15658,20,104,0,15782,15477,225
22-11-2020,airport surveillance (international),2,0,0,0,2,0,0,925,0,925,922,1
22-11-2020,airport surveillance (domestic),11,0,0,0,11,0,0,993,0,993,981,1
22-11-2020,railway surveillance,0,0,0,0,0,0,0,428,0,428,428,0
23-11-2020,ariyalur,30,1,7,0,24,4514,1,20,0,4535,4463,48
23-11-2020,chengalpattu,900,99,138,1,860,46856,99,5,0,46960,45394,706
23-11-2020,chennai,4381,483,504,6,4354,211986,483,35,0,212504,204328,3822
23-11-2020,coimbatore,721,140,163,0,698,47488,140,48,0,47676,46379,599
23-11-2020,cuddalore,133,24,23,0,134,23817,24,202,0,24043,23634,275
23-11-2020,dharmapuri,129,19,13,0,135,5745,19,214,0,5978,5793,50
23-11-2020,dindigul,70,13,15,0,68,10047,13,77,0,10137,9876,193
23-11-2020,erode,278,72,47,0,303,11835,72,94,0,12001,11559,139
23-11-2020,kallakurichi,91,6,16,0,81,10205,6,404,0,10615,10428,106
23-11-2020,kancheepuram,427,72,93,2,404,27252,72,3,0,27327,26504,419
23-11-2020,kanyakumari,135,20,22,0,133,15424,20,109,0,15553,15169,251
23-11-2020,karur,247,21,22,0,246,4650,21,46,0,4717,4424,47
23-11-2020,krishnagiri,249,25,37,0,237,7076,25,165,0,7266,6917,112
23-11-2020,madurai,264,24,42,1,245,19356,24,153,0,19533,18851,437
23-11-2020,nagapattinam,295,27,39,0,283,7365,27,88,0,7480,7074,123
23-11-2020,namakkal,260,42,53,0,249,10039,42,99,0,10180,9830,101
23-11-2020,nilgiris,151,34,41,0,144,7213,34,19,0,7266,7082,40
23-11-2020,perambalur,4,0,3,0,1,2231,0,2,0,2233,2211,21
23-11-2020,pudukottai,118,12,16,0,114,11003,12,33,0,11048,10780,154
23-11-2020,ramanathapuram,48,9,12,0,45,6037,9,133,0,6179,6003,131
23-11-2020,ranipet,134,16,28,0,122,15443,16,49,0,15508,15208,178
23-11-2020,salem,633,77,99,1,610,28852,77,419,0,29348,28304,434
23-11-2020,sivagangai,72,9,13,0,68,6153,9,68,0,6230,6036,126
23-11-2020,tenkasi,58,13,4,0,67,7946,13,49,0,8008,7786,155
23-11-2020,thanjavur,172,16,27,1,160,16186,16,22,0,16224,15837,227
23-11-2020,theni,29,10,12,1,26,16463,10,45,0,16518,16296,196
23-11-2020,thirupathur,64,9,20,0,53,7038,9,110,0,7157,6983,121
23-11-2020,thiruvallur,618,79,100,2,595,40341,79,8,0,40428,39184,649
23-11-2020,thiruvannamalai,172,18,24,0,166,18077,18,393,0,18488,18051,271
23-11-2020,thiruvarur,184,30,25,1,188,10266,30,37,0,10333,10042,103
23-11-2020,thoothukudi,119,18,22,0,115,15287,18,269,0,15574,15324,135
23-11-2020,tirunelveli,142,7,28,0,121,14273,7,420,0,14700,14370,209
23-11-2020,tiruppur,635,67,79,0,623,14825,67,11,0,14903,14073,207
23-11-2020,trichy,134,24,30,0,128,13198,24,18,0,13240,12940,172
23-11-2020,vellore,219,44,53,1,209,18834,44,218,0,19096,18559,328
23-11-2020,villupuram,133,29,17,0,145,14287,29,174,0,14490,14235,110
23-11-2020,virudhunagar,80,10,17,0,73,15678,10,104,0,15792,15494,225
23-11-2020,airport surveillance (international),2,1,0,0,3,0,0,925,1,926,922,1
23-11-2020,airport surveillance (domestic),11,4,0,0,15,0,0,993,4,997,981,1
23-11-2020,railway surveillance,0,0,0,0,0,0,0,428,0,428,428,0
24-11-2020,ariyalur,24,2,3,0,23,4515,2,20,0,4537,4466,48
24-11-2020,chengalpattu,882,90,124,2,846,46977,90,5,0,47072,45518,708
24-11-2020,chennai,4351,469,514,7,4299,212466,469,35,0,212970,204842,3829
24-11-2020,coimbatore,699,146,135,2,708,47629,146,48,0,47823,46514,601
24-11-2020,cuddalore,136,35,62,0,109,23843,35,202,0,24080,23696,275
24-11-2020,dharmapuri,132,12,13,0,131,5761,12,214,0,5987,5806,50
24-11-2020,dindigul,68,11,16,0,63,10060,11,77,0,10148,9892,193
24-11-2020,erode,302,49,59,0,292,11906,49,94,0,12049,11618,139
24-11-2020,kallakurichi,84,1,13,0,72,10214,1,404,0,10619,10441,106
24-11-2020,kancheepuram,379,73,85,0,367,27299,73,3,0,27375,26589,419
24-11-2020,kanyakumari,133,24,36,0,121,15444,24,109,0,15577,15205,251
24-11-2020,karur,247,15,49,0,213,4672,15,46,0,4733,4473,47
24-11-2020,krishnagiri,241,20,46,0,215,7105,20,165,0,7290,6963,112
24-11-2020,madurai,244,33,42,0,235,19379,33,153,0,19565,18893,437
24-11-2020,nagapattinam,283,26,30,0,279,7392,26,88,0,7506,7104,123
24-11-2020,namakkal,256,38,45,1,248,10088,38,99,0,10225,9875,102
24-11-2020,nilgiris,144,27,22,0,149,7247,27,19,0,7293,7104,40
24-11-2020,perambalur,1,0,0,0,1,2231,0,2,0,2233,2211,21
24-11-2020,pudukottai,113,7,14,0,106,11014,7,33,0,11054,10794,154
24-11-2020,ramanathapuram,45,4,2,0,47,6046,4,133,0,6183,6005,131
24-11-2020,ranipet,123,13,23,0,113,15460,13,49,0,15522,15231,178
24-11-2020,salem,602,78,97,0,583,28921,78,419,0,29418,28401,434
24-11-2020,sivagangai,67,19,4,0,82,6161,19,68,0,6248,6040,126
24-11-2020,tenkasi,67,3,6,0,64,7959,3,49,0,8011,7792,155
24-11-2020,thanjavur,160,32,20,0,172,16202,32,22,0,16256,15857,227
24-11-2020,theni,26,14,23,0,17,16473,14,45,0,16532,16319,196
24-11-2020,thirupathur,53,16,33,0,36,7047,16,110,0,7173,7016,121
24-11-2020,thiruvallur,595,73,103,1,564,40420,73,8,0,40501,39287,650
24-11-2020,thiruvannamalai,167,13,27,1,152,18096,13,393,0,18502,18078,272
24-11-2020,thiruvarur,189,21,29,0,181,10297,21,37,0,10355,10071,103
24-11-2020,thoothukudi,115,14,16,0,113,15305,14,269,0,15588,15340,135
24-11-2020,tirunelveli,122,26,20,0,128,14281,26,420,0,14727,14390,209
24-11-2020,tiruppur,624,58,72,0,610,14893,58,11,0,14962,14145,207
24-11-2020,trichy,129,28,25,1,131,13223,28,18,0,13269,12965,173
24-11-2020,vellore,210,31,52,2,187,18879,26,218,5,19128,18611,330
24-11-2020,villupuram,141,27,35,0,133,14312,27,174,0,14513,14270,110
24-11-2020,virudhunagar,73,8,15,0,66,15688,8,104,0,15800,15509,225
24-11-2020,airport surveillance (international),3,0,0,0,3,0,0,926,0,926,922,1
24-11-2020,airport surveillance (domestic),15,1,0,0,16,0,0,997,1,998,981,1
24-11-2020,railway surveillance,0,0,0,0,0,0,0,428,0,428,428,0
25-11-2020,ariyalur,23,4,8,0,19,4517,4,20,0,4541,4474,48
25-11-2020,chengalpattu,878,76,141,1,812,47099,76,5,0,47180,45659,709
25-11-2020,chennai,4279,467,536,4,4206,212915,467,35,0,213417,205378,3833
25-11-2020,coimbatore,711,149,179,2,679,47778,149,48,0,47975,46693,603
25-11-2020,cuddalore,110,31,34,0,107,23879,31,202,0,24112,23730,275
25-11-2020,dharmapuri,131,19,11,0,139,5773,19,214,0,6006,5817,50
25-11-2020,dindigul,62,11,13,0,60,10070,11,77,0,10158,9905,193
25-11-2020,erode,294,72,67,0,299,11957,72,94,0,12123,11685,139
25-11-2020,kallakurichi,72,5,12,0,65,10215,5,404,0,10624,10453,106
25-11-2020,kancheepuram,343,63,92,3,311,27348,63,3,0,27414,26681,422
25-11-2020,kanyakumari,121,24,22,0,123,15468,24,109,0,15601,15227,251
25-11-2020,karur,213,10,23,0,200,4687,10,46,0,4743,4496,47
25-11-2020,krishnagiri,216,19,22,0,213,7126,19,165,0,7310,6985,112
25-11-2020,madurai,233,24,40,0,217,19410,24,153,0,19587,18933,437
25-11-2020,nagapattinam,282,25,21,0,286,7421,25,88,0,7534,7125,123
25-11-2020,namakkal,246,27,45,0,228,10124,27,99,0,10250,9920,102
25-11-2020,nilgiris,147,16,24,0,139,7272,16,19,0,7307,7128,40
25-11-2020,perambalur,1,1,1,0,1,2231,1,2,0,2234,2212,21
25-11-2020,pudukottai,105,10,12,0,103,11020,10,33,0,11063,10806,154
25-11-2020,ramanathapuram,48,2,5,0,45,6051,2,133,0,6186,6010,131
25-11-2020,ranipet,113,16,40,0,89,15473,16,49,0,15538,15271,178
25-11-2020,salem,586,61,89,0,558,29002,61,419,0,29482,28490,434
25-11-2020,sivagangai,82,10,7,0,85,6180,10,68,0,6258,6047,126
25-11-2020,tenkasi,64,11,2,0,73,7962,11,49,0,8022,7794,155
25-11-2020,thanjavur,173,15,36,1,151,16235,15,22,0,16272,15893,228
25-11-2020,theni,17,12,4,0,25,16487,12,45,0,16544,16323,196
25-11-2020,thirupathur,35,5,25,2,13,7062,5,110,0,7177,7041,123
25-11-2020,thiruvallur,566,89,96,0,559,40495,89,8,0,40592,39383,650
25-11-2020,thiruvannamalai,154,11,24,1,140,18111,11,393,0,18515,18102,273
25-11-2020,thiruvarur,181,24,22,0,183,10318,24,37,0,10379,10093,103
25-11-2020,thoothukudi,114,14,17,0,111,15320,14,269,0,15603,15357,135
25-11-2020,tirunelveli,127,22,20,0,129,14306,22,420,0,14748,14410,209
25-11-2020,tiruppur,612,77,73,0,616,14953,77,11,0,15041,14218,207
25-11-2020,trichy,132,31,28,0,135,13252,31,18,0,13301,12993,173
25-11-2020,vellore,187,44,48,1,182,18905,44,223,0,19172,18659,331
25-11-2020,villupuram,132,19,18,0,133,14338,19,174,0,14531,14288,110
25-11-2020,virudhunagar,66,18,15,1,68,15696,18,104,0,15818,15524,226
25-11-2020,airport surveillance (international),3,0,0,0,3,0,0,926,0,926,922,1
25-11-2020,airport surveillance (domestic),16,0,1,0,15,0,0,998,0,998,982,1
25-11-2020,railway surveillance,0,0,0,0,0,0,0,428,0,428,428,0
26-11-2020,ariyalur,19,3,4,0,18,4521,3,20,0,4544,4478,48
26-11-2020,chengalpattu,814,48,104,1,757,47178,48,5,0,47231,45763,711
26-11-2020,chennai,4195,396,566,5,4020,213370,396,35,0,213801,205944,3837
26-11-2020,coimbatore,679,158,156,2,679,47927,158,48,0,48133,46849,605
26-11-2020,cuddalore,108,11,39,0,80,23911,11,202,0,24124,23769,275
26-11-2020,dharmapuri,139,12,14,0,137,5792,12,214,0,6018,5831,50
26-11-2020,dindigul,61,42,13,0,90,10082,42,77,0,10201,9918,193
26-11-2020,erode,294,84,46,0,332,12024,84,94,0,12202,11731,139
26-11-2020,kallakurichi,65,8,7,0,66,10220,8,404,0,10632,10460,106
26-11-2020,kancheepuram,316,43,76,1,282,27416,43,3,0,27462,26757,423
26-11-2020,kanyakumari,115,19,21,0,113,15484,19,109,0,15612,15248,251
26-11-2020,karur,205,12,20,0,197,4702,12,46,0,4760,4516,47
26-11-2020,krishnagiri,213,22,35,0,200,7145,22,165,0,7332,7020,112
26-11-2020,madurai,212,33,24,1,220,19429,33,153,0,19615,18957,438
26-11-2020,nagapattinam,286,3,26,1,262,7446,3,88,0,7537,7151,124
26-11-2020,namakkal,228,33,43,0,218,10151,33,99,0,10283,9963,102
26-11-2020,nilgiris,137,34,11,1,159,7286,34,19,0,7339,7139,41
26-11-2020,perambalur,1,1,0,0,2,2232,1,2,0,2235,2212,21
26-11-2020,pudukottai,106,12,12,0,106,11033,12,33,0,11078,10818,154
26-11-2020,ramanathapuram,46,1,4,0,43,6054,1,133,0,6188,6014,131
26-11-2020,ranipet,88,18,31,0,75,15489,18,49,0,15556,15302,179
26-11-2020,salem,554,93,68,1,578,29060,93,419,0,29572,28558,436
26-11-2020,sivagangai,84,11,11,0,84,6189,11,68,0,6268,6058,126
26-11-2020,tenkasi,74,10,2,0,82,7974,10,49,0,8033,7796,155
26-11-2020,thanjavur,152,22,36,0,138,16251,22,22,0,16295,15929,228
26-11-2020,theni,25,13,7,0,31,16499,13,45,0,16557,16330,196
26-11-2020,thirupathur,16,8,23,0,1,7070,8,110,0,7188,7064,123
26-11-2020,thiruvallur,568,67,94,0,541,40593,67,8,0,40668,39477,650
26-11-2020,thiruvannamalai,141,43,49,1,134,18123,43,393,0,18559,18151,274
26-11-2020,thiruvarur,184,7,28,0,163,10343,7,37,0,10387,10121,103
26-11-2020,thoothukudi,112,18,12,0,118,15335,14,269,4,15622,15369,135
26-11-2020,tirunelveli,131,15,19,0,127,14330,15,420,0,14765,14429,209
26-11-2020,tiruppur,619,71,75,0,615,15033,71,11,0,15115,14293,207
26-11-2020,trichy,132,27,23,0,136,13279,25,18,2,13324,13016,172
26-11-2020,vellore,180,32,50,0,162,18946,32,223,0,19201,18709,330
26-11-2020,villupuram,134,11,23,0,122,14358,11,174,0,14543,14311,110
26-11-2020,virudhunagar,69,22,25,0,66,15715,22,104,0,15841,15549,226
26-11-2020,airport surveillance (international),3,0,0,0,3,0,0,926,0,926,922,1
26-11-2020,airport surveillance (domestic),15,1,0,0,16,0,0,998,1,999,982,1
26-11-2020,railway surveillance,0,0,0,0,0,0,0,428,0,428,428,0
27-11-2020,ariyalur,18,10,6,0,22,4524,10,20,0,4554,4484,48
27-11-2020,chengalpattu,749,77,131,0,695,47219,77,5,0,47301,45894,712
27-11-2020,chennai,4019,392,485,2,3924,213764,392,35,0,214191,206429,3838
27-11-2020,coimbatore,680,145,82,2,741,48086,145,48,0,48279,46931,607
27-11-2020,cuddalore,80,32,22,0,90,23922,32,202,0,24156,23791,275
27-11-2020,dharmapuri,138,16,11,0,143,5805,16,214,0,6035,5842,50
27-11-2020,dindigul,89,29,17,1,100,10123,29,77,0,10229,9935,194
27-11-2020,erode,331,55,27,0,359,12107,55,94,0,12256,11758,139
27-11-2020,kallakurichi,68,9,12,0,65,10230,9,404,0,10643,10472,106
27-11-2020,kancheepuram,282,48,53,0,277,27459,48,3,0,27510,26810,423
27-11-2020,kanyakumari,116,31,13,0,134,15506,31,109,0,15646,15261,251
27-11-2020,karur,197,13,20,0,190,4714,13,46,0,4773,4536,47
27-11-2020,krishnagiri,202,13,14,0,201,7169,13,165,0,7347,7034,112
27-11-2020,madurai,222,20,18,0,224,19464,19,153,1,19637,18975,438
27-11-2020,nagapattinam,263,23,30,0,256,7450,23,88,0,7561,7181,124
27-11-2020,namakkal,219,36,47,0,208,10185,36,99,0,10320,10010,102
27-11-2020,nilgiris,159,11,15,0,155,7320,11,19,0,7350,7154,41
27-11-2020,perambalur,2,1,0,0,3,2233,1,2,0,2236,2212,21
27-11-2020,pudukottai,105,9,16,0,98,11044,9,33,0,11086,10834,154
27-11-2020,ramanathapuram,42,10,8,0,44,6054,10,133,0,6197,6022,131
27-11-2020,ranipet,78,11,6,0,83,15510,11,49,0,15570,15308,179
27-11-2020,salem,578,76,87,1,566,29153,76,419,0,29648,28645,437
27-11-2020,sivagangai,84,12,8,0,88,6200,12,68,0,6280,6066,126
27-11-2020,tenkasi,82,11,6,0,87,7984,11,49,0,8044,7802,155
27-11-2020,thanjavur,138,25,23,1,139,16273,25,22,0,16320,15952,229
27-11-2020,theni,31,9,14,0,26,16512,9,45,0,16566,16344,196
27-11-2020,thirupathur,3,17,2,0,18,7080,17,110,0,7207,7066,123
27-11-2020,thiruvallur,544,59,80,1,522,40663,59,8,0,40730,39557,651
27-11-2020,thiruvannamalai,135,9,33,1,110,18167,9,393,0,18569,18184,275
27-11-2020,thiruvarur,162,16,24,0,154,10349,16,37,0,10402,10145,103
27-11-2020,thoothukudi,117,12,7,0,122,15348,12,273,0,15633,15376,135
27-11-2020,tirunelveli,129,30,18,1,140,14347,30,420,0,14797,14447,210
27-11-2020,tiruppur,612,60,68,1,603,15101,60,11,0,15172,14361,208
27-11-2020,trichy,137,28,16,0,149,13305,25,20,3,13353,13032,172
27-11-2020,vellore,158,47,47,1,157,18974,44,223,3,19244,18756,331
27-11-2020,villupuram,119,25,26,0,118,14366,25,174,0,14565,14337,110
27-11-2020,virudhunagar,66,15,2,0,79,15737,15,104,0,15856,15551,226
27-11-2020,airport surveillance (international),3,0,0,0,3,0,0,926,0,926,922,1
27-11-2020,airport surveillance (domestic),16,0,0,0,16,0,0,999,0,999,982,1
27-11-2020,railway surveillance,0,0,0,0,0,0,0,428,0,428,428,0
28-11-2020,ariyalur,20,8,1,0,27,4532,8,20,0,4560,4485,48
28-11-2020,chengalpattu,705,78,125,0,658,47306,78,5,0,47389,46019,712
28-11-2020,chennai,3917,393,468,5,3837,214149,393,35,0,214577,206897,3843
28-11-2020,coimbatore,741,142,60,4,819,48231,142,48,0,48421,46991,611
28-11-2020,cuddalore,90,18,21,0,87,23954,18,202,0,24174,23812,275
28-11-2020,dharmapuri,142,14,19,0,137,5820,14,214,0,6048,5861,50
28-11-2020,dindigul,100,23,8,0,115,10152,23,77,0,10252,9943,194
28-11-2020,erode,357,44,34,0,367,12160,44,94,0,12298,11792,139
28-11-2020,kallakurichi,65,14,4,0,75,10239,14,404,0,10657,10476,106
28-11-2020,kancheepuram,266,70,54,0,282,27496,70,3,0,27569,26864,423
28-11-2020,kanyakumari,134,29,23,0,140,15537,29,109,0,15675,15284,251
28-11-2020,karur,191,11,20,0,182,4728,11,46,0,4785,4556,47
28-11-2020,krishnagiri,201,11,36,0,176,7182,11,165,0,7358,7070,112
28-11-2020,madurai,222,29,19,0,232,19481,29,154,0,19664,18994,438
28-11-2020,nagapattinam,256,31,35,0,252,7473,31,88,0,7592,7216,124
28-11-2020,namakkal,208,38,23,0,223,10221,38,99,0,10358,10033,102
28-11-2020,nilgiris,155,7,4,0,158,7331,7,19,0,7357,7158,41
28-11-2020,perambalur,4,1,0,0,5,2235,1,2,0,2238,2212,21
28-11-2020,pudukottai,98,12,19,0,91,11053,12,33,0,11098,10853,154
28-11-2020,ramanathapuram,44,3,6,0,41,6064,3,133,0,6200,6028,131
28-11-2020,ranipet,83,6,35,0,54,15521,6,49,0,15576,15343,179
28-11-2020,salem,569,67,63,1,572,29232,67,419,0,29718,28708,438
28-11-2020,sivagangai,88,10,13,0,85,6212,10,68,0,6290,6079,126
28-11-2020,tenkasi,90,9,6,0,93,7998,9,49,0,8056,7808,155
28-11-2020,thanjavur,141,31,16,0,156,16300,31,22,0,16353,15968,229
28-11-2020,theni,27,10,13,1,23,16522,10,45,0,16577,16357,197
28-11-2020,thirupathur,21,8,2,0,27,7100,8,110,0,7218,7068,123
28-11-2020,thiruvallur,524,80,91,0,513,40724,80,8,0,40812,39648,651
28-11-2020,thiruvannamalai,110,17,11,0,116,18176,17,393,0,18586,18195,275
28-11-2020,thiruvarur,156,23,24,1,154,10367,23,37,0,10427,10169,104
28-11-2020,thoothukudi,122,19,10,1,130,15360,19,273,0,15652,15386,136
28-11-2020,tirunelveli,137,15,23,0,129,14374,15,420,0,14809,14470,210
28-11-2020,tiruppur,604,65,95,0,574,15162,65,11,0,15238,14456,208
28-11-2020,trichy,148,22,21,0,149,13329,22,23,0,13374,13053,172
28-11-2020,vellore,157,34,26,0,165,19018,32,226,2,19278,18782,331
28-11-2020,villupuram,118,21,16,0,123,14391,21,174,0,14586,14353,110
28-11-2020,virudhunagar,79,17,9,0,87,15752,17,104,0,15873,15560,226
28-11-2020,airport surveillance (international),3,0,0,0,3,0,0,926,0,926,922,1
28-11-2020,airport surveillance (domestic),16,0,0,0,16,0,0,999,0,999,982,1
28-11-2020,railway surveillance,0,0,0,0,0,0,0,428,0,428,428,0
29-11-2020,ariyalur,27,2,2,0,27,4540,2,20,0,4562,4487,48
29-11-2020,chengalpattu,660,80,138,1,601,47386,80,5,0,47471,46157,713
29-11-2020,chennai,3838,398,478,4,3754,214543,398,35,0,214976,207375,3847
29-11-2020,coimbatore,822,148,50,1,919,48376,148,48,0,48572,47041,612
29-11-2020,cuddalore,87,26,12,0,101,23972,26,202,0,24200,23824,275
29-11-2020,dharmapuri,136,10,14,0,132,5833,10,214,0,6057,5875,50
29-11-2020,dindigul,114,26,5,0,135,10174,26,77,0,10277,9948,194
29-11-2020,erode,365,70,55,0,380,12202,70,94,0,12366,11847,139
29-11-2020,kallakurichi,74,7,14,0,67,10252,7,404,0,10663,10490,106
29-11-2020,kancheepuram,283,58,77,0,264,27567,58,3,0,27628,26941,423
29-11-2020,kanyakumari,139,16,14,1,140,15565,16,109,0,15690,15298,252
29-11-2020,karur,183,15,9,0,189,4740,15,46,0,4801,4565,47
29-11-2020,krishnagiri,177,6,15,0,168,7194,6,165,0,7365,7085,112
29-11-2020,madurai,232,27,16,1,242,19510,27,154,0,19691,19010,439
29-11-2020,nagapattinam,252,24,30,0,246,7504,24,88,0,7616,7246,124
29-11-2020,namakkal,223,28,37,0,214,10259,28,99,0,10386,10070,102
29-11-2020,nilgiris,156,37,11,0,182,7336,37,19,0,7392,7169,41
29-11-2020,perambalur,6,0,1,0,5,2237,0,2,0,2239,2213,21
29-11-2020,pudukottai,91,16,10,0,97,11065,16,33,0,11114,10863,154
29-11-2020,ramanathapuram,41,4,5,0,40,6067,4,133,0,6204,6033,131
29-11-2020,ranipet,54,11,6,0,59,15527,11,49,0,15587,15349,179
29-11-2020,salem,572,78,92,1,557,29299,78,419,0,29796,28800,439
29-11-2020,sivagangai,84,12,10,0,86,6221,12,68,0,6301,6089,126
29-11-2020,tenkasi,96,14,5,0,105,8010,14,49,0,8073,7813,155
29-11-2020,thanjavur,156,32,29,0,159,16331,32,22,0,16385,15997,229
29-11-2020,theni,23,4,10,0,17,16532,4,45,0,16581,16367,197
29-11-2020,thirupathur,28,12,5,0,35,7109,12,110,0,7231,7073,123
29-11-2020,thiruvallur,509,88,80,0,517,40800,88,8,0,40896,39728,651
29-11-2020,thiruvannamalai,116,9,19,0,106,18193,9,393,0,18595,18214,275
29-11-2020,thiruvarur,152,10,26,0,136,10388,10,37,0,10435,10195,104
29-11-2020,thoothukudi,130,15,12,0,133,15379,15,273,0,15667,15398,136
29-11-2020,tirunelveli,129,8,9,0,128,14389,8,420,0,14817,14479,210
29-11-2020,tiruppur,575,79,79,0,575,15228,79,11,0,15318,14535,208
29-11-2020,trichy,149,21,17,0,153,13351,18,23,3,13395,13070,172
29-11-2020,vellore,164,40,47,0,157,19049,34,228,6,19317,18829,331
29-11-2020,villupuram,124,19,20,0,123,14413,19,174,0,14606,14373,110
29-11-2020,virudhunagar,87,9,12,0,84,15769,9,104,0,15882,15572,226
29-11-2020,airport surveillance (international),3,0,0,0,3,0,0,926,0,926,922,1
29-11-2020,airport surveillance (domestic),16,0,0,0,16,0,0,999,0,999,982,1
29-11-2020,railway surveillance,0,0,0,0,0,0,0,428,0,428,428,0
01-12-2020,ariyalur,24,5,3,0,26,4542,5,20,0,4567,4493,48
01-12-2020,chengalpattu,585,86,117,2,552,47584,86,5,0,47675,46408,715
01-12-2020,chennai,3748,380,422,4,3702,215324,380,35,0,215739,208183,3854
01-12-2020,coimbatore,939,141,145,0,935,48677,141,48,0,48866,47318,613
01-12-2020,cuddalore,93,15,27,0,81,24022,15,202,0,24239,23883,275
01-12-2020,dharmapuri,122,22,14,0,130,5852,22,214,0,6088,5908,50
01-12-2020,dindigul,151,24,4,0,171,10233,24,77,0,10334,9969,194
01-12-2020,erode,392,38,29,0,401,12331,38,94,0,12463,11923,139
01-12-2020,kallakurichi,57,0,10,0,47,10265,0,404,0,10669,10515,107
01-12-2020,kancheepuram,256,63,38,0,281,27654,63,3,0,27720,27016,423
01-12-2020,kanyakumari,138,8,18,0,128,15605,8,109,0,15722,15342,252
01-12-2020,karur,183,13,21,0,175,4774,13,46,0,4833,4611,47
01-12-2020,krishnagiri,165,24,20,0,169,7210,24,165,0,7399,7118,112
01-12-2020,madurai,243,25,32,1,235,19569,25,154,0,19748,19073,440
01-12-2020,nagapattinam,229,12,27,0,214,7553,12,88,0,7653,7315,124
01-12-2020,namakkal,222,29,22,0,229,10317,29,99,0,10445,10114,102
01-12-2020,nilgiris,174,18,19,0,173,7404,17,19,1,7441,7226,42
01-12-2020,perambalur,2,3,0,0,5,2237,3,2,0,2242,2216,21
01-12-2020,pudukottai,94,8,14,0,88,11090,8,33,0,11131,10889,154
01-12-2020,ramanathapuram,41,4,6,0,39,6077,4,133,0,6214,6044,131
01-12-2020,ranipet,67,18,3,0,82,15554,18,49,0,15621,15360,179
01-12-2020,salem,518,56,95,2,477,29435,56,419,0,29910,28992,441
01-12-2020,sivagangai,85,10,13,0,82,6244,10,68,0,6322,6114,126
01-12-2020,tenkasi,99,5,10,0,94,8028,5,49,0,8082,7833,155
01-12-2020,thanjavur,173,39,23,0,189,16398,39,22,0,16459,16041,229
01-12-2020,theni,20,5,5,0,20,16544,5,45,0,16594,16377,197
01-12-2020,thirupathur,44,15,2,0,57,7133,15,110,0,7258,7078,123
01-12-2020,thiruvallur,500,63,79,0,484,40946,63,8,0,41017,39879,654
01-12-2020,thiruvannamalai,109,47,20,0,136,18214,47,393,0,18654,18243,275
01-12-2020,thiruvarur,134,26,19,0,141,10411,26,37,0,10474,10229,104
01-12-2020,thoothukudi,122,9,10,0,121,15406,9,273,0,15688,15431,136
01-12-2020,tirunelveli,126,28,14,0,140,14407,28,420,0,14855,14505,210
01-12-2020,tiruppur,567,65,83,1,548,15381,65,11,0,15457,14700,209
01-12-2020,trichy,158,24,17,0,165,13393,24,26,0,13443,13106,172
01-12-2020,vellore,178,43,3,0,218,19118,40,235,3,19396,18847,331
01-12-2020,villupuram,132,12,21,0,123,14449,12,174,0,14635,14403,109
01-12-2020,virudhunagar,88,20,2,0,106,15788,20,104,0,15912,15579,227
01-12-2020,airport surveillance (international),3,0,0,0,3,0,0,926,0,926,922,1
01-12-2020,airport surveillance (domestic),16,1,4,0,13,0,0,999,1,1000,986,1
01-12-2020,railway surveillance,0,0,0,0,0,0,0,428,0,428,428,0
02-12-2020,ariyalur,25,4,3,0,26,4546,4,20,0,4570,4496,48
02-12-2020,chengalpattu,584,83,101,2,564,47702,83,5,0,47790,46509,717
02-12-2020,chennai,3685,397,495,3,3584,215687,397,35,0,216119,208678,3857
02-12-2020,coimbatore,937,142,77,1,1001,48820,141,48,1,49010,47395,614
02-12-2020,cuddalore,81,21,20,0,82,24037,21,202,0,24260,23903,275
02-12-2020,dharmapuri,128,16,12,1,131,5872,16,214,0,6102,5920,51
02-12-2020,dindigul,169,31,5,0,195,10255,31,77,0,10363,9974,194
02-12-2020,erode,397,47,31,0,413,12365,47,94,0,12506,11954,139
02-12-2020,kallakurichi,47,12,6,0,53,10265,12,404,0,10681,10521,107
02-12-2020,kancheepuram,258,61,46,0,273,27694,61,3,0,27758,27062,423
02-12-2020,kanyakumari,127,9,11,0,125,15612,9,109,0,15730,15353,252
02-12-2020,karur,174,14,20,0,168,4786,14,46,0,4846,4631,47
02-12-2020,krishnagiri,171,17,26,0,162,7236,17,165,0,7418,7144,112
02-12-2020,madurai,234,22,30,0,226,19593,21,154,1,19769,19103,440
02-12-2020,nagapattinam,214,16,38,0,192,7565,16,88,0,7669,7353,124
02-12-2020,namakkal,231,31,30,1,231,10348,31,99,0,10478,10144,103
02-12-2020,nilgiris,173,25,22,0,176,7421,25,20,0,7466,7248,42
02-12-2020,perambalur,5,2,2,0,5,2240,2,2,0,2244,2218,21
02-12-2020,pudukottai,89,14,10,0,93,11099,14,33,0,11146,10899,154
02-12-2020,ramanathapuram,39,5,5,0,39,6081,5,133,0,6219,6049,131
02-12-2020,ranipet,82,19,34,0,67,15572,19,49,0,15640,15394,179
02-12-2020,salem,474,99,60,2,511,29488,99,419,0,30006,29052,443
02-12-2020,sivagangai,82,7,11,0,78,6254,7,68,0,6329,6125,126
02-12-2020,tenkasi,94,9,5,0,98,8033,9,49,0,8091,7838,155
02-12-2020,thanjavur,191,27,16,0,202,16439,27,22,0,16488,16057,229
02-12-2020,theni,21,9,3,0,27,16550,9,45,0,16604,16380,197
02-12-2020,thirupathur,60,9,3,0,66,7151,9,110,0,7270,7081,123
02-12-2020,thiruvallur,486,65,79,0,472,41011,65,8,0,41084,39958,654
02-12-2020,thiruvannamalai,138,24,15,0,147,18263,24,393,0,18680,18258,275
02-12-2020,thiruvarur,143,15,19,0,139,10439,15,37,0,10491,10248,104
02-12-2020,thoothukudi,123,17,12,0,128,15417,17,273,0,15707,15443,136
02-12-2020,tirunelveli,139,26,12,0,153,14434,26,420,0,14880,14517,210
02-12-2020,tiruppur,551,55,87,1,518,15449,55,11,0,15515,14787,210
02-12-2020,trichy,168,26,17,0,177,13420,25,26,1,13472,13123,172
02-12-2020,vellore,215,27,14,0,228,19155,24,238,3,19420,18861,331
02-12-2020,villupuram,123,8,13,0,118,14461,8,174,0,14643,14416,109
02-12-2020,virudhunagar,106,16,7,0,115,15808,16,104,0,15928,15586,227
02-12-2020,airport surveillance (international),3,1,0,0,4,0,0,926,1,927,922,1
02-12-2020,airport surveillance (domestic),13,0,1,0,12,0,0,1000,0,1000,987,1
02-12-2020,railway surveillance,0,0,0,0,0,0,0,428,0,428,428,0
03-12-2020,ariyalur,25,5,1,0,29,4549,5,20,0,4574,4497,48
03-12-2020,chengalpattu,585,77,131,2,529,47806,77,5,0,47888,46640,719
03-12-2020,chennai,3579,382,419,6,3536,216079,382,35,0,216496,209097,3863
03-12-2020,coimbatore,1002,140,206,1,935,48962,138,49,2,49151,47601,615
03-12-2020,cuddalore,83,24,22,0,85,24059,24,202,0,24285,23925,275
03-12-2020,dharmapuri,130,9,15,0,124,5887,9,214,0,6110,5935,51
03-12-2020,dindigul,195,15,12,0,198,10286,15,77,0,10378,9986,194
03-12-2020,erode,413,48,26,1,434,12412,48,94,0,12554,11980,140
03-12-2020,kallakurichi,52,3,5,0,50,10276,3,404,0,10683,10526,107
03-12-2020,kancheepuram,252,53,20,0,285,27734,53,3,0,27790,27082,423
03-12-2020,kanyakumari,125,30,12,0,143,15621,30,109,0,15760,15365,252
03-12-2020,karur,167,12,20,1,158,4799,12,46,0,4857,4651,48
03-12-2020,krishnagiri,162,15,24,0,153,7253,15,165,0,7433,7168,112
03-12-2020,madurai,224,32,31,0,225,19612,32,155,0,19799,19134,440
03-12-2020,nagapattinam,192,22,27,0,187,7581,22,88,0,7691,7380,124
03-12-2020,namakkal,232,27,29,0,230,10380,27,99,0,10506,10173,103
03-12-2020,nilgiris,175,25,20,0,180,7445,25,20,0,7490,7268,42
03-12-2020,perambalur,5,0,1,0,4,2242,0,2,0,2244,2219,21
03-12-2020,pudukottai,93,10,15,0,88,11113,10,33,0,11156,10914,154
03-12-2020,ramanathapuram,39,1,3,0,37,6086,1,133,0,6220,6052,131
03-12-2020,ranipet,67,6,13,0,60,15591,6,49,0,15646,15407,179
03-12-2020,salem,512,88,77,1,522,29588,88,419,0,30095,29129,444
03-12-2020,sivagangai,78,16,14,0,80,6261,16,68,0,6345,6139,126
03-12-2020,tenkasi,99,11,9,0,101,8043,11,49,0,8103,7847,155
03-12-2020,thanjavur,202,32,21,0,213,16466,32,22,0,16520,16078,229
03-12-2020,theni,28,14,4,0,38,16560,14,45,0,16619,16384,197
03-12-2020,thirupathur,67,8,2,1,72,7161,8,110,0,7279,7083,124
03-12-2020,thiruvallur,471,81,44,0,508,41075,81,8,0,41164,40002,654
03-12-2020,thiruvannamalai,151,22,17,0,156,18291,22,393,0,18706,18275,275
03-12-2020,thiruvarur,138,19,20,1,136,10453,19,37,0,10509,10268,105
03-12-2020,thoothukudi,129,19,14,0,134,15435,19,273,0,15727,15457,136
03-12-2020,tirunelveli,153,21,17,0,157,14460,21,420,0,14901,14534,210
03-12-2020,tiruppur,518,63,61,0,520,15504,63,11,0,15578,14848,210
03-12-2020,trichy,178,27,23,0,182,13446,26,27,1,13500,13146,172
03-12-2020,vellore,228,31,10,0,249,19179,30,241,1,19451,18871,331
03-12-2020,villupuram,119,10,20,0,109,14470,10,174,0,14654,14436,109
03-12-2020,virudhunagar,115,14,8,0,121,15824,14,104,0,15942,15594,227
03-12-2020,airport surveillance (international),4,0,0,0,4,0,0,927,0,927,922,1
03-12-2020,airport surveillance (domestic),12,4,0,0,16,0,0,1000,4,1004,987,1
03-12-2020,railway surveillance,0,0,0,0,0,0,0,428,0,428,428,0
05-12-2020,ariyalur,31,4,4,0,31,4558,4,20,0,4582,4503,48
05-12-2020,chengalpattu,562,88,84,2,564,47996,88,5,0,48089,46802,723
05-12-2020,chennai,3435,353,448,4,3336,216816,353,35,0,217204,209997,3871
05-12-2020,coimbatore,965,137,169,1,932,49242,137,51,0,49430,47881,617
05-12-2020,cuddalore,86,15,20,0,81,24102,15,202,0,24319,23963,275
05-12-2020,dharmapuri,127,20,16,0,131,5909,20,214,0,6143,5961,51
05-12-2020,dindigul,201,22,24,1,198,10329,22,77,0,10428,10035,195
05-12-2020,erode,438,46,65,0,419,12511,46,94,0,12651,12090,142
05-12-2020,kallakurichi,53,8,7,0,54,10283,8,404,0,10695,10534,107
05-12-2020,kancheepuram,246,44,21,1,268,27797,44,3,0,27844,27150,426
05-12-2020,kanyakumari,147,27,14,0,160,15674,27,109,0,15810,15398,252
05-12-2020,karur,138,19,12,0,145,4826,19,46,0,4891,4698,48
05-12-2020,krishnagiri,164,15,16,0,163,7297,15,165,0,7477,7202,112
05-12-2020,madurai,232,24,25,1,230,19677,24,155,0,19856,19185,441
05-12-2020,nagapattinam,188,16,28,0,176,7622,16,88,0,7726,7426,124
05-12-2020,namakkal,220,30,22,0,228,10425,30,100,0,10555,10224,103
05-12-2020,nilgiris,198,27,19,0,206,7513,27,20,0,7560,7312,42
05-12-2020,perambalur,6,0,1,0,5,2244,0,2,0,2246,2220,21
05-12-2020,pudukottai,87,9,6,0,90,11136,9,33,0,11178,10934,154
05-12-2020,ramanathapuram,35,3,4,0,34,6089,3,133,0,6225,6060,131
05-12-2020,ranipet,62,12,12,0,62,15610,12,49,0,15671,15430,179
05-12-2020,salem,511,97,73,0,535,29747,97,419,0,30263,29284,444
05-12-2020,sivagangai,72,3,8,0,67,6283,3,68,0,6354,6161,126
05-12-2020,tenkasi,102,10,13,0,99,8066,10,49,0,8125,7871,155
05-12-2020,thanjavur,209,22,24,0,207,16523,22,22,0,16567,16131,229
05-12-2020,theni,42,12,7,0,47,16588,12,45,0,16645,16401,197
05-12-2020,thirupathur,72,9,7,0,74,7178,9,110,0,7297,7099,124
05-12-2020,thiruvallur,497,67,63,2,499,41212,67,8,0,41287,40130,658
05-12-2020,thiruvannamalai,166,9,15,0,160,18352,9,393,0,18754,18318,276
05-12-2020,thiruvarur,115,25,19,0,121,10485,25,37,0,10547,10320,106
05-12-2020,thoothukudi,139,17,13,1,142,15464,17,273,0,15754,15475,137
05-12-2020,tirunelveli,172,12,17,0,167,14513,12,420,0,14945,14568,210
05-12-2020,tiruppur,525,66,60,1,530,15627,66,11,0,15704,14963,211
05-12-2020,trichy,181,32,27,0,186,13494,32,28,0,13554,13196,172
05-12-2020,vellore,268,37,15,0,290,19239,36,245,1,19521,18900,331
05-12-2020,villupuram,110,3,22,0,91,14501,3,174,0,14678,14478,109
05-12-2020,virudhunagar,117,25,7,1,134,15856,25,104,0,15985,15623,228
05-12-2020,airport surveillance (international),4,0,0,0,4,0,0,927,0,927,922,1
05-12-2020,airport surveillance (domestic),15,1,0,0,16,0,0,1004,1,1005,988,1
05-12-2020,railway surveillance,0,0,0,0,0,0,0,428,0,428,428,0
06-12-2020,ariyalur,32,3,3,0,32,4563,3,20,0,4586,4506,48
06-12-2020,chengalpattu,568,66,79,1,554,48088,66,5,0,48159,46881,724
06-12-2020,chennai,3328,346,413,4,3257,217161,346,35,0,217542,210410,3875
06-12-2020,coimbatore,933,139,171,2,899,49380,139,51,0,49570,48052,619
06-12-2020,cuddalore,80,24,10,2,92,24116,24,202,0,24342,23973,277
06-12-2020,dharmapuri,131,23,17,0,137,5929,23,214,0,6166,5978,51
06-12-2020,dindigul,198,24,24,0,198,10351,24,77,0,10452,10059,195
06-12-2020,erode,420,57,78,0,399,12558,57,94,0,12709,12168,142
06-12-2020,kallakurichi,54,7,7,0,54,10291,7,404,0,10702,10541,107
06-12-2020,kancheepuram,271,39,42,0,268,27844,39,3,0,27886,27192,426
06-12-2020,kanyakumari,157,21,17,1,160,15698,21,109,0,15828,15415,253
06-12-2020,karur,145,12,12,0,145,4845,12,46,0,4903,4710,48
06-12-2020,krishnagiri,162,24,18,0,168,7311,24,165,0,7500,7220,112
06-12-2020,madurai,227,18,26,0,219,19698,18,155,0,19871,19211,441
06-12-2020,nagapattinam,178,14,9,0,183,7640,14,88,0,7742,7435,124
06-12-2020,namakkal,226,28,31,1,222,10453,28,100,0,10581,10255,104
06-12-2020,nilgiris,207,17,14,0,210,7541,17,20,0,7578,7326,42
06-12-2020,perambalur,5,0,1,0,4,2244,0,2,0,2246,2221,21
06-12-2020,pudukottai,90,7,14,0,83,11145,7,33,0,11185,10948,154
06-12-2020,ramanathapuram,34,9,4,0,39,6092,9,133,0,6234,6064,131
06-12-2020,ranipet,62,13,3,0,72,15622,13,49,0,15684,15433,179
06-12-2020,salem,535,62,66,0,531,29844,62,419,0,30325,29350,444
06-12-2020,sivagangai,67,7,10,0,64,6286,7,68,0,6361,6171,126
06-12-2020,tenkasi,99,6,9,0,96,8076,6,49,0,8131,7880,155
06-12-2020,thanjavur,206,13,26,0,193,16544,13,22,0,16579,16157,229
06-12-2020,theni,47,13,10,0,50,16600,13,45,0,16658,16411,197
06-12-2020,thirupathur,74,6,4,0,76,7187,6,110,0,7303,7103,124
06-12-2020,thiruvallur,498,63,64,0,497,41278,63,8,0,41349,40194,658
06-12-2020,thiruvannamalai,160,15,23,0,152,18361,15,393,0,18769,18341,276
06-12-2020,thiruvarur,121,15,9,0,127,10510,15,37,0,10562,10329,106
06-12-2020,thoothukudi,142,15,16,2,139,15481,15,273,0,15769,15491,139
06-12-2020,tirunelveli,172,14,12,0,174,14530,14,420,0,14964,14580,210
06-12-2020,tiruppur,530,72,66,0,536,15693,72,11,0,15776,15029,211
06-12-2020,trichy,186,36,31,0,191,13526,35,28,1,13590,13227,172
06-12-2020,vellore,289,51,19,2,319,19274,47,246,4,19571,18919,333
06-12-2020,villupuram,92,22,21,1,92,14505,22,174,0,14701,14499,110
06-12-2020,virudhunagar,136,19,19,0,136,15883,19,104,0,16006,15642,228
06-12-2020,airport surveillance (international),4,0,0,0,4,0,0,927,0,927,922,1
06-12-2020,airport surveillance (domestic),16,0,0,0,16,0,0,1005,0,1005,988,1
06-12-2020,railway surveillance,0,0,0,0,0,0,0,428,0,428,428,0
07-12-2020,ariyalur,32,2,8,0,26,4566,2,20,0,4588,4514,48
07-12-2020,chengalpattu,569,87,65,0,591,48169,87,5,0,48261,46946,724
07-12-2020,chennai,3258,307,359,7,3199,217508,307,35,0,217850,210769,3882
07-12-2020,coimbatore,901,124,158,2,865,49521,124,51,0,49696,48210,621
07-12-2020,cuddalore,93,13,43,1,62,24141,13,202,0,24356,24016,278
07-12-2020,dharmapuri,135,11,15,0,131,5950,11,214,0,6175,5993,51
07-12-2020,dindigul,198,21,26,0,193,10375,21,77,0,10473,10085,195
07-12-2020,erode,395,56,63,0,388,12611,56,94,0,12761,12231,142
07-12-2020,kallakurichi,53,5,17,0,41,10297,5,404,0,10706,10558,107
07-12-2020,kancheepuram,254,40,42,1,251,27869,40,3,0,27912,27234,427
07-12-2020,kanyakumari,160,25,19,0,166,15719,25,109,0,15853,15434,253
07-12-2020,karur,144,9,18,0,135,4856,9,46,0,4911,4728,48
07-12-2020,krishnagiri,169,18,22,0,165,7336,18,165,0,7519,7242,112
07-12-2020,madurai,217,42,32,0,227,19714,42,155,0,19911,19243,441
07-12-2020,nagapattinam,183,19,17,1,184,7654,19,88,0,7761,7452,125
07-12-2020,namakkal,224,22,33,0,213,10483,22,100,0,10605,10288,104
07-12-2020,nilgiris,211,14,8,0,217,7559,14,20,0,7593,7334,42
07-12-2020,perambalur,5,0,1,0,4,2245,0,2,0,2247,2222,21
07-12-2020,pudukottai,84,16,15,0,85,11153,16,33,0,11202,10963,154
07-12-2020,ramanathapuram,40,6,7,0,39,6102,6,133,0,6241,6071,131
07-12-2020,ranipet,74,8,6,0,76,15637,8,49,0,15694,15439,179
07-12-2020,salem,533,72,79,0,526,29908,72,419,0,30399,29429,444
07-12-2020,sivagangai,64,6,5,0,65,6293,6,68,0,6367,6176,126
07-12-2020,tenkasi,95,7,9,0,93,8081,7,49,0,8137,7889,155
07-12-2020,thanjavur,192,36,25,0,203,16556,36,22,0,16614,16182,229
07-12-2020,theni,50,10,12,0,48,16613,10,45,0,16668,16423,197
07-12-2020,thirupathur,76,9,2,0,83,7193,9,110,0,7312,7105,124
07-12-2020,thiruvallur,497,69,63,4,499,41341,69,8,0,41418,40257,662
07-12-2020,thiruvannamalai,152,13,25,0,140,18376,13,393,0,18782,18366,276
07-12-2020,thiruvarur,127,12,9,0,130,10525,12,37,0,10574,10338,106
07-12-2020,thoothukudi,141,22,18,0,145,15498,22,273,0,15793,15509,139
07-12-2020,tirunelveli,172,15,11,0,176,14542,15,420,0,14977,14591,210
07-12-2020,tiruppur,536,75,71,0,540,15765,75,11,0,15851,15100,211
07-12-2020,trichy,189,41,33,0,197,13559,41,29,0,13629,13260,172
07-12-2020,vellore,317,46,19,0,344,19319,45,250,1,19615,18938,333
07-12-2020,villupuram,92,18,19,0,91,14527,18,174,0,14719,14518,110
07-12-2020,virudhunagar,136,16,10,0,142,15902,16,104,0,16022,15652,228
07-12-2020,airport surveillance (international),4,0,1,0,3,0,0,927,0,927,923,1
07-12-2020,airport surveillance (domestic),16,0,4,0,12,0,0,1005,0,1005,992,1
07-12-2020,railway surveillance,0,0,0,0,0,0,0,428,0,428,428,0
08-12-2020,ariyalur,27,3,6,0,24,4569,3,20,0,4592,4520,48
08-12-2020,chengalpattu,590,70,81,1,578,48255,70,5,0,48330,47027,725
08-12-2020,chennai,3214,333,292,3,3252,217830,333,35,0,218198,211061,3885
08-12-2020,coimbatore,867,122,112,1,876,49647,122,51,0,49820,48322,622
08-12-2020,cuddalore,63,15,9,0,69,24155,15,202,0,24372,24025,278
08-12-2020,dharmapuri,132,10,11,0,131,5962,10,214,0,6186,6004,51
08-12-2020,dindigul,193,15,23,0,185,10396,15,77,0,10488,10108,195
08-12-2020,erode,389,44,55,0,378,12668,44,94,0,12806,12286,142
08-12-2020,kallakurichi,41,7,15,1,32,10302,7,404,0,10713,10573,108
08-12-2020,kancheepuram,247,39,53,1,232,27905,39,3,0,27947,27287,428
08-12-2020,kanyakumari,166,24,32,0,158,15744,24,109,0,15877,15466,253
08-12-2020,karur,135,12,15,0,132,4865,12,46,0,4923,4743,48
08-12-2020,krishnagiri,166,20,22,1,163,7355,20,165,0,7540,7264,113
08-12-2020,madurai,224,26,33,1,216,19753,26,155,0,19934,19276,442
08-12-2020,nagapattinam,184,25,37,0,172,7673,25,88,0,7786,7489,125
08-12-2020,namakkal,220,23,46,0,197,10512,23,100,0,10635,10334,104
08-12-2020,nilgiris,217,12,16,0,213,7573,12,20,0,7605,7350,42
08-12-2020,perambalur,3,0,0,0,3,2244,0,2,0,2246,2222,21
08-12-2020,pudukottai,85,17,8,0,94,11169,17,33,0,11219,10971,154
08-12-2020,ramanathapuram,39,3,3,0,39,6108,3,133,0,6244,6074,131
08-12-2020,ranipet,76,6,8,0,74,15645,6,49,0,15700,15447,179
08-12-2020,salem,518,64,61,1,520,29972,64,419,0,30455,29490,445
08-12-2020,sivagangai,67,11,13,0,65,6301,11,68,0,6380,6189,126
08-12-2020,tenkasi,94,6,8,0,92,8089,6,49,0,8144,7897,155
08-12-2020,thanjavur,204,23,29,0,198,16593,23,22,0,16638,16211,229
08-12-2020,theni,48,7,5,0,50,16623,7,45,0,16675,16428,197
08-12-2020,thirupathur,83,8,6,0,85,7202,8,110,0,7320,7111,124
08-12-2020,thiruvallur,489,60,84,0,465,41400,60,8,0,41468,40341,662
08-12-2020,thiruvannamalai,141,19,15,0,145,18390,19,393,0,18802,18381,276
08-12-2020,thiruvarur,129,29,27,1,130,10536,29,37,0,10602,10365,107
08-12-2020,thoothukudi,146,12,22,0,136,15521,12,273,0,15806,15531,139
08-12-2020,tirunelveli,175,14,19,0,170,14556,14,420,0,14990,14610,210
08-12-2020,tiruppur,540,73,64,0,549,15840,73,11,0,15924,15164,211
08-12-2020,trichy,193,25,17,0,201,13596,25,29,0,13650,13277,172
08-12-2020,vellore,342,28,38,2,330,19362,28,251,0,19641,18976,335
08-12-2020,villupuram,90,16,23,0,83,14544,16,174,0,14734,14541,110
08-12-2020,virudhunagar,143,15,18,0,140,15919,15,104,0,16038,15670,228
08-12-2020,airport surveillance (international),3,0,0,0,3,0,0,927,0,927,923,1
08-12-2020,airport surveillance (domestic),12,0,4,0,8,0,0,1005,0,1005,996,1
08-12-2020,railway surveillance,0,0,0,0,0,0,0,428,0,428,428,0
09-12-2020,ariyalur,25,5,2,0,28,4573,5,20,0,4598,4522,48
09-12-2020,chengalpattu,584,78,95,1,566,48331,78,5,0,48414,47122,726
09-12-2020,chennai,3256,347,359,8,3236,218167,347,35,0,218549,211420,3893
09-12-2020,coimbatore,877,133,86,0,924,49770,133,51,0,49954,48408,622
09-12-2020,cuddalore,69,9,14,0,64,24170,9,202,0,24381,24039,278
09-12-2020,dharmapuri,131,8,9,0,130,5972,8,214,0,6194,6013,51
09-12-2020,dindigul,184,25,23,0,186,10410,25,77,0,10512,10131,195
09-12-2020,erode,380,37,55,0,362,12714,37,94,0,12845,12341,142
09-12-2020,kallakurichi,33,1,9,0,25,10310,1,404,0,10715,10582,108
09-12-2020,kancheepuram,222,48,43,0,227,27934,48,3,0,27985,27330,428
09-12-2020,kanyakumari,159,22,32,0,149,15769,22,109,0,15900,15498,253
09-12-2020,karur,134,15,16,0,133,4879,15,46,0,4940,4759,48
09-12-2020,krishnagiri,163,14,14,1,162,7375,14,165,0,7554,7278,114
09-12-2020,madurai,216,37,30,1,222,19779,37,155,0,19971,19306,443
09-12-2020,nagapattinam,172,21,33,0,160,7698,21,88,0,7807,7522,125
09-12-2020,namakkal,193,27,33,0,187,10531,25,100,2,10658,10367,104
09-12-2020,nilgiris,213,14,22,0,205,7585,14,20,0,7619,7372,42
09-12-2020,perambalur,3,1,0,0,4,2244,1,2,0,2247,2222,21
09-12-2020,pudukottai,95,9,14,0,90,11187,9,33,0,11229,10985,154
09-12-2020,ramanathapuram,39,2,8,0,33,6111,2,133,0,6246,6082,131
09-12-2020,ranipet,74,12,13,0,73,15651,12,49,0,15712,15460,179
09-12-2020,salem,520,72,65,1,526,30036,72,419,0,30527,29555,446
09-12-2020,sivagangai,65,6,11,0,60,6312,6,68,0,6386,6200,126
09-12-2020,tenkasi,93,2,6,0,89,8096,2,49,0,8147,7903,155
09-12-2020,thanjavur,198,21,43,0,176,16616,21,22,0,16659,16254,229
09-12-2020,theni,50,12,10,1,51,16630,12,45,0,16687,16438,198
09-12-2020,thirupathur,85,8,7,0,86,7210,8,110,0,7328,7118,124
09-12-2020,thiruvallur,464,50,74,1,439,41458,50,8,0,41516,40415,662
09-12-2020,thiruvannamalai,145,26,10,0,161,18409,26,393,0,18828,18391,276
09-12-2020,thiruvarur,130,18,21,0,127,10565,18,37,0,10620,10386,107
09-12-2020,thoothukudi,136,14,14,0,136,15533,14,273,0,15820,15545,139
09-12-2020,tirunelveli,167,15,13,0,169,14567,15,420,0,15002,14623,210
09-12-2020,tiruppur,549,48,50,0,547,15913,48,11,0,15972,15214,211
09-12-2020,trichy,201,17,25,0,193,13621,17,29,0,13667,13302,172
09-12-2020,vellore,330,32,26,0,336,19391,23,251,9,19674,19002,336
09-12-2020,villupuram,82,10,11,0,81,14559,10,174,0,14743,14552,110
09-12-2020,virudhunagar,140,12,15,0,137,15934,12,104,0,16050,15685,228
09-12-2020,airport surveillance (international),3,0,1,0,2,0,0,927,0,927,924,1
09-12-2020,airport surveillance (domestic),8,4,3,0,9,0,0,1005,4,1009,999,1
09-12-2020,railway surveillance,0,0,0,0,0,0,0,428,0,428,428,0
10-12-2020,ariyalur,29,6,6,0,29,4579,6,20,0,4605,4528,48
10-12-2020,chengalpattu,569,83,110,3,539,48412,83,5,0,48500,47232,729
10-12-2020,chennai,3230,313,296,5,3242,218508,313,35,0,218856,211716,3898
10-12-2020,coimbatore,926,124,92,4,954,49905,124,51,0,50080,48500,626
10-12-2020,cuddalore,64,11,18,0,57,24179,11,202,0,24392,24057,278
10-12-2020,dharmapuri,130,10,8,0,132,5980,10,214,0,6204,6021,51
10-12-2020,dindigul,186,16,34,0,168,10435,16,77,0,10528,10165,195
10-12-2020,erode,358,85,52,0,391,12747,85,94,0,12926,12393,142
10-12-2020,kallakurichi,25,3,6,0,22,10311,3,404,0,10718,10588,108
10-12-2020,kancheepuram,229,54,51,0,232,27984,54,3,0,28041,27381,428
10-12-2020,kanyakumari,148,31,29,0,150,15790,31,109,0,15930,15527,253
10-12-2020,karur,132,10,18,0,124,4893,10,46,0,4949,4777,48
10-12-2020,krishnagiri,161,21,15,0,167,7388,21,165,0,7574,7293,114
10-12-2020,madurai,221,29,27,0,223,19815,29,155,0,19999,19333,443
10-12-2020,nagapattinam,161,16,25,0,152,7720,16,88,0,7824,7547,125
10-12-2020,namakkal,187,28,28,0,187,10556,28,102,0,10686,10395,104
10-12-2020,nilgiris,204,10,20,0,194,7598,10,20,0,7628,7392,42
10-12-2020,perambalur,4,0,0,0,4,2245,0,2,0,2247,2222,21
10-12-2020,pudukottai,90,6,14,0,82,11196,6,33,0,11235,10999,154
10-12-2020,ramanathapuram,33,4,6,0,31,6113,4,133,0,6250,6088,131
10-12-2020,ranipet,73,8,10,0,71,15663,8,49,0,15720,15470,179
10-12-2020,salem,528,71,60,1,538,30110,71,419,0,30600,29615,447
10-12-2020,sivagangai,61,7,14,0,54,6319,7,68,0,6394,6214,126
10-12-2020,tenkasi,90,4,14,0,80,8099,4,49,0,8152,7917,155
10-12-2020,thanjavur,175,15,39,0,151,16636,15,22,0,16673,16293,229
10-12-2020,theni,51,11,7,0,55,16642,11,45,0,16698,16445,198
10-12-2020,thirupathur,86,2,17,0,71,7218,2,110,0,7330,7135,124
10-12-2020,thiruvallur,437,64,65,1,435,41506,64,8,0,41578,40480,663
10-12-2020,thiruvannamalai,162,6,33,0,135,18436,6,393,0,18835,18424,276
10-12-2020,thiruvarur,126,11,25,0,112,10582,11,37,0,10630,10411,107
10-12-2020,thoothukudi,137,8,11,1,133,15548,8,273,0,15829,15556,140
10-12-2020,tirunelveli,168,12,15,0,165,14581,12,420,0,15013,14638,210
10-12-2020,tiruppur,549,51,62,0,538,15963,51,11,0,16025,15276,211
10-12-2020,trichy,195,18,31,0,182,13640,18,29,0,13687,13333,172
10-12-2020,vellore,337,43,26,2,352,19415,36,260,7,19718,19028,338
10-12-2020,villupuram,81,8,11,0,78,14569,8,174,0,14751,14563,110
10-12-2020,virudhunagar,137,17,7,0,147,15946,17,104,0,16067,15692,228
10-12-2020,airport surveillance (international),2,1,0,0,3,0,0,927,1,928,924,1
10-12-2020,airport surveillance (domestic),9,3,0,0,12,0,0,1009,3,1012,999,1
10-12-2020,railway surveillance,0,0,0,0,0,0,0,428,0,428,428,0
11-12-2020,ariyalur,28,2,2,0,28,4584,2,20,0,4606,4530,48
11-12-2020,chengalpattu,540,69,96,1,512,48496,69,5,0,48570,47328,730
11-12-2020,chennai,3247,307,315,6,3233,218826,307,35,0,219168,212031,3904
11-12-2020,coimbatore,955,115,92,2,976,50030,115,51,0,50196,48592,628
11-12-2020,cuddalore,57,13,7,0,63,24190,13,202,0,24405,24064,278
11-12-2020,dharmapuri,132,11,11,0,132,5990,11,214,0,6215,6032,51
11-12-2020,dindigul,168,31,28,1,170,10451,31,77,0,10559,10193,196
11-12-2020,erode,389,44,67,0,366,12830,44,94,0,12968,12460,142
11-12-2020,kallakurichi,22,2,5,0,19,10314,2,404,0,10720,10593,108
11-12-2020,kancheepuram,233,40,46,1,226,28039,40,3,0,28082,27427,429
11-12-2020,kanyakumari,150,26,26,0,150,15821,26,109,0,15956,15553,253
11-12-2020,karur,124,8,14,0,118,4903,8,46,0,4957,4791,48
11-12-2020,krishnagiri,167,28,23,0,172,7409,28,165,0,7602,7316,114
11-12-2020,madurai,221,50,28,0,243,19842,50,155,0,20047,19361,443
11-12-2020,nagapattinam,152,17,27,0,142,7736,17,88,0,7841,7574,125
11-12-2020,namakkal,187,23,35,1,174,10584,23,102,0,10709,10430,105
11-12-2020,nilgiris,194,19,17,0,196,7608,19,20,0,7647,7409,42
11-12-2020,perambalur,5,0,1,0,4,2246,0,2,0,2248,2223,21
11-12-2020,pudukottai,82,10,14,0,78,11202,10,33,0,11245,11013,154
11-12-2020,ramanathapuram,31,4,7,0,28,6117,4,133,0,6254,6095,131
11-12-2020,ranipet,72,12,9,0,75,15672,12,49,0,15733,15479,179
11-12-2020,salem,540,73,67,0,546,30183,73,419,0,30675,29682,447
11-12-2020,sivagangai,48,8,12,0,44,6320,8,68,0,6396,6226,126
11-12-2020,tenkasi,80,7,15,0,72,8103,7,49,0,8159,7932,155
11-12-2020,thanjavur,152,25,43,2,132,16652,25,22,0,16699,16336,231
11-12-2020,theni,54,12,10,2,54,16652,12,45,0,16709,16455,200
11-12-2020,thirupathur,70,5,12,0,63,7219,5,110,0,7334,7147,124
11-12-2020,thiruvallur,433,70,68,1,434,41568,70,8,0,41646,40548,664
11-12-2020,thiruvannamalai,135,40,33,0,142,18442,40,393,0,18875,18457,276
11-12-2020,thiruvarur,113,9,20,0,102,10594,9,37,0,10640,10431,107
11-12-2020,thoothukudi,133,9,9,0,133,15556,9,273,0,15838,15565,140
11-12-2020,tirunelveli,164,15,17,0,162,14592,15,420,0,15027,14655,210
11-12-2020,tiruppur,539,48,56,0,531,16015,48,11,0,16074,15332,211
11-12-2020,trichy,181,28,27,0,182,13657,28,29,0,13714,13360,172
11-12-2020,vellore,353,20,28,0,345,19452,19,267,1,19739,19056,338
11-12-2020,villupuram,78,15,9,0,84,14577,15,174,0,14766,14572,110
11-12-2020,virudhunagar,148,19,15,0,152,15964,19,104,0,16087,15707,228
11-12-2020,airport surveillance (international),3,0,0,0,3,0,0,928,0,928,924,1
11-12-2020,airport surveillance (domestic),12,1,0,0,13,0,0,1012,1,1013,999,1
11-12-2020,railway surveillance,0,0,0,0,0,0,0,428,0,428,428,0
12-12-2020,ariyalur,28,0,3,0,25,4586,0,20,0,4606,4533,48
12-12-2020,chengalpattu,517,72,85,0,504,48570,72,5,0,48647,47413,730
12-12-2020,chennai,3246,345,359,6,3226,219146,345,35,0,219526,212390,3910
12-12-2020,coimbatore,977,120,104,1,992,50146,120,51,0,50317,48696,629
12-12-2020,cuddalore,64,14,6,0,72,24204,14,202,0,24420,24070,278
12-12-2020,dharmapuri,134,8,14,0,128,6003,8,214,0,6225,6046,51
12-12-2020,dindigul,166,28,35,0,159,10478,28,77,0,10583,10228,196
12-12-2020,erode,364,41,49,0,356,12872,41,94,0,13007,12509,142
12-12-2020,kallakurichi,24,1,5,0,20,10321,1,404,0,10726,10598,108
12-12-2020,kancheepuram,220,41,36,1,224,28073,41,3,0,28117,27463,430
12-12-2020,kanyakumari,150,19,15,1,153,15847,19,109,0,15975,15568,254
12-12-2020,karur,118,12,15,0,115,4911,12,46,0,4969,4806,48
12-12-2020,krishnagiri,172,17,20,0,169,7437,17,165,0,7619,7336,114
12-12-2020,madurai,244,41,23,1,261,19893,41,155,0,20089,19384,444
12-12-2020,nagapattinam,142,18,28,2,130,7753,18,88,0,7859,7602,127
12-12-2020,namakkal,179,36,47,0,168,10612,36,102,0,10750,10477,105
12-12-2020,nilgiris,196,15,30,0,181,7627,15,20,0,7662,7439,42
12-12-2020,perambalur,4,2,1,0,5,2246,2,2,0,2250,2224,21
12-12-2020,pudukottai,78,15,10,0,83,11212,15,33,0,11260,11023,154
12-12-2020,ramanathapuram,28,1,5,0,24,6121,1,133,0,6255,6100,131
12-12-2020,ranipet,75,15,5,0,85,15684,15,49,0,15748,15484,179
12-12-2020,salem,540,40,53,1,526,30250,40,419,0,30709,29735,448
12-12-2020,sivagangai,44,11,5,0,50,6328,11,68,0,6407,6231,126
12-12-2020,tenkasi,72,4,23,0,53,8110,4,49,0,8163,7955,155
12-12-2020,thanjavur,127,12,11,0,128,16672,12,22,0,16706,16347,231
12-12-2020,theni,54,13,5,0,62,16664,13,45,0,16722,16460,200
12-12-2020,thirupathur,63,8,9,0,62,7224,8,110,0,7342,7156,124
12-12-2020,thiruvallur,425,72,52,0,445,41629,72,8,0,41709,40600,664
12-12-2020,thiruvannamalai,139,9,24,0,124,18479,9,393,0,18881,18481,276
12-12-2020,thiruvarur,104,21,21,0,104,10605,21,37,0,10663,10452,107
12-12-2020,thoothukudi,133,15,19,0,129,15565,15,273,0,15853,15584,140
12-12-2020,tirunelveli,162,14,20,0,156,14607,14,420,0,15041,14675,210
12-12-2020,tiruppur,534,65,68,0,531,16066,65,11,0,16142,15400,211
12-12-2020,trichy,181,17,19,0,179,13684,17,29,0,13730,13379,172
12-12-2020,vellore,349,28,32,0,345,19475,24,268,4,19771,19088,338
12-12-2020,villupuram,78,10,5,0,83,14586,10,174,0,14770,14577,110
12-12-2020,virudhunagar,152,17,31,0,138,15983,17,104,0,16104,15738,228
12-12-2020,airport surveillance (international),3,0,0,0,3,0,0,928,0,928,924,1
12-12-2020,airport surveillance (domestic),13,1,4,0,10,0,0,1013,1,1014,1003,1
12-12-2020,railway surveillance,0,0,0,0,0,0,0,428,0,428,428,0
13-12-2020,ariyalur,26,2,3,0,25,4587,2,20,0,4609,4536,48
13-12-2020,chengalpattu,510,66,83,1,492,48649,66,5,0,48720,47496,732
13-12-2020,chennai,3222,340,366,8,3188,219486,340,35,0,219861,212756,3917
13-12-2020,coimbatore,994,115,102,0,1007,50268,115,51,0,50434,48798,629
13-12-2020,cuddalore,72,12,5,0,79,24218,12,202,0,24432,24075,278
13-12-2020,dharmapuri,129,10,12,0,127,6012,10,214,0,6236,6058,51
13-12-2020,dindigul,160,20,32,0,148,10507,20,77,0,10604,10260,196
13-12-2020,erode,355,43,46,0,352,12912,43,94,0,13049,12555,142
13-12-2020,kallakurichi,20,5,4,0,21,10322,5,404,0,10731,10602,108
13-12-2020,kancheepuram,221,46,33,0,234,28111,46,3,0,28160,27496,430
13-12-2020,kanyakumari,153,29,13,0,169,15866,29,109,0,16004,15581,254
13-12-2020,karur,115,13,13,0,115,4923,13,46,0,4982,4819,48
13-12-2020,krishnagiri,169,15,21,0,163,7454,15,165,0,7634,7357,114
13-12-2020,madurai,259,32,16,0,275,19932,32,155,0,20119,19400,444
13-12-2020,nagapattinam,130,12,25,0,117,7771,12,88,0,7871,7627,127
13-12-2020,namakkal,169,32,44,0,157,10649,31,102,1,10783,10521,105
13-12-2020,nilgiris,180,9,26,0,163,7641,9,20,0,7670,7465,42
13-12-2020,perambalur,5,0,0,0,5,2248,0,2,0,2250,2224,21
13-12-2020,pudukottai,83,9,9,0,83,11227,9,33,0,11269,11032,154
13-12-2020,ramanathapuram,24,3,2,0,25,6122,3,133,0,6258,6102,131
13-12-2020,ranipet,85,11,6,0,90,15699,11,49,0,15759,15490,179
13-12-2020,salem,524,66,57,0,533,30288,66,419,0,30773,29792,448
13-12-2020,sivagangai,49,7,7,0,49,6338,7,68,0,6413,6238,126
13-12-2020,tenkasi,54,4,21,1,36,8115,4,49,0,8168,7976,156
13-12-2020,thanjavur,128,17,12,0,133,16684,17,22,0,16723,16359,231
13-12-2020,theni,62,6,3,1,64,16677,6,45,0,16728,16463,201
13-12-2020,thirupathur,62,3,10,0,55,7232,3,110,0,7345,7166,124
13-12-2020,thiruvallur,444,70,63,0,451,41700,70,8,0,41778,40663,664
13-12-2020,thiruvannamalai,125,21,25,0,121,18489,21,393,0,18903,18506,276
13-12-2020,thiruvarur,103,15,14,0,104,10625,15,37,0,10677,10466,107
13-12-2020,thoothukudi,129,14,18,0,125,15580,14,273,0,15867,15602,140
13-12-2020,tirunelveli,155,6,18,0,143,14620,6,420,0,15046,14693,210
13-12-2020,tiruppur,531,62,71,1,521,16131,62,11,0,16204,15471,212
13-12-2020,trichy,179,14,22,0,171,13701,14,29,0,13744,13401,172
13-12-2020,vellore,346,33,43,0,336,19500,30,272,3,19805,19131,338
13-12-2020,villupuram,85,15,4,0,96,14598,15,174,0,14787,14581,110
13-12-2020,virudhunagar,138,18,27,0,129,16000,18,104,0,16122,15765,228
13-12-2020,airport surveillance (international),3,0,0,0,3,0,0,928,0,928,924,1
13-12-2020,airport surveillance (domestic),10,0,0,0,10,0,0,1014,0,1014,1003,1
13-12-2020,railway surveillance,0,0,0,0,0,0,0,428,0,428,428,0
14-12-2020,ariyalur,26,1,3,0,24,4590,1,20,0,4611,4539,48
14-12-2020,chengalpattu,499,61,74,0,486,48722,61,5,0,48788,47570,732
14-12-2020,chennai,3195,343,378,7,3153,219833,343,35,0,220211,213134,3924
14-12-2020,coimbatore,1007,124,94,1,1036,50383,124,51,0,50558,48892,630
14-12-2020,cuddalore,79,13,6,0,86,24230,13,202,0,24445,24081,278
14-12-2020,dharmapuri,127,15,21,0,121,6022,15,214,0,6251,6079,51
14-12-2020,dindigul,148,21,19,1,149,10527,21,77,0,10625,10279,197
14-12-2020,erode,352,39,39,0,352,12955,39,94,0,13088,12594,142
14-12-2020,kallakurichi,21,2,4,0,19,10327,2,404,0,10733,10606,108
14-12-2020,kancheepuram,227,30,31,1,225,28150,30,3,0,28183,27527,431
14-12-2020,kanyakumari,169,25,9,0,185,15895,25,109,0,16029,15590,254
14-12-2020,karur,116,12,21,0,107,4937,12,46,0,4995,4840,48
14-12-2020,krishnagiri,163,20,24,1,158,7469,20,165,0,7654,7381,115
14-12-2020,madurai,273,25,20,1,277,19962,25,155,0,20142,19420,445
14-12-2020,nagapattinam,117,11,11,0,117,7783,11,88,0,7882,7638,127
14-12-2020,namakkal,157,31,28,0,160,10680,31,103,0,10814,10549,105
14-12-2020,nilgiris,163,12,29,0,146,7650,12,20,0,7682,7494,42
14-12-2020,perambalur,4,0,1,0,3,2247,0,2,0,2249,2225,21
14-12-2020,pudukottai,83,10,10,0,83,11236,10,33,0,11279,11042,154
14-12-2020,ramanathapuram,25,5,2,0,28,6125,5,133,0,6263,6104,131
14-12-2020,ranipet,90,12,9,0,93,15710,12,49,0,15771,15499,179
14-12-2020,salem,533,58,66,1,524,30354,58,419,0,30831,29858,449
14-12-2020,sivagangai,49,9,5,0,53,6345,9,68,0,6422,6243,126
14-12-2020,tenkasi,36,3,4,0,35,8119,3,49,0,8171,7980,156
14-12-2020,thanjavur,132,24,10,0,146,16700,24,22,0,16746,16369,231
14-12-2020,theni,64,8,4,0,68,16683,8,45,0,16736,16467,201
14-12-2020,thirupathur,55,5,7,0,53,7235,5,110,0,7350,7173,124
14-12-2020,thiruvallur,446,50,56,1,439,41765,50,8,0,41823,40719,665
14-12-2020,thiruvannamalai,121,16,14,0,123,18510,16,393,0,18919,18520,276
14-12-2020,thiruvarur,104,18,9,0,113,10640,18,37,0,10695,10475,107
14-12-2020,thoothukudi,125,16,24,0,117,15594,16,273,0,15883,15626,140
14-12-2020,tirunelveli,143,9,19,0,133,14626,9,420,0,15055,14712,210
14-12-2020,tiruppur,521,49,64,0,506,16193,49,11,0,16253,15535,212
14-12-2020,trichy,170,19,14,0,175,13714,19,29,0,13762,13415,172
14-12-2020,vellore,335,26,47,0,314,19529,26,275,0,19830,19178,338
14-12-2020,villupuram,96,9,6,0,99,14613,9,174,0,14796,14587,110
14-12-2020,virudhunagar,131,9,19,0,121,16020,9,104,0,16133,15784,228
14-12-2020,airport surveillance (international),3,0,0,0,3,0,0,928,0,928,924,1
14-12-2020,airport surveillance (domestic),10,1,2,0,9,0,0,1014,1,1015,1005,1
14-12-2020,railway surveillance,0,0,0,0,0,0,0,428,0,428,428,0
15-12-2020,ariyalur,24,2,5,0,21,4591,2,20,0,4613,4544,48
15-12-2020,chengalpattu,494,59,63,0,490,48791,59,5,0,48855,47633,732
15-12-2020,chennai,3143,359,375,5,3122,220166,359,35,0,220560,213509,3929
15-12-2020,coimbatore,1037,117,106,0,1048,50509,117,51,0,50677,48998,631
15-12-2020,cuddalore,86,9,8,0,87,24243,9,202,0,24454,24089,278
15-12-2020,dharmapuri,121,10,23,0,108,6037,10,214,0,6261,6102,51
15-12-2020,dindigul,150,17,16,0,151,10548,17,77,0,10642,10295,196
15-12-2020,erode,351,40,43,0,348,12993,40,94,0,13127,12637,142
15-12-2020,kallakurichi,20,3,3,0,20,10330,3,404,0,10737,10609,108
15-12-2020,kancheepuram,223,36,33,0,226,28179,36,3,0,28218,27560,432
15-12-2020,kanyakumari,184,26,12,0,198,15919,26,109,0,16054,15602,254
15-12-2020,karur,106,10,19,0,97,4948,10,46,0,5004,4859,48
15-12-2020,krishnagiri,158,18,22,0,154,7489,18,165,0,7672,7403,115
15-12-2020,madurai,277,22,23,1,275,19987,22,155,0,20164,19443,446
15-12-2020,nagapattinam,119,13,8,0,124,7796,13,88,0,7897,7646,127
15-12-2020,namakkal,160,25,15,1,169,10711,25,103,0,10839,10564,106
15-12-2020,nilgiris,146,16,28,0,134,7662,16,20,0,7698,7522,42
15-12-2020,perambalur,3,2,0,0,5,2247,2,2,0,2251,2225,21
15-12-2020,pudukottai,82,7,12,0,77,11245,7,33,0,11285,11054,154
15-12-2020,ramanathapuram,29,3,6,0,26,6131,3,133,0,6267,6110,131
15-12-2020,ranipet,93,7,15,1,84,15722,7,49,0,15778,15514,180
15-12-2020,salem,525,34,78,0,481,30413,34,419,0,30866,29936,449
15-12-2020,sivagangai,53,5,3,0,55,6354,5,68,0,6427,6246,126
15-12-2020,tenkasi,35,1,5,0,31,8122,1,49,0,8172,7985,156
15-12-2020,thanjavur,149,22,13,0,158,16726,22,22,0,16770,16382,230
15-12-2020,theni,68,10,5,0,73,16691,10,45,0,16746,16472,201
15-12-2020,thirupathur,52,4,14,0,42,7239,4,110,0,7353,7187,124
15-12-2020,thiruvallur,439,62,50,1,450,41815,62,8,0,41885,40769,666
15-12-2020,thiruvannamalai,124,18,20,0,122,18527,18,393,0,18938,18540,276
15-12-2020,thiruvarur,113,10,3,0,120,10658,10,37,0,10705,10478,107
15-12-2020,thoothukudi,117,13,22,0,108,15610,13,273,0,15896,15648,140
15-12-2020,tirunelveli,132,21,17,1,135,14634,21,420,0,15075,14729,211
15-12-2020,tiruppur,506,69,34,0,541,16242,69,11,0,16322,15569,212
15-12-2020,trichy,173,15,29,0,159,13731,14,29,1,13775,13444,172
15-12-2020,vellore,315,20,36,0,299,19556,20,275,0,19851,19214,338
15-12-2020,villupuram,99,11,13,0,97,14622,11,174,0,14807,14600,110
15-12-2020,virudhunagar,121,15,33,0,103,16029,15,104,0,16148,15817,228
15-12-2020,airport surveillance (international),3,0,0,0,3,0,0,928,0,928,924,1
15-12-2020,airport surveillance (domestic),9,1,0,0,10,0,0,1015,1,1016,1005,1
15-12-2020,railway surveillance,0,0,0,0,0,0,0,428,0,428,428,0
17-12-2020,ariyalur,14,1,2,0,13,4596,1,20,0,4617,4556,48
17-12-2020,chengalpattu,508,76,74,0,510,48938,76,5,0,49019,47776,733
17-12-2020,chennai,3092,342,376,4,3054,220864,340,38,2,221244,214255,3935
17-12-2020,coimbatore,1053,120,108,1,1064,50741,120,51,0,50912,49215,633
17-12-2020,cuddalore,86,8,10,0,84,24263,8,202,0,24473,24110,279
17-12-2020,dharmapuri,96,15,11,0,100,6050,15,214,0,6279,6126,53
17-12-2020,dindigul,157,19,26,0,150,10586,19,77,0,10682,10336,196
17-12-2020,erode,345,47,52,0,340,13079,47,94,0,13220,12738,142
17-12-2020,kallakurichi,16,5,5,0,16,10338,5,404,0,10747,10623,108
17-12-2020,kancheepuram,223,41,33,1,230,28247,41,3,0,28291,27628,433
17-12-2020,kanyakumari,198,14,15,0,197,15966,14,109,0,16089,15638,254
17-12-2020,karur,100,12,7,0,105,4968,12,46,0,5026,4873,48
17-12-2020,krishnagiri,150,8,8,0,150,7523,8,165,0,7696,7430,116
17-12-2020,madurai,277,28,17,1,287,20032,28,155,0,20215,19481,447
17-12-2020,nagapattinam,116,17,16,0,117,7824,17,88,0,7929,7685,127
17-12-2020,namakkal,198,23,10,0,211,10773,22,103,1,10899,10582,106
17-12-2020,nilgiris,140,19,13,0,146,7700,19,20,0,7739,7551,42
17-12-2020,perambalur,6,1,2,0,5,2250,1,2,0,2253,2227,21
17-12-2020,pudukottai,83,6,9,0,80,11263,6,33,0,11302,11068,154
17-12-2020,ramanathapuram,28,2,4,0,26,6139,2,133,0,6274,6117,131
17-12-2020,ranipet,82,11,9,0,84,15742,11,49,0,15802,15538,180
17-12-2020,salem,448,58,85,1,420,30495,58,419,0,30972,30100,452
17-12-2020,sivagangai,55,7,4,0,58,6369,7,68,0,6444,6260,126
17-12-2020,tenkasi,36,6,5,0,37,8133,6,49,0,8188,7995,156
17-12-2020,thanjavur,129,28,29,0,128,16765,28,22,0,16815,16457,230
17-12-2020,theni,69,15,9,1,74,16708,15,45,0,16768,16491,203
17-12-2020,thirupathur,33,4,7,0,30,7245,4,110,0,7359,7205,124
17-12-2020,thiruvallur,439,59,40,1,457,41916,59,8,0,41983,40859,667
17-12-2020,thiruvannamalai,111,12,27,1,95,18559,12,393,0,18964,18591,278
17-12-2020,thiruvarur,122,10,29,0,103,10683,10,37,0,10730,10520,107
17-12-2020,thoothukudi,119,13,11,0,121,15642,13,273,0,15928,15667,140
17-12-2020,tirunelveli,140,10,6,0,144,14669,10,420,0,15099,14744,211
17-12-2020,tiruppur,567,50,57,0,560,16384,50,11,0,16445,15673,212
17-12-2020,trichy,153,33,36,0,150,13769,31,30,2,13832,13510,172
17-12-2020,vellore,301,23,35,0,289,19608,23,278,0,19909,19282,338
17-12-2020,villupuram,89,14,15,0,88,14638,14,174,0,14826,14628,110
17-12-2020,virudhunagar,88,16,12,0,92,16053,16,104,0,16173,15853,228
17-12-2020,airport surveillance (international),3,0,0,0,3,0,0,928,0,928,924,1
17-12-2020,airport surveillance (domestic),10,1,0,0,11,0,0,1016,1,1017,1005,1
17-12-2020,railway surveillance,0,0,0,0,0,0,0,428,0,428,428,0
18-12-2020,ariyalur,11,2,3,0,10,4595,2,20,0,4617,4559,48
18-12-2020,chengalpattu,518,69,79,0,508,49022,69,5,0,49096,47855,733
18-12-2020,chennai,3056,341,357,3,3037,221206,341,40,0,221587,214612,3938
18-12-2020,coimbatore,1066,115,114,1,1066,50863,115,51,0,51029,49329,634
18-12-2020,cuddalore,84,12,6,1,89,24271,12,202,0,24485,24116,280
18-12-2020,dharmapuri,99,12,15,0,96,6064,12,214,0,6290,6141,53
18-12-2020,dindigul,150,15,11,0,154,10605,15,77,0,10697,10347,196
18-12-2020,erode,338,31,43,0,326,13124,31,94,0,13249,12781,142
18-12-2020,kallakurichi,17,6,4,0,19,10344,6,404,0,10754,10627,108
18-12-2020,kancheepuram,223,37,29,0,231,28281,37,3,0,28321,27657,433
18-12-2020,kanyakumari,197,25,28,0,194,15980,25,109,0,16114,15666,254
18-12-2020,karur,105,9,11,0,103,4980,9,46,0,5035,4884,48
18-12-2020,krishnagiri,152,10,13,0,149,7533,10,165,0,7708,7443,116
18-12-2020,madurai,287,39,12,0,314,20060,39,155,0,20254,19493,447
18-12-2020,nagapattinam,118,14,24,0,108,7842,14,88,0,7944,7709,127
18-12-2020,namakkal,206,25,22,0,209,10790,25,104,0,10919,10604,106
18-12-2020,nilgiris,144,17,14,0,147,7717,17,20,0,7754,7565,42
18-12-2020,perambalur,4,0,0,0,4,2250,0,2,0,2252,2227,21
18-12-2020,pudukottai,83,9,4,0,88,11272,9,33,0,11314,11072,154
18-12-2020,ramanathapuram,26,9,7,0,28,6141,9,133,0,6283,6124,131
18-12-2020,ranipet,85,4,8,0,81,15754,4,49,0,15807,15546,180
18-12-2020,salem,423,41,87,1,376,30556,41,419,0,31016,30187,453
18-12-2020,sivagangai,56,8,4,0,60,6374,8,68,0,6450,6264,126
18-12-2020,tenkasi,37,4,4,0,37,8139,4,49,0,8192,7999,156
18-12-2020,thanjavur,129,23,21,1,130,16794,23,22,0,16839,16478,231
18-12-2020,theni,74,9,8,0,75,16723,9,45,0,16777,16499,203
18-12-2020,thirupathur,30,7,10,0,27,7249,7,110,0,7366,7215,124
18-12-2020,thiruvallur,456,51,48,1,458,41974,51,8,0,42033,40907,668
18-12-2020,thiruvannamalai,95,16,17,1,93,18571,16,393,0,18980,18608,279
18-12-2020,thiruvarur,103,16,15,1,103,10693,16,37,0,10746,10535,108
18-12-2020,thoothukudi,122,11,10,0,123,15656,11,273,0,15940,15677,140
18-12-2020,tirunelveli,144,20,9,0,155,14679,20,420,0,15119,14753,211
18-12-2020,tiruppur,561,43,48,1,555,16435,43,11,0,16489,15721,213
18-12-2020,trichy,148,27,19,0,156,13798,27,32,0,13857,13529,172
18-12-2020,vellore,288,24,31,1,280,19630,24,278,0,19932,19313,339
18-12-2020,villupuram,88,16,21,0,83,14652,16,174,0,14842,14649,110
18-12-2020,virudhunagar,92,14,14,0,92,16069,14,104,0,16187,15867,228
18-12-2020,airport surveillance (international),3,0,0,0,3,0,0,928,0,928,924,1
18-12-2020,airport surveillance (domestic),11,3,0,0,14,0,0,1017,3,1020,1005,1
18-12-2020,railway surveillance,0,0,0,0,0,0,0,428,0,428,428,0
19-12-2020,ariyalur,8,1,1,0,8,4595,1,20,0,4616,4560,48
19-12-2020,chengalpattu,516,84,76,0,524,49099,84,5,0,49188,47931,733
19-12-2020,chennai,3049,338,356,9,3022,221559,338,40,0,221937,214968,3947
19-12-2020,coimbatore,1068,116,124,0,1060,50980,116,51,0,51147,49453,634
19-12-2020,cuddalore,91,16,12,0,95,24285,16,202,0,24503,24128,280
19-12-2020,dharmapuri,97,5,20,0,82,6077,5,214,0,6296,6161,53
19-12-2020,dindigul,155,13,15,0,153,10621,13,77,0,10711,10362,196
19-12-2020,erode,325,32,56,0,301,13154,32,94,0,13280,12837,142
19-12-2020,kallakurichi,20,3,3,0,20,10351,3,404,0,10758,10630,108
19-12-2020,kancheepuram,215,45,23,0,237,28302,45,3,0,28350,27680,433
19-12-2020,kanyakumari,194,19,37,0,176,16005,19,109,0,16133,15703,254
19-12-2020,karur,104,8,15,0,97,4990,8,46,0,5044,4899,48
19-12-2020,krishnagiri,149,15,18,0,146,7543,15,165,0,7723,7461,116
19-12-2020,madurai,314,20,28,1,305,20099,20,155,0,20274,19521,448
19-12-2020,nagapattinam,108,17,11,0,114,7856,17,88,0,7961,7720,127
19-12-2020,namakkal,209,26,24,0,211,10815,26,104,0,10945,10628,106
19-12-2020,nilgiris,147,14,21,0,140,7734,14,20,0,7768,7586,42
19-12-2020,perambalur,4,0,0,0,4,2250,0,2,0,2252,2227,21
19-12-2020,pudukottai,90,8,16,0,82,11283,8,33,0,11324,11088,154
19-12-2020,ramanathapuram,28,0,3,0,25,6150,0,133,0,6283,6127,131
19-12-2020,ranipet,81,7,11,0,77,15758,7,49,0,15814,15557,180
19-12-2020,salem,375,44,66,1,352,30596,44,419,0,31059,30253,454
19-12-2020,sivagangai,59,7,9,0,57,6381,7,68,0,6456,6273,126
19-12-2020,tenkasi,38,3,5,0,36,8144,3,49,0,8196,8004,156
19-12-2020,thanjavur,129,32,11,0,150,16816,32,22,0,16870,16489,231
19-12-2020,theni,76,8,6,0,78,16733,8,45,0,16786,16505,203
19-12-2020,thirupathur,28,4,6,0,26,7257,4,110,0,7371,7221,124
19-12-2020,thiruvallur,453,72,47,1,477,42020,70,8,2,42100,40954,669
19-12-2020,thiruvannamalai,94,7,11,1,89,18588,7,393,0,18988,18619,280
19-12-2020,thiruvarur,103,15,7,0,111,10709,15,37,0,10761,10542,108
19-12-2020,thoothukudi,122,7,12,0,117,15666,7,273,0,15946,15689,140
19-12-2020,tirunelveli,150,16,16,0,150,14694,16,420,0,15130,14769,211
19-12-2020,tiruppur,556,41,60,1,536,16479,41,11,0,16531,15781,214
19-12-2020,trichy,156,24,21,0,159,13825,24,32,0,13881,13550,172
19-12-2020,vellore,278,31,34,0,275,19652,25,278,6,19961,19347,339
19-12-2020,villupuram,83,15,12,0,86,14668,15,174,0,14857,14661,110
19-12-2020,virudhunagar,92,12,9,0,95,16083,12,104,0,16199,15876,228
19-12-2020,airport surveillance (international),3,0,0,0,3,0,0,928,0,928,924,1
19-12-2020,airport surveillance (domestic),14,2,0,0,16,0,0,1020,2,1022,1005,1
19-12-2020,railway surveillance,0,0,0,0,0,0,0,428,0,428,428,0
20-12-2020,ariyalur,6,2,0,0,8,4594,2,20,0,4616,4560,48
20-12-2020,chengalpattu,528,81,83,0,526,49187,81,5,0,49273,48014,733
20-12-2020,chennai,3018,325,318,7,3018,221893,325,40,0,222258,215286,3954
20-12-2020,coimbatore,1060,112,145,3,1024,51096,112,51,0,51259,49598,637
20-12-2020,cuddalore,94,13,5,1,101,24300,13,202,0,24515,24133,281
20-12-2020,dharmapuri,83,11,3,0,91,6083,11,214,0,6308,6164,53
20-12-2020,dindigul,153,12,20,0,145,10634,12,77,0,10723,10382,196
20-12-2020,erode,299,38,53,0,284,13184,38,94,0,13316,12890,142
20-12-2020,kallakurichi,20,1,3,0,18,10354,1,404,0,10759,10633,108
20-12-2020,kancheepuram,240,29,30,0,239,28350,29,3,0,28382,27710,433
20-12-2020,kanyakumari,176,27,25,0,178,16024,27,109,0,16160,15728,254
20-12-2020,karur,99,12,10,0,101,5000,12,46,0,5058,4909,48
20-12-2020,krishnagiri,146,10,20,0,136,7558,9,165,1,7733,7481,116
20-12-2020,madurai,305,28,32,0,301,20119,28,155,0,20302,19553,448
20-12-2020,nagapattinam,115,18,15,0,118,7874,18,88,0,7980,7735,127
20-12-2020,namakkal,211,23,14,0,220,10841,23,104,0,10968,10642,106
20-12-2020,nilgiris,140,21,19,0,142,7748,21,20,0,7789,7605,42
20-12-2020,perambalur,4,0,0,0,4,2250,0,2,0,2252,2227,21
20-12-2020,pudukottai,82,11,13,0,80,11291,11,33,0,11335,11101,154
20-12-2020,ramanathapuram,25,3,1,1,26,6150,3,133,0,6286,6128,132
20-12-2020,ranipet,77,3,12,0,68,15765,3,49,0,15817,15569,180
20-12-2020,salem,352,30,69,1,312,30640,30,419,0,31089,30322,455
20-12-2020,sivagangai,55,3,6,0,52,6386,3,68,0,6457,6279,126
20-12-2020,tenkasi,35,8,3,0,40,8146,8,49,0,8203,8007,156
20-12-2020,thanjavur,150,21,16,0,155,16848,21,22,0,16891,16505,231
20-12-2020,theni,79,10,5,0,84,16742,10,45,0,16797,16510,203
20-12-2020,thirupathur,25,5,5,0,25,7260,5,110,0,7375,7226,124
20-12-2020,thiruvallur,470,57,45,0,482,42083,57,10,0,42150,40999,669
20-12-2020,thiruvannamalai,89,21,15,0,95,18595,21,393,0,19009,18634,280
20-12-2020,thiruvarur,112,23,15,1,119,10725,23,37,0,10785,10557,109
20-12-2020,thoothukudi,118,6,19,0,105,15674,6,273,0,15953,15708,140
20-12-2020,tirunelveli,151,15,20,0,146,14711,15,420,0,15146,14789,211
20-12-2020,tiruppur,537,52,70,0,519,16521,52,11,0,16584,15851,214
20-12-2020,trichy,162,27,24,1,164,13852,27,32,0,13911,13574,173
20-12-2020,vellore,276,30,37,0,269,19678,23,284,7,19992,19384,339
20-12-2020,villupuram,86,16,9,0,93,14683,16,174,0,14873,14670,110
20-12-2020,virudhunagar,95,10,15,0,90,16095,10,104,0,16209,15891,228
20-12-2020,airport surveillance (international),3,0,0,0,3,0,0,928,0,928,924,1
20-12-2020,airport surveillance (domestic),16,0,4,0,12,0,0,1022,0,1022,1009,1
20-12-2020,railway surveillance,0,0,0,0,0,0,0,428,0,428,428,0
21-12-2020,ariyalur,9,4,3,0,10,4597,4,20,0,4621,4563,48
21-12-2020,chengalpattu,523,65,71,1,516,49265,65,5,0,49335,48085,734
21-12-2020,chennai,3034,306,317,6,3017,222234,306,40,0,222580,215603,3960
21-12-2020,coimbatore,1024,109,142,0,991,51208,109,51,0,51368,49740,637
21-12-2020,cuddalore,101,11,10,0,102,24313,11,202,0,24526,24143,281
21-12-2020,dharmapuri,92,6,6,0,92,6095,6,214,0,6315,6170,53
21-12-2020,dindigul,145,13,25,0,133,10646,13,77,0,10736,10407,196
21-12-2020,erode,280,43,26,1,296,13218,43,94,0,13355,12916,143
21-12-2020,kallakurichi,20,9,7,0,22,10357,9,404,0,10770,10640,108
21-12-2020,kancheepuram,233,35,20,0,248,28373,35,3,0,28411,27730,433
21-12-2020,kanyakumari,178,14,20,1,171,16051,14,109,0,16174,15748,255
21-12-2020,karur,98,13,16,1,94,5009,13,46,0,5068,4925,49
21-12-2020,krishnagiri,135,11,26,0,120,7566,11,166,0,7743,7507,116
21-12-2020,madurai,301,27,38,0,290,20147,27,155,0,20329,19591,448
21-12-2020,nagapattinam,119,13,9,0,123,7893,13,88,0,7994,7744,127
21-12-2020,namakkal,222,29,33,0,218,10866,29,104,0,10999,10675,106
21-12-2020,nilgiris,142,11,12,1,140,7769,9,20,2,7800,7617,43
21-12-2020,perambalur,5,0,1,0,4,2251,0,2,0,2253,2228,21
21-12-2020,pudukottai,80,7,14,0,73,11302,7,33,0,11342,11115,154
21-12-2020,ramanathapuram,26,4,4,0,26,6153,4,133,0,6290,6132,132
21-12-2020,ranipet,69,10,15,0,64,15769,10,49,0,15828,15584,180
21-12-2020,salem,312,60,51,0,321,30670,60,419,0,31149,30373,455
21-12-2020,sivagangai,52,4,5,0,51,6389,4,68,0,6461,6284,126
21-12-2020,tenkasi,40,5,4,0,41,8154,5,49,0,8208,8011,156
21-12-2020,thanjavur,154,27,11,1,169,16868,27,22,0,16917,16516,232
21-12-2020,theni,84,7,6,0,85,16752,7,45,0,16804,16516,203
21-12-2020,thirupathur,26,6,6,0,26,7266,6,110,0,7382,7232,124
21-12-2020,thiruvallur,475,43,52,0,466,42133,43,10,0,42186,41051,669
21-12-2020,thiruvannamalai,95,19,14,0,100,18616,19,393,0,19028,18648,280
21-12-2020,thiruvarur,118,8,20,0,106,10747,8,37,0,10792,10577,109
21-12-2020,thoothukudi,105,13,16,0,102,15680,13,273,0,15966,15724,140
21-12-2020,tirunelveli,146,10,18,0,138,14726,10,420,0,15156,14807,211
21-12-2020,tiruppur,522,59,74,0,507,16576,59,11,0,16646,15925,214
21-12-2020,trichy,166,21,13,0,174,13881,20,32,1,13934,13587,173
21-12-2020,vellore,267,29,31,0,265,19699,23,291,6,20019,19415,339
21-12-2020,villupuram,90,7,9,0,88,14696,7,174,0,14877,14679,110
21-12-2020,virudhunagar,90,13,11,0,92,16105,13,104,0,16222,15902,228
21-12-2020,airport surveillance (international),3,0,0,0,3,0,0,928,0,928,924,1
21-12-2020,airport surveillance (domestic),12,0,1,0,11,0,0,1022,0,1022,1010,1
21-12-2020,railway surveillance,0,0,0,0,0,0,0,428,0,428,428,0
22-12-2020,ariyalur,8,3,2,0,9,4599,3,20,0,4622,4565,48
22-12-2020,chengalpattu,526,63,54,2,533,49340,63,5,0,49408,48139,736
22-12-2020,chennai,3014,311,295,8,3022,222537,311,40,0,222888,215898,3968
22-12-2020,coimbatore,992,114,116,3,987,51318,114,51,0,51483,49856,640
22-12-2020,cuddalore,101,15,14,0,102,24323,15,202,0,24540,24157,281
22-12-2020,dharmapuri,92,5,10,0,87,6101,5,214,0,6320,6180,53
22-12-2020,dindigul,133,24,28,1,128,10659,24,77,0,10760,10435,197
22-12-2020,erode,292,35,21,0,306,13257,35,94,0,13386,12937,143
22-12-2020,kallakurichi,22,7,5,0,24,10366,7,404,0,10777,10645,108
22-12-2020,kancheepuram,243,43,16,0,270,28403,43,3,0,28449,27746,433
22-12-2020,kanyakumari,171,13,19,0,165,16065,13,109,0,16187,15767,255
22-12-2020,karur,94,9,14,0,89,5022,9,46,0,5077,4939,49
22-12-2020,krishnagiri,121,10,29,0,102,7578,10,166,0,7754,7536,116
22-12-2020,madurai,286,23,48,1,260,20170,23,155,0,20348,19639,449
22-12-2020,nagapattinam,126,10,15,0,121,7909,10,88,0,8007,7759,127
22-12-2020,namakkal,217,17,27,0,207,10894,17,104,0,11015,10702,106
22-12-2020,nilgiris,140,13,17,0,136,7778,13,22,0,7813,7634,43
22-12-2020,perambalur,4,1,0,0,5,2251,1,2,0,2254,2228,21
22-12-2020,pudukottai,73,6,18,0,61,11309,6,33,0,11348,11133,154
22-12-2020,ramanathapuram,22,3,3,0,22,6153,3,133,0,6289,6135,132
22-12-2020,ranipet,64,8,15,0,57,15779,8,49,0,15836,15599,180
22-12-2020,salem,320,38,43,0,315,30729,38,419,0,31186,30416,455
22-12-2020,sivagangai,51,6,8,0,49,6393,6,68,0,6467,6292,126
22-12-2020,tenkasi,41,3,9,0,35,8159,3,49,0,8211,8020,156
22-12-2020,thanjavur,166,18,10,0,174,16892,18,22,0,16932,16526,232
22-12-2020,theni,85,8,11,0,82,16759,8,45,0,16812,16527,203
22-12-2020,thirupathur,25,5,4,0,26,7271,5,110,0,7386,7236,124
22-12-2020,thiruvallur,469,67,55,1,480,42179,67,10,0,42256,41106,670
22-12-2020,thiruvannamalai,101,18,13,0,106,18636,18,393,0,19047,18661,280
22-12-2020,thiruvarur,108,10,22,0,96,10757,10,37,0,10804,10599,109
22-12-2020,thoothukudi,102,11,23,1,89,15693,11,273,0,15977,15747,141
22-12-2020,tirunelveli,138,26,22,0,142,14736,26,420,0,15182,14829,211
22-12-2020,tiruppur,513,36,76,0,473,16641,36,11,0,16688,16001,214
22-12-2020,trichy,174,22,12,0,184,13901,22,33,0,13956,13599,173
22-12-2020,vellore,265,23,43,0,245,19722,20,297,3,20042,19458,339
22-12-2020,villupuram,89,14,8,0,95,14704,14,174,0,14892,14687,110
22-12-2020,virudhunagar,93,11,14,0,90,16119,11,104,0,16234,15916,228
22-12-2020,airport surveillance (international),3,1,0,0,4,0,0,928,1,929,924,1
22-12-2020,airport surveillance (domestic),11,2,0,0,13,0,0,1022,2,1024,1010,1
22-12-2020,railway surveillance,0,0,0,0,0,0,0,428,0,428,428,0
23-12-2020,ariyalur,9,2,1,0,10,4602,2,20,0,4624,4566,48
23-12-2020,chengalpattu,534,77,52,0,559,49404,77,5,0,49486,48191,736
23-12-2020,chennai,3041,302,316,5,3022,222867,302,40,0,223209,216214,3973
23-12-2020,coimbatore,991,109,121,1,978,51436,109,51,0,51596,49977,641
23-12-2020,cuddalore,102,14,15,0,101,24338,14,202,0,24554,24172,281
23-12-2020,dharmapuri,87,9,16,0,80,6106,9,214,0,6329,6196,53
23-12-2020,dindigul,129,25,21,0,133,10684,25,77,0,10786,10456,197
23-12-2020,erode,302,32,25,0,309,13288,32,94,0,13414,12962,143
23-12-2020,kallakurichi,23,2,5,0,20,10372,2,404,0,10778,10650,108
23-12-2020,kancheepuram,259,40,17,0,282,28435,40,3,0,28478,27763,433
23-12-2020,kanyakumari,166,24,23,0,167,16079,24,109,0,16212,15790,255
23-12-2020,karur,89,11,16,0,84,5031,11,46,0,5088,4955,49
23-12-2020,krishnagiri,102,11,26,0,87,7588,10,166,1,7765,7562,116
23-12-2020,madurai,256,30,46,1,239,20189,30,155,0,20374,19685,450
23-12-2020,nagapattinam,121,7,14,0,114,7919,7,88,0,8014,7773,127
23-12-2020,namakkal,208,21,31,2,196,10912,21,104,0,11037,10733,108
23-12-2020,nilgiris,136,23,16,0,143,7791,23,22,0,7836,7650,43
23-12-2020,perambalur,5,0,2,0,3,2252,0,2,0,2254,2230,21
23-12-2020,pudukottai,62,7,3,0,66,11316,7,33,0,11356,11136,154
23-12-2020,ramanathapuram,23,0,4,0,19,6157,0,133,0,6290,6139,132
23-12-2020,ranipet,57,10,6,1,60,15787,10,49,0,15846,15605,181
23-12-2020,salem,315,36,40,1,310,30767,36,419,0,31222,30456,456
23-12-2020,sivagangai,49,3,9,0,43,6399,3,68,0,6470,6301,126
23-12-2020,tenkasi,36,3,1,0,38,8163,3,49,0,8215,8021,156
23-12-2020,thanjavur,174,11,8,0,177,16910,11,22,0,16943,16534,232
23-12-2020,theni,82,7,12,0,77,16767,7,45,0,16819,16539,203
23-12-2020,thirupathur,25,2,5,0,22,7275,2,110,0,7387,7241,124
23-12-2020,thiruvallur,473,58,61,1,469,42239,58,10,0,42307,41167,671
23-12-2020,thiruvannamalai,106,9,9,0,106,18654,9,393,0,19056,18670,280
23-12-2020,thiruvarur,96,23,15,0,104,10767,23,37,0,10827,10614,109
23-12-2020,thoothukudi,89,7,13,0,83,15704,7,273,0,15984,15760,141
23-12-2020,tirunelveli,140,16,18,0,138,14760,16,420,0,15196,14847,211
23-12-2020,tiruppur,475,52,73,0,454,16679,52,11,0,16742,16074,214
23-12-2020,trichy,182,25,12,0,195,13921,25,33,0,13979,13611,173
23-12-2020,vellore,245,29,41,0,233,19742,26,300,3,20071,19499,339
23-12-2020,villupuram,95,13,20,0,88,14718,13,174,0,14905,14707,110
23-12-2020,virudhunagar,90,16,12,0,94,16130,16,104,0,16250,15928,228
23-12-2020,airport surveillance (international),4,0,1,0,3,0,0,929,0,929,925,1
23-12-2020,airport surveillance (domestic),13,0,5,0,8,0,0,1024,0,1024,1015,1
23-12-2020,railway surveillance,0,0,0,0,0,0,0,428,0,428,428,0
24-12-2020,ariyalur,10,1,1,0,10,4604,1,20,0,4625,4567,48
24-12-2020,chengalpattu,565,64,56,1,572,49487,64,5,0,49556,48247,737
24-12-2020,chennai,3026,296,337,6,2979,223173,296,40,0,223509,216551,3979
24-12-2020,coimbatore,980,98,129,1,948,51547,98,51,0,51696,50106,642
24-12-2020,cuddalore,101,17,17,0,101,24352,17,202,0,24571,24189,281
24-12-2020,dharmapuri,80,8,8,0,80,6115,8,214,0,6337,6204,53
24-12-2020,dindigul,135,20,20,0,135,10711,20,77,0,10808,10476,197
24-12-2020,erode,306,34,36,0,304,13317,34,94,0,13445,12998,143
24-12-2020,kallakurichi,20,1,2,0,19,10374,1,404,0,10779,10652,108
24-12-2020,kancheepuram,270,30,16,0,284,28463,30,3,0,28496,27779,433
24-12-2020,kanyakumari,167,17,21,0,163,16103,17,109,0,16229,15811,255
24-12-2020,karur,84,8,7,0,85,5042,8,46,0,5096,4962,49
24-12-2020,krishnagiri,87,16,18,0,85,7598,16,167,0,7781,7580,116
24-12-2020,madurai,239,18,34,0,223,20219,18,155,0,20392,19719,450
24-12-2020,nagapattinam,115,14,15,0,114,7927,14,88,0,8029,7788,127
24-12-2020,namakkal,195,12,25,0,182,10932,12,104,0,11048,10758,108
24-12-2020,nilgiris,143,14,15,1,141,7814,14,22,0,7850,7665,44
24-12-2020,perambalur,2,0,0,0,2,2251,0,2,0,2253,2230,21
24-12-2020,pudukottai,66,5,7,0,64,11323,5,33,0,11361,11143,154
24-12-2020,ramanathapuram,19,5,1,0,23,6157,5,133,0,6295,6140,132
24-12-2020,ranipet,60,11,7,0,64,15797,11,49,0,15857,15612,181
24-12-2020,salem,311,64,38,0,337,30804,64,419,0,31287,30494,456
24-12-2020,sivagangai,43,6,5,0,44,6402,6,68,0,6476,6306,126
24-12-2020,tenkasi,38,8,2,2,42,8166,8,49,0,8223,8023,158
24-12-2020,thanjavur,177,27,17,0,187,16921,27,22,0,16970,16551,232
24-12-2020,theni,77,8,8,0,77,16774,8,45,0,16827,16547,203
24-12-2020,thirupathur,22,5,3,0,24,7277,5,110,0,7392,7244,124
24-12-2020,thiruvallur,467,54,54,1,466,42295,54,10,0,42359,41221,672
24-12-2020,thiruvannamalai,106,16,13,0,109,18663,16,393,0,19072,18683,280
24-12-2020,thiruvarur,104,17,10,0,111,10790,17,37,0,10844,10624,109
24-12-2020,thoothukudi,83,14,10,0,87,15711,14,273,0,15998,15770,141
24-12-2020,tirunelveli,136,11,19,0,128,14774,11,420,0,15205,14866,211
24-12-2020,tiruppur,455,44,83,0,416,16732,44,11,0,16787,16157,214
24-12-2020,trichy,198,28,21,0,205,13949,28,33,0,14010,13632,173
24-12-2020,vellore,233,23,39,0,217,19768,21,303,2,20094,19538,339
24-12-2020,villupuram,89,10,15,0,84,14732,10,174,0,14916,14722,110
24-12-2020,virudhunagar,94,11,11,0,94,16146,11,104,0,16261,15939,228
24-12-2020,airport surveillance (international),3,0,0,0,3,0,0,929,0,929,925,1
24-12-2020,airport surveillance (domestic),8,0,0,0,8,0,0,1024,0,1024,1015,1
24-12-2020,railway surveillance,0,0,0,0,0,0,0,428,0,428,428,0
25-12-2020,ariyalur,9,1,1,0,9,4604,1,20,0,4625,4568,48
25-12-2020,chengalpattu,574,74,54,0,594,49553,74,5,0,49632,48301,737
25-12-2020,chennai,2977,292,332,5,2932,223467,289,40,3,223799,216883,3984
25-12-2020,coimbatore,948,95,128,1,914,51645,95,51,0,51791,50234,643
25-12-2020,cuddalore,100,13,16,1,96,24368,13,202,0,24583,24205,282
25-12-2020,dharmapuri,80,5,18,0,67,6123,5,214,0,6342,6222,53
25-12-2020,dindigul,136,17,9,0,144,10732,17,77,0,10826,10485,197
25-12-2020,erode,301,37,46,0,292,13348,37,94,0,13479,13044,143
25-12-2020,kallakurichi,19,0,1,0,18,10375,0,404,0,10779,10653,108
25-12-2020,kancheepuram,284,38,24,0,298,28493,38,3,0,28534,27803,433
25-12-2020,kanyakumari,164,14,24,0,154,16121,14,109,0,16244,15835,255
25-12-2020,karur,85,10,8,0,87,5050,10,46,0,5106,4970,49
25-12-2020,krishnagiri,85,23,13,0,95,7614,23,167,0,7804,7593,116
25-12-2020,madurai,221,30,27,0,224,20235,30,155,0,20420,19746,450
25-12-2020,nagapattinam,114,18,24,0,108,7941,18,88,0,8047,7812,127
25-12-2020,namakkal,183,26,23,0,186,10945,26,104,0,11075,10781,108
25-12-2020,nilgiris,141,13,20,1,133,7828,13,22,0,7863,7685,45
25-12-2020,perambalur,2,0,0,0,2,2251,0,2,0,2253,2230,21
25-12-2020,pudukottai,64,3,8,1,58,11328,3,33,0,11364,11151,155
25-12-2020,ramanathapuram,23,5,1,0,27,6162,5,133,0,6300,6141,132
25-12-2020,ranipet,64,7,4,0,67,15808,7,49,0,15864,15616,181
25-12-2020,salem,337,63,26,0,374,30868,63,419,0,31350,30520,456
25-12-2020,sivagangai,44,5,8,0,41,6408,5,68,0,6481,6314,126
25-12-2020,tenkasi,43,4,3,0,44,8175,4,49,0,8228,8026,158
25-12-2020,thanjavur,187,32,30,1,188,16948,32,22,0,17002,16581,233
25-12-2020,theni,78,12,16,0,74,16783,12,45,0,16840,16563,203
25-12-2020,thirupathur,24,3,2,0,25,7282,3,110,0,7395,7246,124
25-12-2020,thiruvallur,461,48,51,0,458,42344,48,10,0,42402,41272,672
25-12-2020,thiruvannamalai,110,10,8,0,112,18680,10,393,0,19083,18691,280
25-12-2020,thiruvarur,111,13,6,0,118,10807,13,37,0,10857,10630,109
25-12-2020,thoothukudi,89,10,12,0,87,15727,10,273,0,16010,15782,141
25-12-2020,tirunelveli,127,14,12,0,129,14784,14,420,0,15218,14878,211
25-12-2020,tiruppur,419,28,72,1,374,16779,28,11,0,16818,16229,215
25-12-2020,trichy,205,33,24,0,214,13977,33,33,0,14043,13656,173
25-12-2020,vellore,218,14,31,1,200,19790,14,305,0,20109,19569,340
25-12-2020,villupuram,85,11,9,0,87,14743,11,174,0,14928,14731,110
25-12-2020,virudhunagar,94,6,12,0,88,16157,6,104,0,16267,15951,228
25-12-2020,airport surveillance (international),3,0,0,0,3,0,0,929,0,929,925,1
25-12-2020,airport surveillance (domestic),8,0,0,0,8,0,0,1024,0,1024,1015,1
25-12-2020,railway surveillance,0,0,0,0,0,0,0,428,0,428,428,0
26-12-2020,ariyalur,9,2,1,0,10,4605,2,20,0,4627,4569,48
26-12-2020,chengalpattu,594,78,52,3,617,49627,78,5,0,49710,48353,740
26-12-2020,chennai,2933,295,272,5,2951,223756,295,43,0,224094,217155,3988
26-12-2020,coimbatore,914,93,135,2,870,51740,93,51,0,51884,50369,645
26-12-2020,cuddalore,96,12,5,0,103,24381,12,202,0,24595,24210,282
26-12-2020,dharmapuri,67,8,14,0,61,6128,8,214,0,6350,6236,53
26-12-2020,dindigul,144,20,22,0,142,10749,20,77,0,10846,10507,197
26-12-2020,erode,292,32,44,0,280,13385,32,94,0,13511,13088,143
26-12-2020,kallakurichi,18,4,3,0,19,10375,4,404,0,10783,10656,108
26-12-2020,kancheepuram,298,40,29,0,309,28531,40,3,0,28574,27832,433
26-12-2020,kanyakumari,154,8,25,0,137,16135,8,109,0,16252,15860,255
26-12-2020,karur,87,5,6,0,86,5060,5,46,0,5111,4976,49
26-12-2020,krishnagiri,95,22,11,0,106,7637,22,167,0,7826,7604,116
26-12-2020,madurai,224,18,35,0,207,20265,18,155,0,20438,19781,450
26-12-2020,nagapattinam,108,14,10,0,112,7959,14,88,0,8061,7822,127
26-12-2020,namakkal,186,25,28,0,183,10971,25,104,0,11100,10809,108
26-12-2020,nilgiris,133,11,19,0,125,7841,11,22,0,7874,7704,45
26-12-2020,perambalur,2,1,1,0,2,2251,1,2,0,2254,2231,21
26-12-2020,pudukottai,58,7,11,0,54,11331,7,33,0,11371,11162,155
26-12-2020,ramanathapuram,27,2,3,0,26,6167,2,133,0,6302,6144,132
26-12-2020,ranipet,67,8,14,0,61,15815,8,49,0,15872,15630,181
26-12-2020,salem,374,59,40,1,392,30931,59,419,0,31409,30560,457
26-12-2020,sivagangai,41,13,5,0,49,6413,13,68,0,6494,6319,126
26-12-2020,tenkasi,44,3,7,0,40,8179,3,49,0,8231,8033,158
26-12-2020,thanjavur,188,30,35,0,183,16980,30,22,0,17032,16616,233
26-12-2020,theni,74,10,12,0,72,16795,10,45,0,16850,16575,203
26-12-2020,thirupathur,25,4,4,0,25,7285,4,110,0,7399,7250,124
26-12-2020,thiruvallur,457,55,53,0,459,42392,55,10,0,42457,41325,673
26-12-2020,thiruvannamalai,112,7,14,0,105,18690,7,393,0,19090,18705,280
26-12-2020,thiruvarur,118,6,14,0,110,10820,6,37,0,10863,10644,109
26-12-2020,thoothukudi,87,8,15,0,80,15737,8,273,0,16018,15797,141
26-12-2020,tirunelveli,129,11,13,0,127,14798,11,420,0,15229,14891,211
26-12-2020,tiruppur,374,43,63,0,354,16807,43,11,0,16861,16292,215
26-12-2020,trichy,214,27,31,0,210,14010,27,33,0,14070,13687,173
26-12-2020,vellore,200,15,20,0,195,19804,15,305,0,20124,19589,340
26-12-2020,villupuram,87,13,13,0,87,14754,13,174,0,14941,14744,110
26-12-2020,virudhunagar,88,10,15,0,83,16163,10,104,0,16277,15966,228
26-12-2020,airport surveillance (international),3,0,0,0,3,0,0,929,0,929,925,1
26-12-2020,airport surveillance (domestic),8,0,4,0,4,0,0,1024,0,1024,1019,1
26-12-2020,railway surveillance,0,0,0,0,0,0,0,428,0,428,428,0
27-12-2020,ariyalur,9,3,1,0,11,4606,3,20,0,4629,4570,48
27-12-2020,chengalpattu,625,67,74,1,617,49713,67,5,0,49785,48427,741
27-12-2020,chennai,2953,290,384,5,2854,224053,290,43,0,224386,217539,3993
27-12-2020,coimbatore,872,94,109,0,857,51835,94,51,0,51980,50478,645
27-12-2020,cuddalore,103,15,4,0,114,24393,15,202,0,24610,24214,282
27-12-2020,dharmapuri,63,14,12,0,65,6138,14,214,0,6366,6248,53
27-12-2020,dindigul,144,18,18,0,144,10771,18,77,0,10866,10525,197
27-12-2020,erode,273,37,19,0,291,13410,37,94,0,13541,13107,143
27-12-2020,kallakurichi,19,6,2,0,23,10379,6,404,0,10789,10658,108
27-12-2020,kancheepuram,306,35,26,0,315,28568,35,3,0,28606,27858,433
27-12-2020,kanyakumari,137,14,17,1,133,16143,14,109,0,16266,15877,256
27-12-2020,karur,86,12,8,1,89,5065,12,46,0,5123,4984,50
27-12-2020,krishnagiri,106,12,9,0,109,7659,12,167,0,7838,7613,116
27-12-2020,madurai,204,17,27,0,194,20280,17,155,0,20452,19808,450
27-12-2020,nagapattinam,113,17,16,0,114,7974,17,88,0,8079,7838,127
27-12-2020,namakkal,187,18,21,0,184,11000,18,104,0,11122,10830,108
27-12-2020,nilgiris,125,12,17,0,120,7852,12,22,0,7886,7721,45
27-12-2020,perambalur,2,1,1,0,2,2252,1,2,0,2255,2232,21
27-12-2020,pudukottai,54,5,8,0,51,11338,5,33,0,11376,11170,155
27-12-2020,ramanathapuram,26,4,4,0,26,6169,4,133,0,6306,6148,132
27-12-2020,ranipet,62,9,11,0,60,15824,9,49,0,15882,15641,181
27-12-2020,salem,390,37,53,0,374,30988,37,419,0,31444,30613,457
27-12-2020,sivagangai,46,14,9,0,51,6423,14,68,0,6505,6328,126
27-12-2020,tenkasi,38,9,3,0,44,8180,9,49,0,8238,8036,158
27-12-2020,thanjavur,186,24,34,1,175,17013,24,22,0,17059,16650,234
27-12-2020,theni,72,7,9,0,70,16805,7,45,0,16857,16584,203
27-12-2020,thirupathur,30,10,3,0,37,7294,10,110,0,7414,7253,124
27-12-2020,thiruvallur,448,48,49,1,446,42436,48,10,0,42494,41374,674
27-12-2020,thiruvannamalai,105,12,7,0,110,18697,12,393,0,19102,18712,280
27-12-2020,thiruvarur,112,10,5,0,117,10828,10,37,0,10875,10649,109
27-12-2020,thoothukudi,82,6,16,0,72,15747,6,273,0,16026,15813,141
27-12-2020,tirunelveli,125,10,19,0,116,14807,10,420,0,15237,14910,211
27-12-2020,tiruppur,357,40,42,0,355,16853,40,11,0,16904,16334,215
27-12-2020,trichy,209,28,21,0,216,14036,28,33,0,14097,13708,173
27-12-2020,vellore,191,28,13,0,206,19815,25,305,3,20148,19602,340
27-12-2020,villupuram,88,10,7,0,91,14768,10,174,0,14952,14751,110
27-12-2020,virudhunagar,84,16,13,0,87,16174,16,104,0,16294,15979,228
27-12-2020,airport surveillance (international),3,0,0,0,3,0,0,929,0,929,925,1
27-12-2020,airport surveillance (domestic),4,0,0,0,4,0,0,1024,0,1024,1019,1
27-12-2020,railway surveillance,0,0,0,0,0,0,0,428,0,428,428,0
28-12-2020,ariyalur,11,2,1,0,12,4609,2,20,0,4631,4571,48
28-12-2020,chengalpattu,620,65,52,2,631,49783,65,5,0,49853,48479,743
28-12-2020,chennai,2855,285,363,3,2774,224344,285,43,0,224672,217902,3996
28-12-2020,coimbatore,858,93,103,1,847,51930,93,51,0,52074,50581,646
28-12-2020,cuddalore,115,16,14,0,117,24409,16,202,0,24627,24228,282
28-12-2020,dharmapuri,65,12,7,0,70,6152,12,214,0,6378,6255,53
28-12-2020,dindigul,145,24,21,0,148,10790,24,77,0,10891,10546,197
28-12-2020,erode,289,33,47,0,275,13445,33,94,0,13572,13154,143
28-12-2020,kallakurichi,24,5,5,0,24,10386,5,404,0,10795,10663,108
28-12-2020,kancheepuram,317,38,27,1,327,28605,38,3,0,28646,27885,434
28-12-2020,kanyakumari,133,23,11,0,145,16157,23,109,0,16289,15888,256
28-12-2020,karur,90,13,3,0,100,5078,13,46,0,5137,4987,50
28-12-2020,krishnagiri,109,9,12,0,106,7671,9,167,0,7847,7625,116
28-12-2020,madurai,193,20,22,1,190,20296,20,155,0,20471,19830,451
28-12-2020,nagapattinam,114,13,13,0,114,7991,13,88,0,8092,7851,127
28-12-2020,namakkal,176,26,23,0,179,11010,26,104,0,11140,10853,108
28-12-2020,nilgiris,120,16,19,0,117,7864,16,22,0,7902,7740,45
28-12-2020,perambalur,2,0,0,0,2,2253,0,2,0,2255,2232,21
28-12-2020,pudukottai,52,6,7,0,51,11344,6,33,0,11383,11177,155
28-12-2020,ramanathapuram,26,6,5,0,27,6173,6,133,0,6312,6153,132
28-12-2020,ranipet,59,7,15,0,51,15832,7,49,0,15888,15656,181
28-12-2020,salem,380,39,51,0,368,31031,39,419,0,31489,30664,457
28-12-2020,sivagangai,51,10,1,0,60,6437,10,68,0,6515,6329,126
28-12-2020,tenkasi,45,11,7,0,49,8190,11,49,0,8250,8043,158
28-12-2020,thanjavur,170,30,10,0,190,17032,30,22,0,17084,16660,234
28-12-2020,theni,71,8,6,0,73,16813,8,45,0,16866,16590,203
28-12-2020,thirupathur,37,6,2,0,41,7304,6,110,0,7420,7255,124
28-12-2020,thiruvallur,447,44,51,3,437,42485,44,10,0,42539,41425,677
28-12-2020,thiruvannamalai,110,8,11,0,107,18709,8,393,0,19110,18723,280
28-12-2020,thiruvarur,117,11,10,0,118,10838,11,37,0,10886,10659,109
28-12-2020,thoothukudi,72,14,10,0,76,15753,14,273,0,16040,15823,141
28-12-2020,tirunelveli,115,8,11,0,112,14816,8,420,0,15244,14921,211
28-12-2020,tiruppur,356,41,49,0,348,16894,41,11,0,16946,16383,215
28-12-2020,trichy,216,23,35,0,204,14064,23,33,0,14120,13743,173
28-12-2020,vellore,205,18,21,0,202,19839,18,308,0,20165,19623,340
28-12-2020,villupuram,88,13,10,0,91,14775,13,174,0,14962,14761,110
28-12-2020,virudhunagar,87,9,17,0,79,16190,9,104,0,16303,15996,228
28-12-2020,airport surveillance (international),3,0,0,0,3,0,0,929,0,929,925,1
28-12-2020,airport surveillance (domestic),4,0,2,0,2,0,0,1024,0,1024,1021,1
28-12-2020,railway surveillance,0,0,0,0,0,0,0,428,0,428,428,0
29-12-2020,ariyalur,12,0,1,0,11,4611,0,20,0,4631,4572,48
29-12-2020,chengalpattu,631,47,69,0,609,49848,47,5,0,49900,48548,743
29-12-2020,chennai,2775,286,348,2,2711,224629,286,43,0,224958,218250,3997
29-12-2020,coimbatore,847,81,92,2,834,52023,81,51,0,52155,50673,648
29-12-2020,cuddalore,117,15,11,1,120,24425,15,202,0,24642,24239,283
29-12-2020,dharmapuri,70,9,4,0,75,6164,9,214,0,6387,6259,53
29-12-2020,dindigul,148,16,17,0,147,10814,16,77,0,10907,10563,197
29-12-2020,erode,275,34,36,1,272,13478,34,94,0,13606,13190,144
29-12-2020,kallakurichi,24,3,1,0,26,10391,3,404,0,10798,10664,108
29-12-2020,kancheepuram,327,25,32,0,320,28643,25,3,0,28671,27917,434
29-12-2020,kanyakumari,145,10,18,0,137,16180,10,109,0,16299,15906,256
29-12-2020,karur,100,12,17,0,95,5091,12,46,0,5149,5004,50
29-12-2020,krishnagiri,106,12,8,0,110,7680,12,167,0,7859,7633,116
29-12-2020,madurai,190,26,29,1,186,20316,25,155,1,20497,19859,452
29-12-2020,nagapattinam,114,22,10,0,126,8004,22,88,0,8114,7861,127
29-12-2020,namakkal,179,19,31,1,166,11036,19,104,0,11159,10884,109
29-12-2020,nilgiris,117,15,16,0,116,7880,15,22,0,7917,7756,45
29-12-2020,perambalur,2,0,1,0,1,2253,0,2,0,2255,2233,21
29-12-2020,pudukottai,51,11,11,0,51,11350,11,33,0,11394,11188,155
29-12-2020,ramanathapuram,27,3,3,0,27,6179,3,133,0,6315,6156,132
29-12-2020,ranipet,51,8,5,0,54,15839,8,49,0,15896,15661,181
29-12-2020,salem,368,34,38,0,364,31070,34,419,0,31523,30702,457
29-12-2020,sivagangai,60,8,4,0,64,6447,8,68,0,6523,6333,126
29-12-2020,tenkasi,49,9,6,0,52,8201,9,49,0,8259,8049,158
29-12-2020,thanjavur,189,32,16,1,204,17062,32,22,0,17116,16676,236
29-12-2020,theni,73,14,9,0,78,16821,14,45,0,16880,16599,203
29-12-2020,thirupathur,41,11,4,0,48,7310,11,110,0,7431,7259,124
29-12-2020,thiruvallur,437,47,58,0,426,42529,47,10,0,42586,41483,677
29-12-2020,thiruvannamalai,107,14,13,0,108,18717,14,393,0,19124,18736,280
29-12-2020,thiruvarur,118,12,19,0,111,10849,12,37,0,10898,10678,109
29-12-2020,thoothukudi,76,8,6,0,78,15767,8,273,0,16048,15829,141
29-12-2020,tirunelveli,112,18,12,0,118,14824,18,420,0,15262,14933,211
29-12-2020,tiruppur,348,38,54,0,332,16935,38,11,0,16984,16437,215
29-12-2020,trichy,204,22,21,3,202,14087,22,33,0,14142,13764,176
29-12-2020,vellore,202,14,33,0,183,19857,13,308,1,20179,19656,340
29-12-2020,villupuram,91,8,7,0,92,14788,8,174,0,14970,14768,110
29-12-2020,virudhunagar,79,14,5,0,88,16199,14,104,0,16317,16001,228
29-12-2020,airport surveillance (international),3,0,0,0,3,0,0,929,0,929,925,1
29-12-2020,airport surveillance (domestic),2,0,0,0,2,0,0,1024,0,1024,1021,1
29-12-2020,railway surveillance,0,0,0,0,0,0,0,428,0,428,428,0
30-12-2020,ariyalur,11,1,1,0,11,4611,1,20,0,4632,4573,48
30-12-2020,chengalpattu,617,48,82,0,583,49903,48,5,0,49956,48630,743
30-12-2020,chennai,2730,275,320,7,2678,224934,275,43,0,225252,218570,4004
30-12-2020,coimbatore,835,91,101,4,821,52105,91,51,0,52247,50774,652
30-12-2020,cuddalore,120,20,13,0,127,24440,20,202,0,24662,24252,283
30-12-2020,dharmapuri,75,17,9,0,83,6173,17,214,0,6404,6268,53
30-12-2020,dindigul,146,20,13,0,153,10829,20,77,0,10926,10576,197
30-12-2020,erode,270,32,38,0,264,13510,32,94,0,13636,13228,144
30-12-2020,kallakurichi,24,1,6,0,19,10392,1,404,0,10797,10670,108
30-12-2020,kancheepuram,309,37,48,0,298,28657,37,3,0,28697,27965,434
30-12-2020,kanyakumari,135,18,25,0,128,16188,18,109,0,16315,15931,256
30-12-2020,karur,95,16,19,0,92,5103,16,46,0,5165,5023,50
30-12-2020,krishnagiri,110,8,8,0,110,7692,8,167,0,7867,7641,116
30-12-2020,madurai,186,22,31,0,177,20341,22,156,0,20519,19890,452
30-12-2020,nagapattinam,126,15,21,0,120,8026,15,88,0,8129,7882,127
30-12-2020,namakkal,166,30,15,0,181,11055,30,104,0,11189,10899,109
30-12-2020,nilgiris,116,13,15,1,113,7895,13,22,0,7930,7771,46
30-12-2020,perambalur,1,1,0,0,2,2253,1,2,0,2256,2233,21
30-12-2020,pudukottai,51,3,3,0,51,11361,3,33,0,11397,11191,155
30-12-2020,ramanathapuram,28,2,2,0,28,6183,2,133,0,6318,6158,132
30-12-2020,ranipet,55,6,5,0,56,15848,6,49,0,15903,15666,181
30-12-2020,salem,364,24,40,0,348,31104,24,419,0,31547,30742,457
30-12-2020,sivagangai,64,9,4,0,69,6455,9,68,0,6532,6337,126
30-12-2020,tenkasi,52,2,3,0,51,8210,2,49,0,8261,8052,158
30-12-2020,thanjavur,202,27,14,0,215,17092,27,22,0,17141,16690,236
30-12-2020,theni,78,9,15,1,71,16835,9,45,0,16889,16614,204
30-12-2020,thirupathur,49,4,4,1,48,7322,4,110,0,7436,7263,125
30-12-2020,thiruvallur,414,35,48,1,400,42564,35,10,0,42609,41531,678
30-12-2020,thiruvannamalai,108,11,27,1,91,18731,11,393,0,19135,18763,281
30-12-2020,thiruvarur,114,22,16,0,120,10864,22,37,0,10923,10694,109
30-12-2020,thoothukudi,78,13,11,0,80,15775,13,273,0,16061,15840,141
30-12-2020,tirunelveli,118,20,8,0,130,14842,20,420,0,15282,14941,211
30-12-2020,tiruppur,333,32,45,1,319,16974,32,11,0,17017,16482,216
30-12-2020,trichy,201,21,19,0,203,14108,20,33,1,14162,13783,176
30-12-2020,vellore,180,16,21,0,175,19867,16,309,0,20192,19677,340
30-12-2020,villupuram,93,10,6,0,97,14797,10,174,0,14981,14774,110
30-12-2020,virudhunagar,88,12,4,0,96,16213,12,104,0,16329,16005,228
30-12-2020,airport surveillance (international),3,0,0,0,3,0,0,929,0,929,925,1
30-12-2020,airport surveillance (domestic),2,2,0,0,4,0,0,1024,2,1026,1021,1
30-12-2020,railway surveillance,0,0,0,0,0,0,0,428,0,428,428,0
31-12-2020,ariyalur,11,2,1,0,12,4612,2,20,0,4634,4574,48
31-12-2020,chengalpattu,603,53,68,0,588,49971,53,5,0,50029,48698,743
31-12-2020,chennai,2674,259,312,4,2617,225205,259,43,0,225507,218882,4008
31-12-2020,coimbatore,821,89,95,1,814,52196,89,51,0,52336,50869,653
31-12-2020,cuddalore,127,19,11,0,135,24460,19,202,0,24681,24263,283
31-12-2020,dharmapuri,83,8,8,0,83,6190,8,214,0,6412,6276,53
31-12-2020,dindigul,153,19,15,0,157,10849,19,77,0,10945,10591,197
31-12-2020,erode,265,42,36,0,271,13543,42,94,0,13679,13264,144
31-12-2020,kallakurichi,19,3,4,0,18,10393,3,404,0,10800,10674,108
31-12-2020,kancheepuram,279,25,46,0,258,28675,25,3,0,28703,28011,434
31-12-2020,kanyakumari,128,24,23,0,129,16206,24,109,0,16339,15954,256
31-12-2020,karur,91,6,16,0,81,5118,6,46,0,5170,5039,50
31-12-2020,krishnagiri,112,9,7,0,114,7702,9,167,0,7878,7648,116
31-12-2020,madurai,176,14,28,1,161,20362,13,156,1,20532,19918,453
31-12-2020,nagapattinam,120,22,18,1,123,8041,22,88,0,8151,7900,128
31-12-2020,namakkal,178,17,18,0,177,11082,17,104,0,11203,10917,109
31-12-2020,nilgiris,113,15,14,0,114,7908,15,22,0,7945,7785,46
31-12-2020,perambalur,2,0,0,0,2,2254,0,2,0,2256,2233,21
31-12-2020,pudukottai,51,7,4,0,54,11364,7,33,0,11404,11195,155
31-12-2020,ramanathapuram,28,4,3,0,29,6185,4,133,0,6322,6161,132
31-12-2020,ranipet,57,7,6,0,58,15855,7,49,0,15911,15672,181
31-12-2020,salem,349,38,41,2,344,31129,38,419,0,31586,30783,459
31-12-2020,sivagangai,69,3,7,0,65,6464,3,68,0,6535,6344,126
31-12-2020,tenkasi,50,3,4,0,49,8211,3,49,0,8263,8056,158
31-12-2020,thanjavur,215,37,13,1,238,17119,37,22,0,17178,16703,237
31-12-2020,theni,70,7,17,0,60,16843,7,45,0,16895,16631,204
31-12-2020,thirupathur,48,8,5,0,51,7326,8,110,0,7444,7268,125
31-12-2020,thiruvallur,400,41,53,1,387,42599,41,10,0,42650,41584,679
31-12-2020,thiruvannamalai,92,11,26,0,77,18743,11,393,0,19147,18789,281
31-12-2020,thiruvarur,120,9,16,0,113,10886,9,37,0,10932,10710,109
31-12-2020,thoothukudi,81,10,12,0,79,15789,10,273,0,16072,15852,141
31-12-2020,tirunelveli,130,12,11,0,131,14862,12,420,0,15294,14952,211
31-12-2020,tiruppur,321,36,48,1,308,17008,36,11,0,17055,16530,217
31-12-2020,trichy,202,22,20,0,204,14127,22,34,0,14183,13803,176
31-12-2020,vellore,175,28,19,0,184,19883,23,309,5,20220,19696,340
31-12-2020,villupuram,97,14,7,0,104,14807,14,174,0,14995,14781,110
31-12-2020,virudhunagar,98,13,6,1,104,16227,13,104,0,16344,16011,229
31-12-2020,airport surveillance (international),3,1,0,0,4,0,0,929,1,930,925,1
31-12-2020,airport surveillance (domestic),4,0,0,0,4,0,0,1026,0,1026,1021,1
31-12-2020,railway surveillance,0,0,0,0,0,0,0,428,0,428,428,0
01-01-2021,ariyalur,12,3,1,0,14,4614,3,20,0,4637,4575,48
01-01-2021,chengalpattu,595,54,66,1,582,50031,54,5,0,50090,48764,744
01-01-2021,chennai,2616,252,334,6,2528,225463,252,43,0,225758,219216,4014
01-01-2021,coimbatore,814,82,97,1,798,52285,82,51,0,52418,50966,654
01-01-2021,cuddalore,135,14,14,0,135,24479,14,202,0,24695,24277,283
01-01-2021,dharmapuri,83,11,6,0,88,6198,11,214,0,6423,6282,53
01-01-2021,dindigul,157,16,19,0,154,10868,16,77,0,10961,10610,197
01-01-2021,erode,269,44,24,0,289,13583,44,94,0,13721,13288,144
01-01-2021,kallakurichi,18,2,3,0,17,10396,2,404,0,10802,10677,108
01-01-2021,kancheepuram,255,32,30,0,257,28697,32,3,0,28732,28041,434
01-01-2021,kanyakumari,130,25,15,0,140,16231,25,109,0,16365,15969,256
01-01-2021,karur,81,7,11,0,77,5124,7,46,0,5177,5050,50
01-01-2021,krishnagiri,114,7,20,0,101,7711,7,167,0,7885,7668,116
01-01-2021,madurai,159,18,21,0,156,20373,18,157,0,20548,19939,453
01-01-2021,nagapattinam,126,10,4,0,132,8066,10,88,0,8164,7904,128
01-01-2021,namakkal,178,24,16,0,186,11100,24,104,0,11228,10933,109
01-01-2021,nilgiris,114,11,9,0,116,7923,11,22,0,7956,7794,46
01-01-2021,perambalur,3,0,0,0,3,2255,0,2,0,2257,2233,21
01-01-2021,pudukottai,54,8,3,0,59,11371,8,33,0,11412,11198,155
01-01-2021,ramanathapuram,29,2,4,1,26,6189,2,133,0,6324,6165,133
01-01-2021,ranipet,57,9,8,0,58,15861,9,49,0,15919,15680,181
01-01-2021,salem,344,40,40,2,342,31167,40,419,0,31626,30823,461
01-01-2021,sivagangai,65,4,2,0,67,6467,4,68,0,6539,6346,126
01-01-2021,tenkasi,49,9,8,0,50,8214,9,49,0,8272,8064,158
01-01-2021,thanjavur,239,22,24,1,236,17157,22,22,0,17201,16727,238
01-01-2021,theni,61,6,6,0,61,16851,6,45,0,16902,16637,204
01-01-2021,thirupathur,51,6,5,0,52,7334,6,110,0,7450,7273,125
01-01-2021,thiruvallur,379,40,49,0,370,42632,40,10,0,42682,41633,679
01-01-2021,thiruvannamalai,78,12,16,1,73,18755,12,393,0,19160,18805,282
01-01-2021,thiruvarur,109,14,23,0,100,10891,14,37,0,10942,10733,109
01-01-2021,thoothukudi,79,12,9,0,82,15799,12,273,0,16084,15861,141
01-01-2021,tirunelveli,130,10,19,0,121,14873,10,420,0,15303,14971,211
01-01-2021,tiruppur,309,46,51,0,304,17045,46,11,0,17102,16581,217
01-01-2021,trichy,204,20,23,0,201,14149,20,34,0,14203,13826,176
01-01-2021,vellore,185,22,24,0,183,19907,21,314,1,20243,19720,340
01-01-2021,villupuram,106,15,10,0,111,14823,15,174,0,15012,14791,110
01-01-2021,virudhunagar,106,12,14,0,104,16242,12,104,0,16358,16025,229
01-01-2021,airport surveillance (international),4,0,0,0,4,0,0,930,0,930,925,1
01-01-2021,airport surveillance (domestic),4,0,1,0,3,0,0,1026,0,1026,1022,1
01-01-2021,railway surveillance,0,0,0,0,0,0,0,428,0,428,428,0
02-01-2021,ariyalur,10,0,2,0,8,4613,0,20,0,4633,4577,48
02-01-2021,chengalpattu,587,64,76,0,575,50090,64,5,0,50159,48840,744
02-01-2021,chennai,2522,246,302,4,2462,225709,244,43,2,225998,219518,4018
02-01-2021,coimbatore,798,78,97,0,779,52367,78,51,0,52496,51063,654
02-01-2021,cuddalore,135,12,15,0,132,24493,12,202,0,24707,24292,283
02-01-2021,dharmapuri,87,13,8,0,92,6208,13,214,0,6435,6290,53
02-01-2021,dindigul,155,19,21,0,153,10885,19,77,0,10981,10631,197
02-01-2021,erode,288,36,25,0,299,13626,36,94,0,13756,13313,144
02-01-2021,kallakurichi,17,0,2,0,15,10398,0,404,0,10802,10679,108
02-01-2021,kancheepuram,253,34,24,0,263,28725,34,3,0,28762,28065,434
02-01-2021,kanyakumari,140,22,11,0,151,16256,22,109,0,16387,15980,256
02-01-2021,karur,78,13,5,0,86,5132,13,46,0,5191,5055,50
02-01-2021,krishnagiri,100,5,24,0,81,7717,5,167,0,7889,7692,116
02-01-2021,madurai,158,23,20,0,161,20393,23,157,0,20573,19959,453
02-01-2021,nagapattinam,132,18,13,3,134,8076,18,88,0,8182,7917,131
02-01-2021,namakkal,187,21,18,0,190,11125,21,104,0,11250,10951,109
02-01-2021,nilgiris,116,12,13,0,115,7934,12,22,0,7968,7807,46
02-01-2021,perambalur,4,0,0,0,4,2256,0,2,0,2258,2233,21
02-01-2021,pudukottai,59,7,5,0,61,11379,7,33,0,11419,11203,155
02-01-2021,ramanathapuram,26,4,2,1,27,6191,4,133,0,6328,6167,134
02-01-2021,ranipet,59,7,11,0,55,15871,7,49,0,15927,15691,181
02-01-2021,salem,342,31,41,1,331,31207,31,419,0,31657,30864,462
02-01-2021,sivagangai,67,4,6,0,65,6471,4,68,0,6543,6352,126
02-01-2021,tenkasi,48,7,6,0,49,8221,7,49,0,8277,8070,158
02-01-2021,thanjavur,236,35,27,0,244,17179,35,22,0,17236,16754,238
02-01-2021,theni,60,13,2,0,71,16856,13,45,0,16914,16639,204
02-01-2021,thirupathur,53,13,2,0,64,7341,13,110,0,7464,7275,125
02-01-2021,thiruvallur,373,43,55,0,361,42675,43,10,0,42728,41688,679
02-01-2021,thiruvannamalai,74,8,13,0,69,18768,8,393,0,19169,18818,282
02-01-2021,thiruvarur,99,7,16,0,90,10904,7,37,0,10948,10749,109
02-01-2021,thoothukudi,83,7,6,0,84,15812,7,273,0,16092,15867,141
02-01-2021,tirunelveli,121,11,14,0,118,14883,11,420,0,15314,14985,211
02-01-2021,tiruppur,304,42,52,2,292,17091,42,11,0,17144,16633,219
02-01-2021,trichy,202,17,26,0,193,14170,17,34,0,14221,13852,176
02-01-2021,vellore,183,23,21,0,185,19928,20,315,3,20266,19741,340
02-01-2021,villupuram,113,9,13,0,109,14840,9,174,0,15023,14804,110
02-01-2021,virudhunagar,104,6,13,0,97,16254,6,104,0,16364,16038,229
02-01-2021,airport surveillance (international),4,0,0,0,4,0,0,930,0,930,925,1
02-01-2021,airport surveillance (domestic),3,0,0,0,3,0,0,1026,0,1026,1022,1
02-01-2021,railway surveillance,0,0,0,0,0,0,0,428,0,428,428,0
03-01-2021,ariyalur,8,0,3,0,5,4613,0,20,0,4633,4580,48
03-01-2021,chengalpattu,575,49,96,0,528,50154,49,5,0,50208,48936,744
03-01-2021,chennai,2462,236,287,5,2406,225953,236,45,0,226234,219805,4023
03-01-2021,coimbatore,779,69,94,1,753,52445,69,51,0,52565,51157,655
03-01-2021,cuddalore,132,13,13,0,132,24505,13,202,0,24720,24305,283
03-01-2021,dharmapuri,92,8,6,1,93,6221,8,214,0,6443,6296,54
03-01-2021,dindigul,153,8,16,0,145,10904,8,77,0,10989,10647,197
03-01-2021,erode,299,39,29,0,309,13662,39,94,0,13795,13342,144
03-01-2021,kallakurichi,15,6,1,0,20,10398,6,404,0,10808,10680,108
03-01-2021,kancheepuram,263,32,28,0,267,28759,32,3,0,28794,28093,434
03-01-2021,kanyakumari,151,20,12,0,159,16278,20,109,0,16407,15992,256
03-01-2021,karur,86,16,11,0,91,5145,16,46,0,5207,5066,50
03-01-2021,krishnagiri,81,8,14,0,75,7722,8,167,0,7897,7706,116
03-01-2021,madurai,161,19,17,0,163,20416,19,157,0,20592,19976,453
03-01-2021,nagapattinam,134,10,15,0,129,8094,10,88,0,8192,7932,131
03-01-2021,namakkal,190,16,26,0,180,11146,16,104,0,11266,10977,109
03-01-2021,nilgiris,115,8,13,0,110,7946,8,22,0,7976,7820,46
03-01-2021,perambalur,4,0,1,0,3,2256,0,2,0,2258,2234,21
03-01-2021,pudukottai,61,6,7,0,60,11386,6,33,0,11425,11210,155
03-01-2021,ramanathapuram,27,6,1,0,32,6195,6,133,0,6334,6168,134
03-01-2021,ranipet,55,8,6,1,56,15878,8,49,0,15935,15697,182
03-01-2021,salem,331,46,56,0,321,31238,46,419,0,31703,30920,462
03-01-2021,sivagangai,65,3,10,0,58,6475,3,68,0,6546,6362,126
03-01-2021,tenkasi,49,8,1,0,56,8228,8,49,0,8285,8071,158
03-01-2021,thanjavur,244,23,22,0,245,17214,23,22,0,17259,16776,238
03-01-2021,theni,71,8,3,0,76,16869,8,45,0,16922,16642,204
03-01-2021,thirupathur,64,9,4,0,69,7354,9,110,0,7473,7279,125
03-01-2021,thiruvallur,361,45,58,1,347,42718,45,10,0,42773,41746,680
03-01-2021,thiruvannamalai,69,12,6,1,74,18776,12,393,0,19181,18824,283
03-01-2021,thiruvarur,90,10,5,0,95,10911,10,37,0,10958,10754,109
03-01-2021,thoothukudi,84,9,6,0,87,15819,9,273,0,16101,15873,141
03-01-2021,tirunelveli,118,14,22,0,110,14894,14,420,0,15328,15007,211
03-01-2021,tiruppur,292,26,35,0,283,17133,26,11,0,17170,16668,219
03-01-2021,trichy,193,27,24,0,196,14187,27,34,0,14248,13876,176
03-01-2021,vellore,185,17,26,0,176,19948,14,318,3,20283,19767,340
03-01-2021,villupuram,109,12,17,0,104,14849,12,174,0,15035,14821,110
03-01-2021,virudhunagar,97,21,11,0,107,16260,21,104,0,16385,16049,229
03-01-2021,airport surveillance (international),4,0,0,0,4,0,0,930,0,930,925,1
03-01-2021,airport surveillance (domestic),3,0,0,0,3,0,0,1026,0,1026,1022,1
03-01-2021,railway surveillance,0,0,0,0,0,0,0,428,0,428,428,0
04-01-2021,ariyalur,6,3,1,0,8,4614,3,20,0,4637,4581,48
04-01-2021,chengalpattu,537,43,98,2,480,50212,43,5,0,50260,49034,746
04-01-2021,chennai,2399,229,267,2,2359,226182,228,45,1,226456,220072,4025
04-01-2021,coimbatore,754,83,94,1,742,52515,83,51,0,52649,51251,656
04-01-2021,cuddalore,132,10,6,0,136,24518,10,202,0,24730,24311,283
04-01-2021,dharmapuri,95,6,11,0,90,6231,6,214,0,6451,6307,54
04-01-2021,dindigul,146,12,19,0,139,10913,12,77,0,11002,10666,197
04-01-2021,erode,305,29,37,1,296,13697,29,94,0,13820,13379,145
04-01-2021,kallakurichi,20,7,5,0,22,10404,7,404,0,10815,10685,108
04-01-2021,kancheepuram,264,27,31,0,260,28788,27,3,0,28818,28124,434
04-01-2021,kanyakumari,160,23,9,0,174,16299,23,109,0,16431,16001,256
04-01-2021,karur,94,15,12,0,97,5164,15,46,0,5225,5078,50
04-01-2021,krishnagiri,76,6,15,1,66,7731,6,167,0,7904,7721,117
04-01-2021,madurai,162,21,20,0,163,20434,21,157,0,20612,19996,453
04-01-2021,nagapattinam,129,19,13,0,135,8104,19,88,0,8211,7945,131
04-01-2021,namakkal,168,18,18,0,168,11150,17,104,1,11272,10995,109
04-01-2021,nilgiris,110,17,19,0,108,7954,17,22,0,7993,7839,46
04-01-2021,perambalur,2,0,0,0,2,2255,0,2,0,2257,2234,21
04-01-2021,pudukottai,60,5,11,0,54,11392,5,33,0,11430,11221,155
04-01-2021,ramanathapuram,32,4,5,0,31,6201,4,133,0,6338,6173,134
04-01-2021,ranipet,56,9,5,0,60,15886,9,49,0,15944,15702,182
04-01-2021,salem,329,31,46,1,313,31292,31,419,0,31742,30966,463
04-01-2021,sivagangai,58,5,11,0,52,6478,5,68,0,6551,6373,126
04-01-2021,tenkasi,56,6,5,0,57,8236,6,49,0,8291,8076,158
04-01-2021,thanjavur,246,19,28,1,236,17238,19,22,0,17279,16804,239
04-01-2021,theni,77,10,6,0,81,16878,10,45,0,16933,16648,204
04-01-2021,thirupathur,68,6,9,0,65,7362,6,110,0,7478,7288,125
04-01-2021,thiruvallur,342,41,52,0,331,42758,41,10,0,42809,41798,680
04-01-2021,thiruvannamalai,76,9,5,0,80,18790,9,393,0,19192,18829,283
04-01-2021,thiruvarur,97,12,7,0,102,10923,12,37,0,10972,10761,109
04-01-2021,thoothukudi,88,8,9,0,87,15829,8,273,0,16110,15882,141
04-01-2021,tirunelveli,109,10,8,1,110,14907,10,420,0,15337,15015,212
04-01-2021,tiruppur,285,38,31,0,292,17161,38,11,0,17210,16699,219
04-01-2021,trichy,194,17,22,0,189,14212,17,34,0,14263,13898,176
04-01-2021,vellore,176,15,25,0,166,19962,14,321,1,20298,19792,340
04-01-2021,villupuram,105,11,9,0,107,14862,11,174,0,15047,14830,110
04-01-2021,virudhunagar,107,14,16,0,105,16281,14,104,0,16399,16065,229
04-01-2021,airport surveillance (international),4,0,0,0,4,0,0,930,0,930,925,1
04-01-2021,airport surveillance (domestic),3,0,0,0,3,0,0,1026,0,1026,1022,1
04-01-2021,railway surveillance,0,0,0,0,0,0,0,428,0,428,428,0
05-01-2021,ariyalur,10,3,2,0,11,4619,3,20,0,4642,4583,48
05-01-2021,chengalpattu,484,55,91,1,447,50259,55,5,0,50319,49125,747
05-01-2021,chennai,2368,235,256,5,2342,226419,235,46,0,226700,220328,4030
05-01-2021,coimbatore,744,81,86,1,738,52600,81,51,0,52732,51337,657
05-01-2021,cuddalore,137,14,11,0,140,24529,14,202,0,24745,24322,283
05-01-2021,dharmapuri,90,12,6,0,96,6237,12,214,0,6463,6313,54
05-01-2021,dindigul,138,11,20,0,129,10924,11,77,0,11012,10686,197
05-01-2021,erode,296,31,32,0,295,13726,31,94,0,13851,13411,145
05-01-2021,kallakurichi,22,5,2,0,25,10411,5,404,0,10820,10687,108
05-01-2021,kancheepuram,250,29,30,0,249,28805,29,3,0,28837,28154,434
05-01-2021,kanyakumari,175,21,16,0,180,16323,21,109,0,16453,16017,256
05-01-2021,karur,97,10,7,0,100,5179,10,46,0,5235,5085,50
05-01-2021,krishnagiri,66,9,14,0,61,7737,9,167,0,7913,7735,117
05-01-2021,madurai,163,15,16,2,160,20455,15,157,0,20627,20012,455
05-01-2021,nagapattinam,136,8,15,0,129,8124,8,88,0,8220,7960,131
05-01-2021,namakkal,169,22,17,1,173,11168,22,105,0,11295,11012,110
05-01-2021,nilgiris,108,9,15,0,102,7971,9,22,0,8002,7854,46
05-01-2021,perambalur,2,1,0,0,3,2255,1,2,0,2258,2234,21
05-01-2021,pudukottai,54,6,5,0,55,11397,6,33,0,11436,11226,155
05-01-2021,ramanathapuram,31,3,4,0,30,6205,3,133,0,6341,6177,134
05-01-2021,ranipet,60,10,3,0,67,15895,10,49,0,15954,15705,182
05-01-2021,salem,312,30,47,1,294,31322,30,419,0,31771,31013,464
05-01-2021,sivagangai,51,7,6,0,52,6482,7,68,0,6557,6379,126
05-01-2021,tenkasi,57,7,10,0,54,8242,7,49,0,8298,8086,158
05-01-2021,thanjavur,233,11,36,0,208,17254,11,22,0,17287,16840,239
05-01-2021,theni,80,5,12,0,73,16887,5,45,0,16937,16660,204
05-01-2021,thirupathur,65,4,7,0,62,7368,4,110,0,7482,7295,125
05-01-2021,thiruvallur,327,44,54,0,317,42795,44,10,0,42849,41852,680
05-01-2021,thiruvannamalai,80,11,6,0,85,18799,11,393,0,19203,18835,283
05-01-2021,thiruvarur,103,9,15,0,97,10936,9,37,0,10982,10776,109
05-01-2021,thoothukudi,87,12,8,0,91,15837,12,273,0,16122,15890,141
05-01-2021,tirunelveli,108,9,9,0,108,14915,9,420,0,15344,15024,212
05-01-2021,tiruppur,292,27,32,0,287,17199,27,11,0,17237,16731,219
05-01-2021,trichy,189,27,29,0,187,14229,27,34,0,14290,13927,176
05-01-2021,vellore,167,10,24,0,153,19977,10,322,0,20309,19816,340
05-01-2021,villupuram,107,8,16,0,99,14873,8,174,0,15055,14846,110
05-01-2021,virudhunagar,105,9,12,0,102,16295,9,104,0,16408,16077,229
05-01-2021,airport surveillance (international),4,0,0,0,4,0,0,930,0,930,925,1
05-01-2021,airport surveillance (domestic),3,0,0,0,3,0,0,1026,0,1026,1022,1
05-01-2021,railway surveillance,0,0,0,0,0,0,0,428,0,428,428,0
06-01-2021,ariyalur,9,4,1,1,11,4620,4,20,0,4644,4584,49
06-01-2021,chengalpattu,443,47,75,2,413,50310,47,5,0,50362,49200,749
06-01-2021,chennai,2351,228,247,5,2327,226663,228,46,0,226937,220575,4035
06-01-2021,coimbatore,740,87,81,1,745,52683,87,51,0,52821,51418,658
06-01-2021,cuddalore,140,16,19,0,137,24543,16,202,0,24761,24341,283
06-01-2021,dharmapuri,96,8,18,0,86,6249,8,214,0,6471,6331,54
06-01-2021,dindigul,129,7,23,0,113,10935,7,77,0,11019,10709,197
06-01-2021,erode,295,29,39,0,285,13757,29,94,0,13880,13450,145
06-01-2021,kallakurichi,25,2,2,0,25,10416,2,404,0,10822,10689,108
06-01-2021,kancheepuram,243,27,25,0,245,28828,27,3,0,28858,28179,434
06-01-2021,kanyakumari,180,13,21,1,171,16344,13,109,0,16466,16038,257
06-01-2021,karur,101,12,14,0,99,5190,12,46,0,5248,5099,50
06-01-2021,krishnagiri,61,8,7,0,62,7746,7,167,1,7921,7742,117
06-01-2021,madurai,158,20,16,0,162,20468,20,157,0,20645,20028,455
06-01-2021,nagapattinam,130,10,12,0,128,8133,10,88,0,8231,7972,131
06-01-2021,namakkal,173,14,22,0,165,11190,14,105,0,11309,11034,110
06-01-2021,nilgiris,102,10,7,0,105,7980,10,22,0,8012,7861,46
06-01-2021,perambalur,3,0,1,0,2,2256,0,2,0,2258,2235,21
06-01-2021,pudukottai,55,3,7,0,51,11403,3,33,0,11439,11233,155
06-01-2021,ramanathapuram,31,4,6,0,29,6209,4,133,0,6346,6183,134
06-01-2021,ranipet,67,18,7,1,77,15905,18,49,0,15972,15712,183
06-01-2021,salem,294,44,37,0,301,31352,43,419,1,31815,31050,464
06-01-2021,sivagangai,52,3,11,0,44,6489,3,68,0,6560,6390,126
06-01-2021,tenkasi,56,3,13,0,46,8251,3,49,0,8303,8099,158
06-01-2021,thanjavur,208,13,32,0,189,17265,13,22,0,17300,16872,239
06-01-2021,theni,74,4,8,0,70,16893,4,45,0,16942,16668,204
06-01-2021,thirupathur,63,5,6,0,62,7373,5,110,0,7488,7301,125
06-01-2021,thiruvallur,316,36,43,0,309,42838,36,10,0,42884,41895,680
06-01-2021,thiruvannamalai,85,9,8,0,86,18810,9,393,0,19212,18843,283
06-01-2021,thiruvarur,97,10,11,0,96,10945,10,37,0,10992,10787,109
06-01-2021,thoothukudi,91,10,9,0,92,15849,10,273,0,16132,15899,141
06-01-2021,tirunelveli,106,18,11,0,113,14922,18,420,0,15360,15035,212
06-01-2021,tiruppur,287,28,37,0,278,17226,28,11,0,17265,16768,219
06-01-2021,trichy,187,20,26,0,181,14256,20,34,0,14310,13953,176
06-01-2021,vellore,151,32,15,0,168,19985,27,322,5,20339,19831,340
06-01-2021,villupuram,99,3,15,0,87,14881,3,174,0,15058,14861,110
06-01-2021,virudhunagar,103,6,11,0,98,16305,6,104,0,16415,16088,229
06-01-2021,airport surveillance (international),4,0,0,0,4,0,0,930,0,930,925,1
06-01-2021,airport surveillance (domestic),3,0,0,0,3,0,0,1026,0,1026,1022,1
06-01-2021,railway surveillance,0,0,0,0,0,0,0,428,0,428,428,0
07-01-2021,ariyalur,11,3,1,0,13,4624,3,20,0,4647,4585,49
07-01-2021,chengalpattu,421,42,59,1,403,50365,42,5,0,50412,49259,750
07-01-2021,chennai,2326,210,258,4,2274,226889,210,46,0,227145,220833,4038
07-01-2021,coimbatore,745,78,88,1,734,52770,78,51,0,52899,51506,659
07-01-2021,cuddalore,137,11,23,0,125,24559,11,202,0,24772,24364,283
07-01-2021,dharmapuri,87,12,16,0,83,6258,12,214,0,6484,6347,54
07-01-2021,dindigul,113,12,21,0,104,10942,12,77,0,11031,10730,197
07-01-2021,erode,285,28,33,0,280,13786,28,94,0,13908,13483,145
07-01-2021,kallakurichi,25,4,3,0,26,10418,4,404,0,10826,10692,108
07-01-2021,kancheepuram,241,19,30,0,230,28851,19,3,0,28873,28209,434
07-01-2021,kanyakumari,172,37,18,0,191,16358,37,109,0,16504,16056,257
07-01-2021,karur,99,6,16,0,89,5202,6,46,0,5254,5115,50
07-01-2021,krishnagiri,62,9,4,0,67,7753,9,168,0,7930,7746,117
07-01-2021,madurai,162,22,21,0,163,20488,22,157,0,20667,20049,455
07-01-2021,nagapattinam,128,9,16,0,121,8143,9,88,0,8240,7988,131
07-01-2021,namakkal,165,18,26,0,157,11204,18,105,0,11327,11060,110
07-01-2021,nilgiris,105,9,8,1,105,7990,9,22,0,8021,7869,47
07-01-2021,perambalur,2,0,0,0,2,2256,0,2,0,2258,2235,21
07-01-2021,pudukottai,51,7,3,0,55,11406,7,33,0,11446,11236,155
07-01-2021,ramanathapuram,29,6,2,0,33,6213,6,133,0,6352,6185,134
07-01-2021,ranipet,76,9,6,1,78,15923,9,49,0,15981,15718,185
07-01-2021,salem,301,32,28,0,305,31395,32,420,0,31847,31078,464
07-01-2021,sivagangai,44,2,12,0,34,6492,2,68,0,6562,6402,126
07-01-2021,tenkasi,45,6,5,0,46,8253,6,49,0,8308,8104,158
07-01-2021,thanjavur,189,22,25,0,186,17278,22,22,0,17322,16897,239
07-01-2021,theni,70,8,5,0,73,16897,8,45,0,16950,16673,204
07-01-2021,thirupathur,61,4,7,0,58,7377,4,110,0,7491,7308,125
07-01-2021,thiruvallur,306,48,24,0,330,42871,48,10,0,42929,41919,680
07-01-2021,thiruvannamalai,86,10,9,0,87,18819,10,393,0,19222,18852,283
07-01-2021,thiruvarur,97,7,16,0,88,10956,7,37,0,11000,10803,109
07-01-2021,thoothukudi,92,14,13,0,93,15859,14,273,0,16146,15912,141
07-01-2021,tirunelveli,113,13,15,0,111,14940,13,420,0,15373,15050,212
07-01-2021,tiruppur,278,27,30,1,274,17254,27,11,0,17292,16798,220
07-01-2021,trichy,181,17,27,2,169,14276,17,34,0,14327,13980,178
07-01-2021,vellore,168,30,17,1,180,20012,28,327,2,20369,19848,341
07-01-2021,villupuram,87,0,11,0,76,14884,0,174,0,15058,14872,110
07-01-2021,virudhunagar,98,13,12,0,99,16311,13,104,0,16428,16100,229
07-01-2021,airport surveillance (international),4,0,1,0,3,0,0,930,0,930,926,1
07-01-2021,airport surveillance (domestic),3,1,2,0,2,0,0,1026,1,1027,1024,1
07-01-2021,railway surveillance,0,0,0,0,0,0,0,428,0,428,428,0
08-01-2021,ariyalur,13,4,1,0,16,4627,4,20,0,4651,4586,49
08-01-2021,chengalpattu,403,58,42,0,419,50407,58,5,0,50470,49301,750
08-01-2021,chennai,2274,208,247,4,2231,227099,208,46,0,227353,221080,4042
08-01-2021,coimbatore,734,79,81,1,731,52848,79,51,0,52978,51587,660
08-01-2021,cuddalore,125,8,29,0,104,24570,8,202,0,24780,24393,283
08-01-2021,dharmapuri,83,6,13,0,76,6270,6,214,0,6490,6360,54
08-01-2021,dindigul,104,14,22,1,95,10954,14,77,0,11045,10752,198
08-01-2021,erode,280,18,36,1,261,13814,18,94,0,13926,13519,146
08-01-2021,kallakurichi,26,5,3,0,28,10422,5,404,0,10831,10695,108
08-01-2021,kancheepuram,230,31,26,0,235,28870,31,3,0,28904,28235,434
08-01-2021,kanyakumari,191,18,17,0,192,16395,18,109,0,16522,16073,257
08-01-2021,karur,89,9,9,0,89,5208,9,46,0,5263,5124,50
08-01-2021,krishnagiri,67,8,12,0,63,7762,8,168,0,7938,7758,117
08-01-2021,madurai,163,23,10,0,176,20510,23,157,0,20690,20059,455
08-01-2021,nagapattinam,121,11,10,0,122,8152,11,88,0,8251,7998,131
08-01-2021,namakkal,157,20,15,0,162,11222,20,105,0,11347,11075,110
08-01-2021,nilgiris,105,10,14,0,101,7999,10,22,0,8031,7883,47
08-01-2021,perambalur,2,0,0,0,2,2256,0,2,0,2258,2235,21
08-01-2021,pudukottai,55,5,7,0,53,11413,5,33,0,11451,11243,155
08-01-2021,ramanathapuram,33,4,3,0,34,6219,4,133,0,6356,6188,134
08-01-2021,ranipet,78,13,4,0,87,15932,13,49,0,15994,15722,185
08-01-2021,salem,305,25,36,0,294,31427,25,420,0,31872,31114,464
08-01-2021,sivagangai,34,7,8,0,33,6494,7,68,0,6569,6410,126
08-01-2021,tenkasi,46,5,3,0,48,8259,5,49,0,8313,8107,158
08-01-2021,thanjavur,186,10,38,0,158,17300,10,22,0,17332,16935,239
08-01-2021,theni,73,7,12,1,67,16905,7,45,0,16957,16685,205
08-01-2021,thirupathur,58,8,9,0,57,7381,8,110,0,7499,7317,125
08-01-2021,thiruvallur,330,32,27,0,335,42919,32,10,0,42961,41946,680
08-01-2021,thiruvannamalai,87,9,13,0,83,18829,9,393,0,19231,18865,283
08-01-2021,thiruvarur,88,15,18,0,85,10963,15,37,0,11015,10821,109
08-01-2021,thoothukudi,93,7,11,0,89,15873,7,273,0,16153,15923,141
08-01-2021,tirunelveli,111,12,18,0,105,14953,12,420,0,15385,15068,212
08-01-2021,tiruppur,274,34,36,0,272,17281,34,11,0,17326,16834,220
08-01-2021,trichy,169,19,22,0,166,14293,19,34,0,14346,14002,178
08-01-2021,vellore,180,27,22,0,185,20040,27,329,0,20396,19870,341
08-01-2021,villupuram,76,10,15,0,71,14884,10,174,0,15068,14887,110
08-01-2021,virudhunagar,99,9,8,0,100,16324,9,104,0,16437,16108,229
08-01-2021,airport surveillance (international),3,2,0,0,5,0,0,930,2,932,926,1
08-01-2021,airport surveillance (domestic),2,0,0,0,2,0,0,1027,0,1027,1024,1
08-01-2021,railway surveillance,0,0,0,0,0,0,0,428,0,428,428,0
09-01-2021,ariyalur,16,3,2,0,17,,,,,,4588,49
09-01-2021,chengalpattu,418,46,46,0,418,,,,,,49347,750
09-01-2021,chennai,2235,218,253,2,2198,,,,,,221333,4044
09-01-2021,coimbatore,733,69,90,0,712,,,,,,51677,660
09-01-2021,cuddalore,105,9,10,0,104,,,,,,24403,283
09-01-2021,dharmapuri,76,5,7,0,74,,,,,,6367,54
09-01-2021,dindigul,96,7,16,0,87,,,,,,10768,198
09-01-2021,erode,258,20,42,0,236,,,,,,13561,146
09-01-2021,kallakurichi,29,4,5,0,28,,,,,,10700,108
09-01-2021,kancheepuram,236,21,21,1,235,,,,,,28256,435
09-01-2021,kanyakumari,191,17,19,0,189,,,,,,16092,257
09-01-2021,karur,93,6,11,0,88,,,,,,5135,50
09-01-2021,krishnagiri,62,8,9,0,61,,,,,,7767,117
09-01-2021,madurai,175,18,15,0,178,,,,,,20074,455
09-01-2021,nagapattinam,122,19,14,0,127,,,,,,8012,131
09-01-2021,namakkal,155,19,23,0,151,,,,,,11098,110
09-01-2021,nilgiris,101,2,13,0,90,,,,,,7896,47
09-01-2021,perambalur,3,0,1,0,2,,,,,,2236,21
09-01-2021,pudukottai,53,6,3,0,56,,,,,,11246,155
09-01-2021,ramanathapuram,34,0,2,0,32,,,,,,6190,134
09-01-2021,ranipet,87,7,9,1,84,,,,,,15731,186
09-01-2021,salem,295,52,41,0,306,,,,,,31155,464
09-01-2021,sivagangai,33,7,1,0,39,,,,,,6411,126
09-01-2021,tenkasi,48,6,5,0,49,,,,,,8112,158
09-01-2021,thanjavur,159,22,28,1,152,,,,,,16963,240
09-01-2021,theni,67,8,7,0,68,,,,,,16692,205
09-01-2021,thirupathur,57,4,6,0,55,,,,,,7323,125
09-01-2021,thiruvallur,330,39,27,0,342,,,,,,41973,680
09-01-2021,thiruvannamalai,83,7,18,0,72,,,,,,18883,283
09-01-2021,thiruvarur,85,9,15,0,79,,,,,,10836,109
09-01-2021,thoothukudi,90,6,11,0,85,,,,,,15934,141
09-01-2021,tirunelveli,104,10,12,0,102,,,,,,15080,212
09-01-2021,tiruppur,274,27,37,0,264,,,,,,16871,220
09-01-2021,trichy,166,27,21,0,172,,,,,,14023,178
09-01-2021,vellore,185,16,17,2,182,,,,,,19887,343
09-01-2021,villupuram,71,9,16,0,64,,,,,,14903,110
09-01-2021,virudhunagar,100,8,9,0,99,,,,,,16117,229
09-01-2021,airport surveillance (international),5,0,0,0,5,,,,,,926,1
09-01-2021,airport surveillance (domestic),2,0,0,0,2,,,,,,1024,1
09-01-2021,railway surveillance,0,0,0,0,0,,,,,,428,0
10-01-2021,ariyalur,17,2,1,0,18,4634,2,20,0,4656,4589,49
10-01-2021,chengalpattu,420,40,42,0,418,50512,40,5,0,50557,49389,750
10-01-2021,chennai,2215,208,240,1,2182,227546,208,46,0,227800,221573,4045
10-01-2021,coimbatore,716,76,87,1,704,53002,76,51,0,53129,51764,661
10-01-2021,cuddalore,104,9,14,0,99,24588,9,202,0,24799,24417,283
10-01-2021,dharmapuri,75,4,11,0,68,6282,4,214,0,6500,6378,54
10-01-2021,dindigul,86,10,10,0,86,10975,10,77,0,11062,10778,198
10-01-2021,erode,234,27,36,0,225,13847,27,94,0,13968,13597,146
10-01-2021,kallakurichi,26,2,2,0,26,10430,2,404,0,10836,10702,108
10-01-2021,kancheepuram,234,21,29,0,226,28922,21,3,0,28946,28285,435
10-01-2021,kanyakumari,189,20,23,0,186,16429,20,109,0,16558,16115,257
10-01-2021,karur,91,6,13,0,84,5230,6,46,0,5282,5148,50
10-01-2021,krishnagiri,61,6,4,0,63,7777,6,168,0,7951,7771,117
10-01-2021,madurai,175,13,23,0,165,20547,13,157,0,20717,20097,455
10-01-2021,nagapattinam,128,9,19,0,118,8183,9,88,0,8280,8031,131
10-01-2021,namakkal,156,12,26,0,142,11259,12,105,0,11376,11124,110
10-01-2021,nilgiris,90,13,17,0,86,8011,13,22,0,8046,7913,47
10-01-2021,perambalur,2,0,0,0,2,2257,0,2,0,2259,2236,21
10-01-2021,pudukottai,59,7,7,0,59,11427,7,33,0,11467,11253,155
10-01-2021,ramanathapuram,32,2,2,2,30,6223,2,133,0,6358,6192,136
10-01-2021,ranipet,82,8,6,0,84,15950,8,49,0,16007,15737,186
10-01-2021,salem,303,48,30,0,321,31502,48,420,0,31970,31185,464
10-01-2021,sivagangai,39,3,3,0,39,6508,3,68,0,6579,6414,126
10-01-2021,tenkasi,49,4,6,0,47,8270,4,49,0,8323,8118,158
10-01-2021,thanjavur,152,16,26,2,140,17333,16,22,0,17371,16989,242
10-01-2021,theni,69,4,13,0,60,16921,4,45,0,16970,16705,205
10-01-2021,thirupathur,55,5,8,0,52,7393,5,110,0,7508,7331,125
10-01-2021,thiruvallur,331,36,33,1,333,42974,36,10,0,43020,42006,681
10-01-2021,thiruvannamalai,72,8,6,0,74,18845,8,393,0,19246,18889,283
10-01-2021,thiruvarur,79,7,5,0,81,10987,7,37,0,11031,10841,109
10-01-2021,thoothukudi,85,7,12,0,80,15887,7,273,0,16167,15946,141
10-01-2021,tirunelveli,102,12,14,0,100,14974,12,420,0,15406,15094,212
10-01-2021,tiruppur,264,27,39,0,252,17344,27,11,0,17382,16910,220
10-01-2021,trichy,161,20,9,0,172,14328,20,34,0,14382,14032,178
10-01-2021,vellore,181,19,23,0,177,20078,15,333,4,20430,19910,343
10-01-2021,villupuram,64,2,7,0,59,14903,2,174,0,15079,14910,110
10-01-2021,virudhunagar,99,7,11,0,95,16341,7,104,0,16452,16128,229
10-01-2021,airport surveillance (international),5,4,0,0,9,0,0,932,4,936,926,1
10-01-2021,airport surveillance (domestic),2,0,0,0,2,0,0,1027,0,1027,1024,1
10-01-2021,railway surveillance,0,0,0,0,0,0,0,428,0,428,428,0
11-01-2021,ariyalur,17,2,1,0,18,4635,2,20,0,4657,4590,49
11-01-2021,chengalpattu,426,44,52,0,418,50560,44,5,0,50609,49441,750
11-01-2021,chennai,2156,201,247,3,2107,227728,201,46,0,227975,221820,4048
11-01-2021,coimbatore,704,71,84,0,691,53078,71,51,0,53200,51848,661
11-01-2021,cuddalore,99,6,16,0,89,24597,6,202,0,24805,24433,283
11-01-2021,dharmapuri,68,6,9,0,65,6286,6,214,0,6506,6387,54
11-01-2021,dindigul,87,8,8,0,87,10986,8,77,0,11071,10786,198
11-01-2021,erode,225,25,35,0,215,13874,25,94,0,13993,13632,146
11-01-2021,kallakurichi,26,1,2,0,25,10432,1,404,0,10837,10704,108
11-01-2021,kancheepuram,232,18,32,0,218,28949,18,3,0,28970,28317,435
11-01-2021,kanyakumari,187,19,26,0,180,16450,19,109,0,16578,16141,257
11-01-2021,karur,85,8,15,0,78,5237,8,46,0,5291,5163,50
11-01-2021,krishnagiri,63,7,5,0,65,7783,7,168,0,7958,7776,117
11-01-2021,madurai,165,19,19,0,165,20560,19,157,0,20736,20116,455
11-01-2021,nagapattinam,118,7,22,0,103,8192,7,88,0,8287,8053,131
11-01-2021,namakkal,142,14,14,0,142,11271,14,105,0,11390,11138,110
11-01-2021,nilgiris,86,11,11,0,86,8024,11,22,0,8057,7924,47
11-01-2021,perambalur,2,0,1,0,1,2257,0,2,0,2259,2237,21
11-01-2021,pudukottai,59,5,11,0,53,11434,5,33,0,11472,11264,155
11-01-2021,ramanathapuram,30,1,2,0,29,6225,1,133,0,6359,6194,136
11-01-2021,ranipet,83,7,7,0,83,15957,7,49,0,16013,15744,186
11-01-2021,salem,321,34,32,0,323,31550,34,420,0,32004,31217,464
11-01-2021,sivagangai,38,4,2,0,40,6510,4,68,0,6582,6416,126
11-01-2021,tenkasi,47,2,5,0,44,8274,2,49,0,8325,8123,158
11-01-2021,thanjavur,141,21,21,1,140,17350,21,22,0,17393,17010,243
11-01-2021,theni,59,3,8,0,54,16924,3,45,0,16972,16713,205
11-01-2021,thirupathur,52,4,9,0,47,7398,4,110,0,7512,7340,125
11-01-2021,thiruvallur,343,30,39,1,333,43020,30,10,0,43060,42045,682
11-01-2021,thiruvannamalai,75,7,7,0,75,18854,7,393,0,19254,18896,283
11-01-2021,thiruvarur,81,6,9,0,78,10994,6,37,0,11037,10850,109
11-01-2021,thoothukudi,80,6,11,0,75,15894,6,273,0,16173,15957,141
11-01-2021,tirunelveli,100,10,13,0,97,14986,10,420,0,15416,15107,212
11-01-2021,tiruppur,252,26,31,0,247,17371,26,11,0,17408,16941,220
11-01-2021,trichy,172,21,12,0,181,14348,21,34,0,14403,14044,178
11-01-2021,vellore,176,20,21,0,175,20092,20,337,0,20449,19931,343
11-01-2021,villupuram,59,1,10,0,50,14905,1,174,0,15080,14920,110
11-01-2021,virudhunagar,97,5,17,1,84,16350,5,104,0,16459,16145,230
11-01-2021,airport surveillance (international),9,0,2,0,7,0,0,936,0,936,928,1
11-01-2021,airport surveillance (domestic),2,2,1,0,3,0,0,1027,2,1029,1025,1
11-01-2021,railway surveillance,0,0,0,0,0,0,0,428,0,428,428,0
12-01-2021,ariyalur,18,3,2,0,19,4637,3,20,0,4660,4592,49
12-01-2021,chengalpattu,418,42,59,0,401,50604,42,5,0,50651,49500,750
12-01-2021,chennai,2107,194,219,5,2077,227929,194,46,0,228169,222039,4053
12-01-2021,coimbatore,691,59,78,0,672,53149,59,51,0,53259,51926,661
12-01-2021,cuddalore,89,5,4,1,89,24603,5,202,0,24810,24437,284
12-01-2021,dharmapuri,65,5,5,0,65,6292,5,214,0,6511,6392,54
12-01-2021,dindigul,87,7,16,0,78,10994,7,77,0,11078,10802,198
12-01-2021,erode,215,21,31,0,205,13899,21,94,0,14014,13663,146
12-01-2021,kallakurichi,25,2,2,0,25,10433,2,404,0,10839,10706,108
12-01-2021,kancheepuram,218,20,38,1,199,28967,20,3,0,28990,28355,436
12-01-2021,kanyakumari,180,21,11,0,190,16469,21,109,0,16599,16152,257
12-01-2021,karur,78,9,5,0,82,5245,9,46,0,5300,5168,50
12-01-2021,krishnagiri,65,9,9,0,65,7790,9,168,0,7967,7785,117
12-01-2021,madurai,165,11,24,0,152,20579,10,157,1,20747,20140,455
12-01-2021,nagapattinam,103,6,18,0,91,8199,6,88,0,8293,8071,131
12-01-2021,namakkal,142,15,19,0,138,11285,15,105,0,11405,11157,110
12-01-2021,nilgiris,86,14,15,0,85,8035,14,22,0,8071,7939,47
12-01-2021,perambalur,1,0,0,0,1,2257,0,2,0,2259,2237,21
12-01-2021,pudukottai,53,6,5,0,54,11439,6,33,0,11478,11269,155
12-01-2021,ramanathapuram,29,6,7,1,27,6226,6,133,0,6365,6201,137
12-01-2021,ranipet,83,5,9,0,79,15964,5,49,0,16018,15753,186
12-01-2021,salem,323,31,27,0,327,31584,31,420,0,32035,31244,464
12-01-2021,sivagangai,40,6,2,0,44,6514,6,68,0,6588,6418,126
12-01-2021,tenkasi,44,3,5,0,42,8276,3,49,0,8328,8128,158
12-01-2021,thanjavur,140,23,18,0,145,17371,23,22,0,17416,17028,243
12-01-2021,theni,54,4,8,0,50,16927,4,45,0,16976,16721,205
12-01-2021,thirupathur,47,5,11,0,41,7402,5,110,0,7517,7351,125
12-01-2021,thiruvallur,333,36,46,0,323,43050,36,10,0,43096,42091,682
12-01-2021,thiruvannamalai,75,6,13,0,68,18861,6,393,0,19260,18909,283
12-01-2021,thiruvarur,78,5,14,0,69,11000,5,37,0,11042,10864,109
12-01-2021,thoothukudi,75,7,9,0,73,15900,7,273,0,16180,15966,141
12-01-2021,tirunelveli,97,9,12,0,94,14996,9,420,0,15425,15119,212
12-01-2021,tiruppur,247,23,30,0,240,17397,23,11,0,17431,16971,220
12-01-2021,trichy,181,18,18,0,181,14369,18,34,0,14421,14062,178
12-01-2021,vellore,175,22,19,0,178,20112,19,337,3,20471,19950,343
12-01-2021,villupuram,50,4,7,0,47,14906,4,174,0,15084,14927,110
12-01-2021,virudhunagar,84,7,12,0,79,16355,7,104,0,16466,16157,230
12-01-2021,airport surveillance (international),7,2,0,0,9,0,0,936,2,938,928,1
12-01-2021,airport surveillance (domestic),3,0,0,0,3,0,0,1029,0,1029,1025,1
12-01-2021,railway surveillance,0,0,0,0,0,0,0,428,0,428,428,0
13-01-2021,ariyalur,18,1,1,0,18,4639,1,20,0,4660,4593,49
13-01-2021,chengalpattu,404,55,70,1,388,50650,55,5,0,50710,49570,752
13-01-2021,chennai,2085,192,233,2,2042,228130,191,46,1,228368,222272,4054
13-01-2021,coimbatore,673,71,83,1,660,53209,71,51,0,53331,52009,662
13-01-2021,cuddalore,90,8,8,0,90,24609,8,202,0,24819,24445,284
13-01-2021,dharmapuri,65,4,2,0,67,6297,4,214,0,6515,6394,54
13-01-2021,dindigul,76,10,13,0,73,10999,10,77,0,11086,10815,198
13-01-2021,erode,199,22,34,1,186,13914,22,94,0,14030,13697,147
13-01-2021,kallakurichi,26,3,6,0,23,10436,3,404,0,10843,10712,108
13-01-2021,kancheepuram,195,18,28,0,185,28983,18,3,0,29004,28383,436
13-01-2021,kanyakumari,187,11,19,0,179,16487,11,109,0,16607,16171,257
13-01-2021,karur,79,8,10,0,77,5251,8,46,0,5305,5178,50
13-01-2021,krishnagiri,65,13,5,0,73,7799,13,168,0,7980,7790,117
13-01-2021,madurai,153,13,11,0,155,20590,13,158,0,20761,20151,455
13-01-2021,nagapattinam,92,8,17,0,83,8206,8,88,0,8302,8088,131
13-01-2021,namakkal,142,12,13,0,141,11304,12,105,0,11421,11170,110
13-01-2021,nilgiris,85,7,12,0,80,8049,7,22,0,8078,7951,47
13-01-2021,perambalur,1,0,0,0,1,2257,0,2,0,2259,2237,21
13-01-2021,pudukottai,54,5,1,0,58,11445,5,33,0,11483,11270,155
13-01-2021,ramanathapuram,27,5,3,0,29,6232,5,133,0,6370,6204,137
13-01-2021,ranipet,79,4,13,0,70,15969,4,49,0,16022,15766,186
13-01-2021,salem,327,30,35,0,322,31615,30,420,0,32065,31279,464
13-01-2021,sivagangai,44,5,4,0,45,6520,5,68,0,6593,6422,126
13-01-2021,tenkasi,42,4,11,0,35,8279,4,49,0,8332,8139,158
13-01-2021,thanjavur,145,24,14,0,155,17394,24,22,0,17440,17042,243
13-01-2021,theni,51,9,12,0,48,16932,9,45,0,16986,16733,205
13-01-2021,thirupathur,41,4,6,0,39,7407,4,110,0,7521,7357,125
13-01-2021,thiruvallur,313,32,43,0,302,43076,32,10,0,43118,42134,682
13-01-2021,thiruvannamalai,67,7,8,0,66,18866,7,393,0,19266,18917,283
13-01-2021,thiruvarur,70,4,7,0,67,11006,4,37,0,11047,10871,109
13-01-2021,thoothukudi,73,4,7,0,70,15907,4,273,0,16184,15973,141
13-01-2021,tirunelveli,97,10,10,0,97,15008,10,420,0,15438,15129,212
13-01-2021,tiruppur,243,21,28,0,236,17423,21,11,0,17455,16999,220
13-01-2021,trichy,182,17,21,1,177,14388,17,34,0,14439,14083,179
13-01-2021,vellore,178,23,11,0,190,20131,19,340,4,20494,19961,343
13-01-2021,villupuram,48,2,5,0,45,14911,2,174,0,15087,14932,110
13-01-2021,virudhunagar,79,6,17,0,68,16362,6,104,0,16472,16174,230
13-01-2021,airport surveillance (international),9,0,0,0,9,0,0,938,0,938,928,1
13-01-2021,airport surveillance (domestic),3,1,0,0,4,0,0,1029,1,1030,1025,1
13-01-2021,railway surveillance,0,0,0,0,0,0,0,428,0,428,428,0
14-01-2021,ariyalur,17,1,1,0,17,4639,1,20,0,4660,4594,49
14-01-2021,chengalpattu,391,44,55,0,380,50708,44,5,0,50757,49625,752
14-01-2021,chennai,2045,195,229,3,2008,228324,195,47,0,228566,222501,4057
14-01-2021,coimbatore,660,77,92,0,645,53280,77,51,0,53408,52101,662
14-01-2021,cuddalore,90,7,17,0,80,24617,7,202,0,24826,24462,284
14-01-2021,dharmapuri,67,5,6,0,66,6301,5,214,0,6520,6400,54
14-01-2021,dindigul,74,7,4,0,77,11010,7,77,0,11094,10819,198
14-01-2021,erode,183,15,21,0,177,13933,15,94,0,14042,13718,147
14-01-2021,kallakurichi,23,5,2,0,26,10439,5,404,0,10848,10714,108
14-01-2021,kancheepuram,183,16,30,0,169,28999,16,3,0,29018,28413,436
14-01-2021,kanyakumari,179,18,21,0,176,16498,18,109,0,16625,16192,257
14-01-2021,karur,77,6,12,0,71,5259,6,46,0,5311,5190,50
14-01-2021,krishnagiri,73,12,8,0,77,7812,11,168,1,7992,7798,117
14-01-2021,madurai,152,16,19,0,149,20600,16,158,0,20774,20170,455
14-01-2021,nagapattinam,84,6,11,0,79,8215,6,88,0,8309,8099,131
14-01-2021,namakkal,143,13,16,0,140,11318,13,105,0,11436,11186,110
14-01-2021,nilgiris,80,12,9,0,83,8056,12,22,0,8090,7960,47
14-01-2021,perambalur,1,0,1,0,0,2257,0,2,0,2259,2238,21
14-01-2021,pudukottai,58,3,8,0,53,11450,3,33,0,11486,11278,155
14-01-2021,ramanathapuram,29,3,4,0,28,6237,3,133,0,6373,6208,137
14-01-2021,ranipet,70,6,11,0,65,15973,6,49,0,16028,15777,186
14-01-2021,salem,323,25,41,0,307,31646,25,420,0,32091,31320,464
14-01-2021,sivagangai,45,7,7,0,45,6525,7,68,0,6600,6429,126
14-01-2021,tenkasi,35,5,4,0,36,8283,5,49,0,8337,8143,158
14-01-2021,thanjavur,158,17,12,0,163,17421,17,22,0,17460,17054,243
14-01-2021,theni,48,6,4,0,50,16941,6,45,0,16992,16737,205
14-01-2021,thirupathur,39,5,4,0,40,7411,5,110,0,7526,7361,125
14-01-2021,thiruvallur,295,31,37,0,289,43101,31,10,0,43142,42171,682
14-01-2021,thiruvannamalai,66,6,9,0,63,18873,6,393,0,19272,18926,283
14-01-2021,thiruvarur,67,8,8,0,67,11010,8,37,0,11055,10879,109
14-01-2021,thoothukudi,71,3,6,0,68,15912,3,273,0,16188,15979,141
14-01-2021,tirunelveli,96,8,12,0,92,15017,8,420,0,15445,15141,212
14-01-2021,tiruppur,237,23,37,0,223,17445,23,11,0,17479,17036,220
14-01-2021,trichy,177,14,24,0,167,14405,14,34,0,14453,14107,179
14-01-2021,vellore,191,24,19,1,195,20151,24,344,0,20519,19980,344
14-01-2021,villupuram,45,11,11,0,45,14913,11,174,0,15098,14943,110
14-01-2021,virudhunagar,68,4,14,0,58,16368,4,104,0,16476,16188,230
14-01-2021,airport surveillance (international),9,0,0,0,9,0,0,938,0,938,928,1
14-01-2021,airport surveillance (domestic),4,1,0,0,5,0,0,1030,1,1031,1025,1
14-01-2021,railway surveillance,0,0,0,0,0,0,0,428,0,428,428,0
15-01-2021,ariyalur,17,0,3,0,14,4640,0,20,0,4660,4597,49
15-01-2021,chengalpattu,380,25,38,2,365,50752,25,5,0,50782,49663,754
15-01-2021,chennai,2008,180,215,2,1971,228519,180,47,0,228746,222716,4059
15-01-2021,coimbatore,645,67,87,0,625,53357,67,51,0,53475,52188,662
15-01-2021,cuddalore,80,14,24,0,70,24624,14,202,0,24840,24486,284
15-01-2021,dharmapuri,66,6,14,0,58,6306,6,214,0,6526,6414,54
15-01-2021,dindigul,77,10,5,0,82,11017,10,77,0,11104,10824,198
15-01-2021,erode,177,16,23,0,170,13948,16,94,0,14058,13741,147
15-01-2021,kallakurichi,26,4,3,0,27,10444,4,404,0,10852,10717,108
15-01-2021,kancheepuram,169,22,19,0,172,29015,22,3,0,29040,28432,436
15-01-2021,kanyakumari,176,10,26,0,160,16516,10,109,0,16635,16218,257
15-01-2021,karur,71,10,13,0,68,5265,10,46,0,5321,5203,50
15-01-2021,krishnagiri,77,7,7,0,77,7823,7,169,0,7999,7805,117
15-01-2021,madurai,149,14,23,0,140,20616,14,158,0,20788,20193,455
15-01-2021,nagapattinam,79,5,9,0,75,8221,5,88,0,8314,8108,131
15-01-2021,namakkal,140,12,21,0,131,11331,12,105,0,11448,11207,110
15-01-2021,nilgiris,83,5,12,0,76,8068,5,22,0,8095,7972,47
15-01-2021,perambalur,0,1,0,0,1,2257,1,2,0,2260,2238,21
15-01-2021,pudukottai,53,5,10,0,48,11453,5,33,0,11491,11288,155
15-01-2021,ramanathapuram,28,3,2,0,29,6240,3,133,0,6376,6210,137
15-01-2021,ranipet,65,4,9,0,60,15979,4,49,0,16032,15786,186
15-01-2021,salem,307,24,45,1,285,31671,24,420,0,32115,31365,465
15-01-2021,sivagangai,45,4,4,0,45,6532,4,68,0,6604,6433,126
15-01-2021,tenkasi,36,4,6,0,34,8288,4,49,0,8341,8149,158
15-01-2021,thanjavur,163,27,18,0,172,17438,27,22,0,17487,17072,243
15-01-2021,theni,50,7,8,0,49,16947,7,45,0,16999,16745,205
15-01-2021,thirupathur,40,4,3,0,41,7416,4,110,0,7530,7364,125
15-01-2021,thiruvallur,289,22,39,0,272,43132,22,10,0,43164,42210,682
15-01-2021,thiruvannamalai,63,10,11,0,62,18879,10,393,0,19282,18937,283
15-01-2021,thiruvarur,67,7,9,0,65,11018,7,37,0,11062,10888,109
15-01-2021,thoothukudi,68,7,13,0,62,15915,7,273,0,16195,15992,141
15-01-2021,tirunelveli,92,7,9,0,90,15025,7,420,0,15452,15150,212
15-01-2021,tiruppur,223,27,24,0,226,17468,27,11,0,17506,17060,220
15-01-2021,trichy,167,20,21,0,166,14419,20,34,0,14473,14128,179
15-01-2021,vellore,195,17,22,0,190,20175,10,344,7,20536,20002,344
15-01-2021,villupuram,45,5,4,0,46,14924,5,174,0,15103,14947,110
15-01-2021,virudhunagar,58,9,6,0,61,16372,9,104,0,16485,16194,230
15-01-2021,airport surveillance (international),9,0,0,0,9,0,0,938,0,938,928,1
15-01-2021,airport surveillance (domestic),5,0,0,0,5,0,0,1031,0,1031,1025,1
15-01-2021,railway surveillance,0,0,0,0,0,0,0,428,0,428,428,0
16-01-2021,ariyalur,14,0,2,0,12,4640,0,20,0,4660,4599,49
16-01-2021,chengalpattu,370,38,45,2,361,50782,38,5,0,50825,49708,756
16-01-2021,chennai,1961,176,187,4,1946,228688,176,47,0,228911,222903,4062
16-01-2021,coimbatore,625,80,76,0,629,53424,80,51,0,53555,52264,662
16-01-2021,cuddalore,70,6,15,0,61,24638,6,202,0,24846,24501,284
16-01-2021,dharmapuri,58,7,12,0,53,6312,7,214,0,6533,6426,54
16-01-2021,dindigul,82,12,10,0,84,11027,12,77,0,11116,10834,198
16-01-2021,erode,170,14,28,0,156,13964,14,94,0,14072,13769,147
16-01-2021,kallakurichi,27,5,4,0,28,10448,5,404,0,10857,10721,108
16-01-2021,kancheepuram,172,16,25,0,163,29038,16,3,0,29057,28457,437
16-01-2021,kanyakumari,160,11,24,0,147,16526,11,109,0,16646,16242,257
16-01-2021,karur,68,7,11,0,64,5275,7,46,0,5328,5214,50
16-01-2021,krishnagiri,77,3,9,0,71,7830,3,169,0,8002,7814,117
16-01-2021,madurai,140,15,25,0,130,20630,15,158,0,20803,20218,455
16-01-2021,nagapattinam,75,6,10,0,71,8226,6,88,0,8320,8118,131
16-01-2021,namakkal,132,11,23,0,120,11344,11,105,0,11460,11230,110
16-01-2021,nilgiris,76,8,7,0,77,8073,8,22,0,8103,7979,47
16-01-2021,perambalur,1,0,0,0,1,2258,0,2,0,2260,2238,21
16-01-2021,pudukottai,48,4,8,0,44,11458,4,33,0,11495,11296,155
16-01-2021,ramanathapuram,34,2,3,0,33,6248,2,133,0,6383,6213,137
16-01-2021,ranipet,60,6,11,0,55,15983,6,49,0,16038,15797,186
16-01-2021,salem,285,21,41,0,265,31695,21,420,0,32136,31406,465
16-01-2021,sivagangai,45,6,3,0,48,6536,6,68,0,6610,6436,126
16-01-2021,tenkasi,35,4,5,0,34,8293,4,49,0,8346,8154,158
16-01-2021,thanjavur,172,18,19,0,171,17465,18,22,0,17505,17091,243
16-01-2021,theni,49,6,5,0,50,16954,6,45,0,17005,16750,205
16-01-2021,thirupathur,41,6,4,0,43,7420,6,110,0,7536,7368,125
16-01-2021,thiruvallur,268,30,46,0,252,43150,30,10,0,43190,42256,682
16-01-2021,thiruvannamalai,63,11,16,0,58,18890,11,393,0,19294,18953,283
16-01-2021,thiruvarur,65,3,6,0,62,11025,3,37,0,11065,10894,109
16-01-2021,thoothukudi,62,6,11,0,57,15922,6,273,0,16201,16003,141
16-01-2021,tirunelveli,89,14,7,0,96,15031,14,420,0,15465,15157,212
16-01-2021,tiruppur,226,15,23,0,218,17495,15,11,0,17521,17083,220
16-01-2021,trichy,166,13,28,0,151,14439,13,34,0,14486,14156,179
16-01-2021,vellore,190,12,19,0,183,20185,9,351,3,20548,20021,344
16-01-2021,villupuram,46,6,3,0,49,14929,6,174,0,15109,14950,110
16-01-2021,virudhunagar,63,10,4,0,69,16383,10,104,0,16497,16198,230
16-01-2021,airport surveillance (international),9,2,0,0,11,0,0,938,2,940,928,1
16-01-2021,airport surveillance (domestic),5,0,0,0,5,0,0,1031,0,1031,1025,1
16-01-2021,railway surveillance,0,0,0,0,0,0,0,428,0,428,428,0
17-01-2021,ariyalur,12,2,1,0,13,4640,2,20,0,4662,4600,49
17-01-2021,chengalpattu,364,50,56,1,357,50823,50,5,0,50878,49764,757
17-01-2021,chennai,1945,164,147,3,1959,228863,164,47,0,229074,223050,4065
17-01-2021,coimbatore,630,66,88,0,608,53505,66,51,0,53622,52352,662
17-01-2021,cuddalore,61,5,14,0,52,24644,5,202,0,24851,24515,284
17-01-2021,dharmapuri,53,1,11,0,43,6319,1,214,0,6534,6437,54
17-01-2021,dindigul,83,14,16,0,81,11038,14,77,0,11129,10850,198
17-01-2021,erode,153,18,27,0,144,13975,18,94,0,14087,13796,147
17-01-2021,kallakurichi,28,3,3,0,28,10453,3,404,0,10860,10724,108
17-01-2021,kancheepuram,161,15,28,0,148,29052,15,3,0,29070,28485,437
17-01-2021,kanyakumari,147,13,22,0,138,16537,13,109,0,16659,16264,257
17-01-2021,karur,65,6,13,0,58,5283,6,46,0,5335,5227,50
17-01-2021,krishnagiri,71,4,11,0,64,7833,4,169,0,8006,7825,117
17-01-2021,madurai,127,16,23,0,120,20642,16,158,0,20816,20241,455
17-01-2021,nagapattinam,71,7,9,0,69,8232,7,88,0,8327,8127,131
17-01-2021,namakkal,121,10,22,0,109,11356,10,105,0,11471,11252,110
17-01-2021,nilgiris,77,6,6,0,77,8081,6,22,0,8109,7985,47
17-01-2021,perambalur,1,0,0,0,1,2258,0,2,0,2260,2238,21
17-01-2021,pudukottai,44,6,7,0,43,11462,6,33,0,11501,11303,155
17-01-2021,ramanathapuram,34,1,5,0,30,6251,1,133,0,6385,6218,137
17-01-2021,ranipet,55,4,12,0,47,15989,4,49,0,16042,15809,186
17-01-2021,salem,266,25,39,0,252,31717,25,420,0,32162,31445,465
17-01-2021,sivagangai,47,4,4,0,47,6541,4,68,0,6613,6440,126
17-01-2021,tenkasi,35,0,3,0,32,8298,0,49,0,8347,8157,158
17-01-2021,thanjavur,171,22,21,0,172,17483,22,22,0,17527,17112,243
17-01-2021,theni,50,7,7,0,50,16960,7,45,0,17012,16757,205
17-01-2021,thirupathur,43,2,5,0,40,7426,2,110,0,7538,7373,125
17-01-2021,thiruvallur,252,28,43,2,235,43180,28,10,0,43218,42299,684
17-01-2021,thiruvannamalai,58,4,10,0,52,18901,4,393,0,19298,18963,283
17-01-2021,thiruvarur,62,7,9,0,60,11028,7,37,0,11072,10903,109
17-01-2021,thoothukudi,57,3,10,0,50,15928,3,273,0,16204,16013,141
17-01-2021,tirunelveli,97,9,8,0,98,15046,9,420,0,15475,15165,212
17-01-2021,tiruppur,219,20,26,0,213,17511,20,11,0,17542,17109,220
17-01-2021,trichy,151,17,34,0,134,14452,17,34,0,14503,14190,179
17-01-2021,vellore,183,17,15,0,185,20194,17,354,0,20565,20036,344
17-01-2021,villupuram,49,4,6,0,47,14935,4,174,0,15113,14956,110
17-01-2021,virudhunagar,69,9,9,1,68,16393,9,104,0,16506,16207,231
17-01-2021,airport surveillance (international),11,0,0,0,11,0,0,940,0,940,928,1
17-01-2021,airport surveillance (domestic),5,0,0,0,5,0,0,1031,0,1031,1025,1
17-01-2021,railway surveillance,0,0,0,0,0,0,0,428,0,428,428,0
18-01-2021,ariyalur,13,1,2,0,12,4642,1,20,0,4663,4602,49
18-01-2021,chengalpattu,361,40,50,0,351,50877,40,5,0,50922,49814,757
18-01-2021,chennai,1965,158,180,4,1939,229033,158,47,0,229238,223230,4069
18-01-2021,coimbatore,608,69,81,1,595,53571,69,51,0,53691,52433,663
18-01-2021,cuddalore,52,7,9,0,50,24649,7,202,0,24858,24524,284
18-01-2021,dharmapuri,43,5,7,0,41,6320,5,214,0,6539,6444,54
18-01-2021,dindigul,81,5,17,0,69,11052,5,77,0,11134,10867,198
18-01-2021,erode,141,11,22,0,130,13990,11,94,0,14095,13818,147
18-01-2021,kallakurichi,28,1,2,0,27,10456,1,404,0,10861,10726,108
18-01-2021,kancheepuram,140,20,27,0,133,29059,20,3,0,29082,28512,437
18-01-2021,kanyakumari,138,8,18,0,128,16550,8,109,0,16667,16282,257
18-01-2021,karur,59,7,10,0,56,5290,7,46,0,5343,5237,50
18-01-2021,krishnagiri,64,2,8,0,58,7837,2,169,0,8008,7833,117
18-01-2021,madurai,119,15,19,0,115,20657,15,158,0,20830,20260,455
18-01-2021,nagapattinam,69,8,7,0,70,8239,8,88,0,8335,8134,131
18-01-2021,namakkal,109,6,17,0,98,11366,6,105,0,11477,11269,110
18-01-2021,nilgiris,77,4,9,0,72,8087,4,22,0,8113,7994,47
18-01-2021,perambalur,1,0,0,0,1,2258,0,2,0,2260,2238,21
18-01-2021,pudukottai,44,3,6,1,40,11469,3,33,0,11505,11309,156
18-01-2021,ramanathapuram,30,6,6,0,30,6252,6,133,0,6391,6224,137
18-01-2021,ranipet,47,3,15,0,35,15993,3,49,0,16045,15824,186
18-01-2021,salem,252,24,38,0,238,31742,24,420,0,32186,31483,465
18-01-2021,sivagangai,47,1,5,0,43,6545,1,68,0,6614,6445,126
18-01-2021,tenkasi,32,5,2,0,35,8298,5,49,0,8352,8159,158
18-01-2021,thanjavur,172,20,19,0,173,17505,20,22,0,17547,17131,243
18-01-2021,theni,50,3,5,0,48,16967,3,45,0,17015,16762,205
18-01-2021,thirupathur,40,2,6,0,36,7428,2,110,0,7540,7379,125
18-01-2021,thiruvallur,234,30,48,0,216,43207,30,10,0,43247,42347,684
18-01-2021,thiruvannamalai,52,5,8,0,49,18905,5,393,0,19303,18971,283
18-01-2021,thiruvarur,61,13,12,0,62,11036,13,37,0,11086,10915,109
18-01-2021,thoothukudi,50,6,8,0,48,15931,6,273,0,16210,16021,141
18-01-2021,tirunelveli,98,14,10,0,102,15055,14,420,0,15489,15175,212
18-01-2021,tiruppur,216,19,25,0,210,17534,19,11,0,17564,17134,220
18-01-2021,trichy,131,11,29,0,113,14466,11,34,0,14511,14219,179
18-01-2021,vellore,185,14,14,2,183,20211,11,354,3,20579,20050,346
18-01-2021,villupuram,47,2,5,0,44,14939,2,174,0,15115,14961,110
18-01-2021,virudhunagar,68,3,12,0,59,16402,3,104,0,16509,16219,231
18-01-2021,airport surveillance (international),11,0,0,0,11,0,0,940,0,940,928,1
18-01-2021,airport surveillance (domestic),5,0,0,0,5,0,0,1031,0,1031,1025,1
18-01-2021,railway surveillance,0,0,0,0,0,0,0,428,0,428,428,0
19-01-2021,ariyalur,13,1,6,0,8,4644,1,20,0,4665,4608,49
19-01-2021,chengalpattu,359,45,62,0,342,50925,45,5,0,50975,49876,757
19-01-2021,chennai,1935,152,191,3,1893,229187,152,47,0,229386,223421,4072
19-01-2021,coimbatore,595,58,98,1,554,53640,58,51,0,53749,52531,664
19-01-2021,cuddalore,51,5,5,0,51,24657,5,202,0,24864,24529,284
19-01-2021,dharmapuri,41,1,5,0,37,6325,1,214,0,6540,6449,54
19-01-2021,dindigul,69,4,18,0,55,11057,4,77,0,11138,10885,198
19-01-2021,erode,130,22,11,1,140,14001,22,94,0,14117,13829,148
19-01-2021,kallakurichi,27,0,2,0,25,10457,0,404,0,10861,10728,108
19-01-2021,kancheepuram,128,12,15,1,124,29074,12,3,0,29089,28527,438
19-01-2021,kanyakumari,128,11,24,0,115,16558,11,109,0,16678,16306,257
19-01-2021,karur,58,4,4,0,58,5299,4,46,0,5349,5241,50
19-01-2021,krishnagiri,59,5,3,0,61,7840,5,169,0,8014,7836,117
19-01-2021,madurai,112,12,7,0,117,20669,12,158,0,20839,20267,455
19-01-2021,nagapattinam,70,11,14,0,67,8247,11,88,0,8346,8148,131
19-01-2021,namakkal,98,9,19,0,88,11372,9,105,0,11486,11288,110
19-01-2021,nilgiris,72,8,15,0,65,8091,8,22,0,8121,8009,47
19-01-2021,perambalur,1,1,0,0,2,2258,1,2,0,2261,2238,21
19-01-2021,pudukottai,40,7,4,0,43,11472,7,33,0,11512,11313,156
19-01-2021,ramanathapuram,30,2,4,0,28,6258,2,133,0,6393,6228,137
19-01-2021,ranipet,35,4,15,0,24,15996,4,49,0,16049,15839,186
19-01-2021,salem,238,18,36,0,220,31766,18,420,0,32204,31519,465
19-01-2021,sivagangai,44,3,9,0,38,6547,3,68,0,6618,6454,126
19-01-2021,tenkasi,35,2,7,0,30,8303,2,49,0,8354,8166,158
19-01-2021,thanjavur,171,16,15,0,172,17523,16,22,0,17561,17146,243
19-01-2021,theni,48,7,8,0,47,16970,7,45,0,17022,16770,205
19-01-2021,thirupathur,36,1,4,0,33,7430,1,110,0,7541,7383,125
19-01-2021,thiruvallur,215,40,36,2,217,43236,40,10,0,43286,42383,686
19-01-2021,thiruvannamalai,49,6,12,0,43,18910,6,393,0,19309,18983,283
19-01-2021,thiruvarur,61,5,13,0,53,11048,5,37,0,11090,10928,109
19-01-2021,thoothukudi,48,4,3,0,49,15937,4,273,0,16214,16024,141
19-01-2021,tirunelveli,102,12,14,0,100,15069,12,420,0,15501,15189,212
19-01-2021,tiruppur,211,20,29,0,202,17554,20,11,0,17585,17163,220
19-01-2021,trichy,112,17,20,0,109,14476,17,34,0,14527,14239,179
19-01-2021,vellore,183,11,19,0,175,20222,8,357,3,20590,20069,346
19-01-2021,villupuram,45,4,9,1,39,14942,4,174,0,15120,14970,111
19-01-2021,virudhunagar,60,3,11,0,52,16406,3,104,0,16513,16230,231
19-01-2021,airport surveillance (international),11,0,3,0,8,0,0,940,0,940,931,1
19-01-2021,airport surveillance (domestic),5,0,2,0,3,0,0,1031,0,1031,1027,1
19-01-2021,railway surveillance,0,0,0,0,0,0,0,428,0,428,428,0
21-01-2021,ariyalur,7,1,3,0,5,4646,1,20,0,4667,4613,49
21-01-2021,chengalpattu,357,72,50,2,377,51025,72,5,0,51102,49964,761
21-01-2021,chennai,1869,166,189,4,1842,229492,166,47,0,229705,223783,4080
21-01-2021,coimbatore,530,59,60,1,528,53753,59,51,0,53863,52670,665
21-01-2021,cuddalore,47,2,4,0,45,24664,2,202,0,24868,24539,284
21-01-2021,dharmapuri,33,6,5,0,34,6329,6,214,0,6549,6461,54
21-01-2021,dindigul,54,7,9,0,52,11066,7,77,0,11150,10900,198
21-01-2021,erode,147,17,27,0,137,14048,17,94,0,14159,13874,148
21-01-2021,kallakurichi,20,1,2,0,19,10457,1,404,0,10862,10735,108
21-01-2021,kancheepuram,121,24,12,0,133,29092,24,3,0,29119,28548,438
21-01-2021,kanyakumari,101,15,23,0,93,16576,15,109,0,16700,16350,257
21-01-2021,karur,58,6,11,0,53,5311,6,46,0,5363,5260,50
21-01-2021,krishnagiri,56,3,10,0,49,7849,3,169,0,8021,7855,117
21-01-2021,madurai,111,23,15,0,119,20690,23,158,0,20871,20296,456
21-01-2021,nagapattinam,54,11,13,0,52,8262,11,88,0,8361,8177,132
21-01-2021,namakkal,91,8,12,0,87,11396,8,105,0,11509,11312,110
21-01-2021,nilgiris,61,6,11,0,56,8107,6,22,0,8135,8032,47
21-01-2021,perambalur,1,0,0,0,1,2258,0,2,0,2260,2238,21
21-01-2021,pudukottai,38,3,3,0,38,11483,3,33,0,11519,11325,156
21-01-2021,ramanathapuram,25,6,6,0,25,6260,6,133,0,6399,6237,137
21-01-2021,ranipet,27,5,3,0,29,16007,5,49,0,16061,15846,186
21-01-2021,salem,186,27,34,0,179,31802,27,420,0,32249,31605,465
21-01-2021,sivagangai,33,4,4,0,33,6552,4,68,0,6624,6465,126
21-01-2021,tenkasi,35,4,4,0,35,8314,4,49,0,8367,8174,158
21-01-2021,thanjavur,172,5,38,1,138,17561,5,22,0,17588,17206,244
21-01-2021,theni,52,6,5,0,53,16986,6,45,0,17037,16779,205
21-01-2021,thirupathur,30,0,4,0,26,7433,0,110,0,7543,7392,125
21-01-2021,thiruvallur,210,18,19,0,209,43298,18,10,0,43326,42430,687
21-01-2021,thiruvannamalai,38,4,7,0,35,18918,4,393,0,19315,18997,283
21-01-2021,thiruvarur,55,6,3,0,58,11064,6,37,0,11107,10940,109
21-01-2021,thoothukudi,43,8,6,0,45,15948,8,273,0,16229,16043,141
21-01-2021,tirunelveli,87,1,11,0,77,15087,1,420,0,15508,15219,212
21-01-2021,tiruppur,186,32,38,0,180,17596,32,11,0,17639,17239,220
21-01-2021,trichy,110,11,13,0,108,14506,11,34,0,14551,14264,179
21-01-2021,vellore,165,12,36,0,141,20242,8,366,4,20620,20133,346
21-01-2021,villupuram,41,11,8,1,43,14952,11,174,0,15137,14982,112
21-01-2021,virudhunagar,53,6,7,0,52,16418,6,104,0,16528,16245,231
21-01-2021,airport surveillance (international),6,0,0,0,6,0,0,940,0,940,933,1
21-01-2021,airport surveillance (domestic),4,0,0,0,4,0,0,1032,0,1032,1027,1
21-01-2021,railway surveillance,0,0,0,0,0,0,0,428,0,428,428,0
22-01-2021,ariyalur,5,5,1,0,9,4647,5,20,0,4672,4614,49
22-01-2021,chengalpattu,377,58,56,1,378,51097,58,5,0,51160,50020,762
22-01-2021,chennai,1842,155,203,4,1790,229658,155,47,0,229860,223986,4084
22-01-2021,coimbatore,528,55,68,1,514,53812,55,51,0,53918,52738,666
22-01-2021,cuddalore,45,5,5,0,45,24666,5,202,0,24873,24544,284
22-01-2021,dharmapuri,34,4,4,0,34,6335,4,214,0,6553,6465,54
22-01-2021,dindigul,52,14,11,0,55,11073,14,77,0,11164,10911,198
22-01-2021,erode,137,9,22,0,124,14065,9,94,0,14168,13896,148
22-01-2021,kallakurichi,19,4,3,0,20,10458,4,404,0,10866,10738,108
22-01-2021,kancheepuram,133,15,13,0,135,29116,15,3,0,29134,28561,438
22-01-2021,kanyakumari,93,14,14,0,93,16591,14,109,0,16714,16364,257
22-01-2021,karur,53,5,4,0,54,5317,5,46,0,5368,5264,50
22-01-2021,krishnagiri,49,6,17,0,38,7852,6,169,0,8027,7872,117
22-01-2021,madurai,119,30,12,0,137,20713,30,158,0,20901,20308,456
22-01-2021,nagapattinam,52,10,6,0,56,8273,10,88,0,8371,8183,132
22-01-2021,namakkal,87,12,12,0,87,11404,12,105,0,11521,11324,110
22-01-2021,nilgiris,56,2,9,0,49,8113,2,22,0,8137,8041,47
22-01-2021,perambalur,1,0,0,0,1,2258,0,2,0,2260,2238,21
22-01-2021,pudukottai,38,2,5,0,35,11486,2,33,0,11521,11330,156
22-01-2021,ramanathapuram,25,1,3,0,23,6266,1,133,0,6400,6240,137
22-01-2021,ranipet,29,3,6,1,25,16012,3,49,0,16064,15852,187
22-01-2021,salem,179,12,30,0,161,31829,12,420,0,32261,31635,465
22-01-2021,sivagangai,33,5,5,0,33,6556,5,68,0,6629,6470,126
22-01-2021,tenkasi,35,13,3,0,45,8318,13,49,0,8380,8177,158
22-01-2021,thanjavur,138,7,24,0,121,17566,7,22,0,17595,17230,244
22-01-2021,theni,53,6,6,0,53,16992,6,45,0,17043,16785,205
22-01-2021,thirupathur,26,3,6,0,23,7433,3,110,0,7546,7398,125
22-01-2021,thiruvallur,209,32,16,0,225,43316,32,10,0,43358,42446,687
22-01-2021,thiruvannamalai,35,8,7,0,36,18922,8,393,0,19323,19004,283
22-01-2021,thiruvarur,58,8,8,0,58,11070,8,37,0,11115,10948,109
22-01-2021,thoothukudi,45,3,3,0,45,15956,3,273,0,16232,16046,141
22-01-2021,tirunelveli,77,2,12,0,67,15088,2,420,0,15510,15231,212
22-01-2021,tiruppur,180,29,40,0,169,17628,29,11,0,17668,17279,220
22-01-2021,trichy,108,13,10,0,111,14517,13,34,0,14564,14274,179
22-01-2021,vellore,141,14,28,1,126,20250,9,370,5,20634,20161,347
22-01-2021,villupuram,43,6,8,0,41,14963,6,174,0,15143,14990,112
22-01-2021,virudhunagar,52,3,4,0,51,16424,3,104,0,16531,16249,231
22-01-2021,airport surveillance (international),6,0,2,0,4,0,0,940,0,940,935,1
22-01-2021,airport surveillance (domestic),4,1,3,0,2,0,0,1032,1,1033,1030,1
22-01-2021,railway surveillance,0,0,0,0,0,0,0,428,0,428,428,0
23-01-2021,ariyalur,9,2,2,0,9,4652,2,20,0,4674,4616,49
23-01-2021,chengalpattu,373,51,45,0,379,51150,51,5,0,51206,50065,762
23-01-2021,chennai,1803,153,206,1,1749,229826,153,47,0,230026,224192,4085
23-01-2021,coimbatore,515,47,64,0,498,53868,47,51,0,53966,52802,666
23-01-2021,cuddalore,46,2,13,0,35,24672,2,202,0,24876,24557,284
23-01-2021,dharmapuri,34,10,9,0,35,6339,10,214,0,6563,6474,54
23-01-2021,dindigul,55,17,7,0,65,11087,17,77,0,11181,10918,198
23-01-2021,erode,124,27,20,0,131,14074,27,94,0,14195,13916,148
23-01-2021,kallakurichi,22,1,4,0,19,10464,1,404,0,10869,10742,108
23-01-2021,kancheepuram,126,25,14,0,137,29122,25,3,0,29150,28575,438
23-01-2021,kanyakumari,91,10,17,0,84,16603,10,109,0,16722,16381,257
23-01-2021,karur,53,3,7,0,49,5321,3,46,0,5370,5271,50
23-01-2021,krishnagiri,38,7,10,0,35,7858,7,169,0,8034,7882,117
23-01-2021,madurai,136,12,13,0,135,20742,12,158,0,20912,20321,456
23-01-2021,nagapattinam,57,14,9,0,62,8284,14,88,0,8386,8192,132
23-01-2021,namakkal,84,10,11,0,83,11413,10,105,0,11528,11335,110
23-01-2021,nilgiris,49,10,4,0,55,8115,10,22,0,8147,8045,47
23-01-2021,perambalur,1,2,0,0,3,2258,2,2,0,2262,2238,21
23-01-2021,pudukottai,35,2,9,0,28,11488,2,33,0,11523,11339,156
23-01-2021,ramanathapuram,24,0,4,0,20,6268,0,133,0,6401,6244,137
23-01-2021,ranipet,28,9,0,0,37,16018,9,49,0,16076,15852,187
23-01-2021,salem,161,16,33,0,144,31841,16,420,0,32277,31668,465
23-01-2021,sivagangai,33,4,6,0,31,6561,4,68,0,6633,6476,126
23-01-2021,tenkasi,46,8,7,0,47,8332,8,49,0,8389,8184,158
23-01-2021,thanjavur,121,9,15,0,115,17573,9,22,0,17604,17245,244
23-01-2021,theni,53,7,3,0,57,16998,7,45,0,17050,16788,205
23-01-2021,thirupathur,23,3,4,0,22,7436,3,110,0,7549,7402,125
23-01-2021,thiruvallur,222,24,19,0,227,43345,24,10,0,43379,42465,687
23-01-2021,thiruvannamalai,38,3,7,0,34,18932,3,393,0,19328,19011,283
23-01-2021,thiruvarur,59,26,5,0,80,11079,26,37,0,11142,10953,109
23-01-2021,thoothukudi,46,7,8,0,45,15960,7,273,0,16240,16054,141
23-01-2021,tirunelveli,64,10,14,1,59,15087,10,420,0,15517,15245,213
23-01-2021,tiruppur,169,30,34,0,165,17657,30,11,0,17698,17313,220
23-01-2021,trichy,111,7,12,0,106,14530,7,34,0,14571,14286,179
23-01-2021,vellore,125,9,24,0,110,20258,7,375,2,20642,20185,347
23-01-2021,villupuram,42,5,5,0,42,14970,5,174,0,15149,14995,112
23-01-2021,virudhunagar,51,4,9,0,46,16427,4,104,0,16535,16258,231
23-01-2021,airport surveillance (international),4,0,0,0,4,0,0,940,0,940,935,1
23-01-2021,airport surveillance (domestic),2,0,0,0,2,0,0,1033,0,1033,1030,1
23-01-2021,railway surveillance,0,0,0,0,0,0,0,428,0,428,428,0
24-01-2021,ariyalur,10,0,1,0,9,4655,0,20,0,4675,4617,49
24-01-2021,chengalpattu,390,40,37,1,392,51212,40,5,0,51257,50102,763
24-01-2021,chennai,1750,168,225,0,1693,229980,168,47,0,230195,224417,4085
24-01-2021,coimbatore,498,55,73,2,478,53915,55,51,0,54021,52875,668
24-01-2021,cuddalore,35,5,8,0,32,24674,5,202,0,24881,24565,284
24-01-2021,dharmapuri,35,2,4,0,33,6349,2,214,0,6565,6478,54
24-01-2021,dindigul,65,4,2,0,67,11104,4,77,0,11185,10920,198
24-01-2021,erode,131,29,13,0,147,14101,29,94,0,14224,13929,148
24-01-2021,kallakurichi,17,0,4,0,13,10463,0,404,0,10867,10746,108
24-01-2021,kancheepuram,126,23,13,1,135,29136,23,3,0,29162,28588,439
24-01-2021,kanyakumari,85,17,8,0,94,16614,17,109,0,16740,16389,257
24-01-2021,karur,49,3,8,0,44,5324,3,46,0,5373,5279,50
24-01-2021,krishnagiri,35,5,8,0,32,7865,5,169,0,8039,7890,117
24-01-2021,madurai,136,10,16,1,129,20755,10,158,0,20923,20337,457
24-01-2021,nagapattinam,62,8,6,0,64,8298,8,88,0,8394,8198,132
24-01-2021,namakkal,83,13,12,0,84,11423,13,105,0,11541,11347,110
24-01-2021,nilgiris,55,9,9,0,55,8125,9,22,0,8156,8054,47
24-01-2021,perambalur,2,0,0,0,2,2259,0,2,0,2261,2238,21
24-01-2021,pudukottai,28,3,3,0,28,11490,3,33,0,11526,11342,156
24-01-2021,ramanathapuram,20,1,3,0,18,6268,1,133,0,6402,6247,137
24-01-2021,ranipet,36,10,3,0,43,16026,10,49,0,16085,15855,187
24-01-2021,salem,144,19,23,0,140,31857,19,420,0,32296,31691,465
24-01-2021,sivagangai,31,5,6,0,30,6565,5,68,0,6638,6482,126
24-01-2021,tenkasi,47,2,5,0,44,8340,2,49,0,8391,8189,158
24-01-2021,thanjavur,115,13,18,0,110,17582,13,22,0,17617,17263,244
24-01-2021,theni,55,4,8,0,51,17003,4,45,0,17052,16796,205
24-01-2021,thirupathur,22,4,7,0,19,7439,4,110,0,7553,7409,125
24-01-2021,thiruvallur,225,22,26,1,220,43367,22,10,0,43399,42491,688
24-01-2021,thiruvannamalai,35,1,3,0,33,18936,1,393,0,19330,19014,283
24-01-2021,thiruvarur,80,4,6,0,78,11105,4,37,0,11146,10959,109
24-01-2021,thoothukudi,45,9,10,0,44,15967,9,273,0,16249,16064,141
24-01-2021,tirunelveli,59,6,6,0,59,15097,6,420,0,15523,15251,213
24-01-2021,tiruppur,165,36,24,1,176,17687,36,11,0,17734,17337,221
24-01-2021,trichy,106,17,16,0,107,14537,17,34,0,14588,14302,179
24-01-2021,vellore,112,15,13,0,114,20267,12,377,3,20659,20198,347
24-01-2021,villupuram,43,2,6,0,39,14976,2,174,0,15152,15001,112
24-01-2021,virudhunagar,46,5,7,0,44,16431,5,104,0,16540,16265,231
24-01-2021,airport surveillance (international),4,0,2,0,2,0,0,940,0,940,937,1
24-01-2021,airport surveillance (domestic),2,0,0,0,2,0,0,1033,0,1033,1030,1
24-01-2021,railway surveillance,0,0,0,0,0,0,0,428,0,428,428,0
25-01-2021,ariyalur,9,1,1,0,9,4655,1,20,0,4676,4618,49
25-01-2021,chengalpattu,392,38,39,0,391,51252,38,5,0,51295,50141,763
25-01-2021,chennai,1687,157,209,1,1634,230142,157,47,0,230346,224626,4086
25-01-2021,coimbatore,478,56,68,1,465,53970,56,51,0,54077,52943,669
25-01-2021,cuddalore,32,11,7,1,35,24679,11,202,0,24892,24572,285
25-01-2021,dharmapuri,33,3,3,0,33,6351,3,214,0,6568,6481,54
25-01-2021,dindigul,68,8,11,0,65,11109,8,77,0,11194,10931,198
25-01-2021,erode,149,20,11,0,158,14132,20,94,0,14246,13940,148
25-01-2021,kallakurichi,12,0,2,0,10,10462,0,404,0,10866,10748,108
25-01-2021,kancheepuram,134,18,12,0,140,29158,18,3,0,29179,28600,439
25-01-2021,kanyakumari,94,16,14,0,96,16631,16,109,0,16756,16403,257
25-01-2021,karur,44,4,9,0,39,5327,4,46,0,5377,5288,50
25-01-2021,krishnagiri,33,3,4,0,32,7871,3,169,0,8043,7894,117
25-01-2021,madurai,130,11,17,0,124,20766,11,158,0,20935,20354,457
25-01-2021,nagapattinam,64,5,9,0,60,8306,5,88,0,8399,8207,132
25-01-2021,namakkal,85,20,13,0,92,11437,20,105,0,11562,11360,110
25-01-2021,nilgiris,55,6,10,0,51,8134,6,22,0,8162,8064,47
25-01-2021,perambalur,2,0,1,0,1,2259,0,2,0,2261,2239,21
25-01-2021,pudukottai,28,4,4,0,28,11493,4,33,0,11530,11346,156
25-01-2021,ramanathapuram,18,3,2,0,19,6269,3,133,0,6405,6249,137
25-01-2021,ranipet,45,4,7,0,42,16038,4,49,0,16091,15862,187
25-01-2021,salem,138,14,20,0,132,31874,14,420,0,32308,31711,465
25-01-2021,sivagangai,31,6,4,0,33,6571,6,68,0,6645,6486,126
25-01-2021,tenkasi,44,6,2,0,48,8342,6,49,0,8397,8191,158
25-01-2021,thanjavur,112,5,27,0,90,17597,5,22,0,17624,17290,244
25-01-2021,theni,51,1,6,0,46,17007,1,45,0,17053,16802,205
25-01-2021,thirupathur,19,5,4,0,20,7443,5,110,0,7558,7413,125
25-01-2021,thiruvallur,222,25,23,1,223,43391,25,10,0,43426,42514,689
25-01-2021,thiruvannamalai,33,5,3,0,35,18937,5,393,0,19335,19017,283
25-01-2021,thiruvarur,78,9,5,0,82,11109,9,37,0,11155,10964,109
25-01-2021,thoothukudi,44,5,6,0,43,15976,5,273,0,16254,16070,141
25-01-2021,tirunelveli,59,5,3,0,61,15103,5,420,0,15528,15254,213
25-01-2021,tiruppur,175,34,27,0,182,17722,34,11,0,17767,17364,221
25-01-2021,trichy,105,13,15,0,103,14552,11,34,2,14599,14317,179
25-01-2021,vellore,112,6,16,0,102,20277,6,380,0,20663,20214,347
25-01-2021,villupuram,40,11,2,0,49,14979,11,174,0,15164,15003,112
25-01-2021,virudhunagar,45,1,11,0,35,16437,1,104,0,16542,16276,231
25-01-2021,airport surveillance (international),2,0,0,0,2,0,0,940,0,940,937,1
25-01-2021,airport surveillance (domestic),2,1,0,0,3,0,0,1033,1,1034,1030,1
25-01-2021,railway surveillance,0,0,0,0,0,0,0,428,0,428,428,0
26-01-2021,ariyalur,9,1,0,0,10,4656,1,20,0,4677,4618,49
26-01-2021,chengalpattu,395,37,51,1,380,51294,37,5,0,51336,50192,764
26-01-2021,chennai,1642,168,192,2,1616,230307,168,47,0,230522,224818,4088
26-01-2021,coimbatore,465,48,69,1,443,54026,48,51,0,54125,53012,670
26-01-2021,cuddalore,36,4,10,0,30,24691,4,202,0,24897,24582,285
26-01-2021,dharmapuri,33,1,6,0,28,6354,1,214,0,6569,6487,54
26-01-2021,dindigul,65,12,6,0,71,11117,12,77,0,11206,10937,198
26-01-2021,erode,157,21,12,0,166,14151,21,94,0,14266,13952,148
26-01-2021,kallakurichi,10,0,3,0,7,10462,0,404,0,10866,10751,108
26-01-2021,kancheepuram,132,19,14,0,137,29168,19,3,0,29190,28614,439
26-01-2021,kanyakumari,96,17,11,0,102,16647,17,109,0,16773,16414,257
26-01-2021,karur,38,1,7,0,32,5330,1,46,0,5377,5295,50
26-01-2021,krishnagiri,32,5,2,0,35,7874,5,169,0,8048,7896,117
26-01-2021,madurai,120,10,15,0,115,20773,10,158,0,20941,20369,457
26-01-2021,nagapattinam,61,14,4,0,71,8312,14,88,0,8414,8211,132
26-01-2021,namakkal,93,7,12,0,88,11458,7,105,0,11570,11372,110
26-01-2021,nilgiris,51,10,6,0,55,8140,10,22,0,8172,8070,47
26-01-2021,perambalur,1,0,0,0,1,2259,0,2,0,2261,2239,21
26-01-2021,pudukottai,31,3,6,0,28,11500,3,33,0,11536,11352,156
26-01-2021,ramanathapuram,19,2,3,0,18,6272,2,133,0,6407,6252,137
26-01-2021,ranipet,43,5,2,0,46,16043,5,49,0,16097,15864,187
26-01-2021,salem,133,24,16,0,141,31889,24,420,0,32333,31727,465
26-01-2021,sivagangai,32,3,5,0,30,6576,3,68,0,6647,6491,126
26-01-2021,tenkasi,48,5,5,0,48,8348,5,49,0,8402,8196,158
26-01-2021,thanjavur,90,9,23,0,76,17602,9,22,0,17633,17313,244
26-01-2021,theni,46,7,5,0,48,17008,7,45,0,17060,16807,205
26-01-2021,thirupathur,22,1,3,0,20,7450,1,110,0,7561,7416,125
26-01-2021,thiruvallur,217,24,21,0,220,43410,24,10,0,43444,42535,689
26-01-2021,thiruvannamalai,35,2,6,0,31,18942,2,393,0,19337,19023,283
26-01-2021,thiruvarur,81,10,8,0,83,11117,10,37,0,11164,10972,109
26-01-2021,thoothukudi,45,2,4,0,43,15983,2,273,0,16258,16074,141
26-01-2021,tirunelveli,59,9,8,0,60,15106,9,420,0,15535,15262,213
26-01-2021,tiruppur,183,13,21,0,175,17757,13,11,0,17781,17385,221
26-01-2021,trichy,103,14,13,1,103,14563,14,36,0,14613,14330,180
26-01-2021,vellore,101,12,15,0,98,20282,12,380,0,20674,20229,347
26-01-2021,villupuram,49,1,5,0,45,14990,1,174,0,15165,15008,112
26-01-2021,virudhunagar,35,2,6,0,31,16438,2,104,0,16544,16282,231
26-01-2021,airport surveillance (international),2,0,0,0,2,0,0,940,0,940,937,1
26-01-2021,airport surveillance (domestic),3,0,0,0,3,0,0,1034,0,1034,1030,1
26-01-2021,railway surveillance,0,0,0,0,0,0,0,428,0,428,428,0
27-01-2021,ariyalur,10,4,0,0,14,4657,4,20,0,4681,4618,49
27-01-2021,chengalpattu,381,28,58,1,350,51332,28,5,0,51365,50250,765
27-01-2021,chennai,1610,159,162,4,1603,230469,159,47,0,230675,224980,4092
27-01-2021,coimbatore,443,51,65,0,429,54074,51,51,0,54176,53077,670
27-01-2021,cuddalore,30,7,7,0,30,24695,7,202,0,24904,24589,285
27-01-2021,dharmapuri,28,5,3,0,30,6355,5,214,0,6574,6490,54
27-01-2021,dindigul,71,10,8,0,73,11129,10,77,0,11216,10945,198
27-01-2021,erode,166,19,15,2,168,14172,19,94,0,14285,13967,150
27-01-2021,kallakurichi,7,1,2,0,6,10462,1,404,0,10867,10753,108
27-01-2021,kancheepuram,137,21,15,0,143,29187,21,3,0,29211,28629,439
27-01-2021,kanyakumari,102,7,6,0,103,16664,7,109,0,16780,16420,257
27-01-2021,karur,33,3,3,0,33,5332,3,46,0,5381,5298,50
27-01-2021,krishnagiri,35,4,3,0,36,7879,4,169,0,8052,7899,117
27-01-2021,madurai,113,14,17,0,110,20781,14,158,0,20953,20386,457
27-01-2021,nagapattinam,71,7,9,0,69,8326,7,88,0,8421,8220,132
27-01-2021,namakkal,88,14,6,0,96,11465,14,105,0,11584,11378,110
27-01-2021,nilgiris,55,5,3,0,57,8150,5,22,0,8177,8073,47
27-01-2021,perambalur,1,0,0,0,1,2259,0,2,0,2261,2239,21
27-01-2021,pudukottai,25,4,7,0,22,11500,4,33,0,11537,11359,156
27-01-2021,ramanathapuram,19,2,5,0,16,6275,2,133,0,6410,6257,137
27-01-2021,ranipet,45,6,3,0,48,16047,6,49,0,16102,15867,187
27-01-2021,salem,141,14,15,0,140,31913,14,420,0,32347,31742,465
27-01-2021,sivagangai,33,2,6,0,29,6582,2,68,0,6652,6497,126
27-01-2021,tenkasi,48,7,4,0,51,8353,7,49,0,8409,8200,158
27-01-2021,thanjavur,76,3,14,0,65,17611,3,22,0,17636,17327,244
27-01-2021,theni,48,3,6,0,45,17015,3,45,0,17063,16813,205
27-01-2021,thirupathur,20,1,2,0,19,7451,1,110,0,7562,7418,125
27-01-2021,thiruvallur,223,26,25,1,223,43437,26,10,0,43473,42560,690
27-01-2021,thiruvannamalai,31,5,8,0,28,18944,5,393,0,19342,19031,283
27-01-2021,thiruvarur,85,6,12,0,79,11129,6,37,0,11172,10984,109
27-01-2021,thoothukudi,44,3,6,0,41,15986,3,273,0,16262,16080,141
27-01-2021,tirunelveli,59,8,11,0,56,15114,8,420,0,15542,15273,213
27-01-2021,tiruppur,175,23,23,0,175,17770,23,11,0,17804,17408,221
27-01-2021,trichy,102,16,11,0,107,14576,16,36,0,14628,14341,180
27-01-2021,vellore,99,15,9,0,105,20295,12,380,3,20690,20238,347
27-01-2021,villupuram,46,6,7,0,45,14992,6,174,0,15172,15015,112
27-01-2021,virudhunagar,31,1,8,0,24,16440,1,104,0,16545,16290,231
27-01-2021,airport surveillance (international),2,0,0,0,2,0,0,940,0,940,937,1
27-01-2021,airport surveillance (domestic),3,2,0,0,5,0,0,1034,2,1036,1030,1
27-01-2021,railway surveillance,0,0,0,0,0,0,0,428,0,428,428,0
28-01-2021,ariyalur,11,3,1,0,13,4658,3,20,0,4681,4619,49
28-01-2021,chengalpattu,353,41,43,0,351,51363,41,5,0,51409,50293,765
28-01-2021,chennai,1611,151,176,4,1582,230636,151,47,0,230834,225156,4096
28-01-2021,coimbatore,430,48,52,0,426,54126,48,51,0,54225,53129,670
28-01-2021,cuddalore,33,3,4,0,32,24705,3,202,0,24910,24593,285
28-01-2021,dharmapuri,30,3,2,0,31,6360,3,214,0,6577,6492,54
28-01-2021,dindigul,73,15,10,0,78,11139,15,77,0,11231,10955,198
28-01-2021,erode,170,18,12,0,176,14193,18,94,0,14305,13979,150
28-01-2021,kallakurichi,5,0,1,0,4,10462,0,404,0,10866,10754,108
28-01-2021,kancheepuram,136,17,14,0,139,29201,17,3,0,29221,28643,439
28-01-2021,kanyakumari,100,14,7,0,107,16668,14,109,0,16791,16427,257
28-01-2021,karur,33,2,3,0,32,5335,2,46,0,5383,5301,50
28-01-2021,krishnagiri,36,3,8,0,31,7883,3,169,0,8055,7907,117
28-01-2021,madurai,110,13,12,0,111,20795,13,158,0,20966,20398,457
28-01-2021,nagapattinam,68,9,6,0,71,8332,9,88,0,8429,8226,132
28-01-2021,namakkal,96,11,14,0,93,11479,11,105,0,11595,11392,110
28-01-2021,nilgiris,57,10,6,0,61,8155,10,22,0,8187,8079,47
28-01-2021,perambalur,1,2,0,0,3,2259,2,2,0,2263,2239,21
28-01-2021,pudukottai,22,5,5,0,22,11504,5,33,0,11542,11364,156
28-01-2021,ramanathapuram,15,2,1,0,16,6276,2,133,0,6411,6258,137
28-01-2021,ranipet,49,4,6,0,47,16054,4,49,0,16107,15873,187
28-01-2021,salem,140,16,14,0,142,31927,16,420,0,32363,31756,465
28-01-2021,sivagangai,27,1,3,0,25,6582,1,68,0,6651,6500,126
28-01-2021,tenkasi,51,4,7,0,48,8360,4,49,0,8413,8207,158
28-01-2021,thanjavur,65,6,13,1,57,17614,6,22,0,17642,17340,245
28-01-2021,theni,45,4,7,0,42,17018,4,45,0,17067,16820,205
28-01-2021,thirupathur,20,2,3,0,19,7453,2,110,0,7565,7421,125
28-01-2021,thiruvallur,222,14,35,1,200,43462,14,10,0,43486,42595,691
28-01-2021,thiruvannamalai,29,3,3,0,29,18950,3,393,0,19346,19034,283
28-01-2021,thiruvarur,79,5,7,0,77,11135,5,37,0,11177,10991,109
28-01-2021,thoothukudi,43,6,2,0,47,15991,6,273,0,16270,16082,141
28-01-2021,tirunelveli,57,10,9,0,58,15123,10,420,0,15553,15282,213
28-01-2021,tiruppur,175,25,21,0,179,17793,25,11,0,17829,17429,221
28-01-2021,trichy,106,19,13,0,112,14591,19,36,0,14646,14354,180
28-01-2021,vellore,102,7,12,0,97,20304,7,383,0,20694,20250,347
28-01-2021,villupuram,45,3,6,0,42,14998,3,174,0,15175,15021,112
28-01-2021,virudhunagar,24,4,5,0,23,16441,4,104,0,16549,16295,231
28-01-2021,airport surveillance (international),2,0,0,0,2,0,0,940,0,940,937,1
28-01-2021,airport surveillance (domestic),5,0,1,0,4,0,0,1036,0,1036,1031,1
28-01-2021,railway surveillance,0,0,0,0,0,0,0,428,0,428,428,0
29-01-2021,ariyalur,13,4,2,0,15,4661,4,20,0,4685,4621,49
29-01-2021,chengalpattu,351,48,41,1,357,51404,48,5,0,51457,50334,766
29-01-2021,chennai,1582,148,169,1,1560,230787,148,47,0,230982,225325,4097
29-01-2021,coimbatore,426,57,53,1,429,54174,57,51,0,54282,53182,671
29-01-2021,cuddalore,32,10,5,0,37,24708,10,202,0,24920,24598,285
29-01-2021,dharmapuri,31,2,4,0,29,6363,2,214,0,6579,6496,54
29-01-2021,dindigul,78,2,2,0,78,11154,2,77,0,11233,10957,198
29-01-2021,erode,176,20,3,0,193,14211,20,94,0,14325,13982,150
29-01-2021,kallakurichi,4,3,2,0,5,10462,3,404,0,10869,10756,108
29-01-2021,kancheepuram,139,14,13,0,140,29218,14,3,0,29235,28656,439
29-01-2021,kanyakumari,107,10,7,0,110,16682,10,109,0,16801,16434,257
29-01-2021,karur,32,8,6,0,34,5337,8,46,0,5391,5307,50
29-01-2021,krishnagiri,31,9,3,0,37,7886,9,169,0,8064,7910,117
29-01-2021,madurai,111,9,7,0,113,20808,9,158,0,20975,20405,457
29-01-2021,nagapattinam,71,8,8,0,71,8341,8,88,0,8437,8234,132
29-01-2021,namakkal,93,6,8,0,91,11490,6,105,0,11601,11400,110
29-01-2021,nilgiris,61,12,8,0,65,8165,12,22,0,8199,8087,47
29-01-2021,perambalur,3,1,0,0,4,2261,1,2,0,2264,2239,21
29-01-2021,pudukottai,22,6,1,0,27,11509,6,33,0,11548,11365,156
29-01-2021,ramanathapuram,16,0,2,0,14,6278,0,133,0,6411,6260,137
29-01-2021,ranipet,47,3,4,0,46,16058,3,49,0,16110,15877,187
29-01-2021,salem,142,21,30,1,132,31943,21,420,0,32384,31786,466
29-01-2021,sivagangai,25,2,4,0,23,6583,2,68,0,6653,6504,126
29-01-2021,tenkasi,48,1,3,0,46,8364,1,49,0,8414,8210,158
29-01-2021,thanjavur,57,7,6,1,57,17620,7,22,0,17649,17346,246
29-01-2021,theni,42,1,7,0,36,17022,1,45,0,17068,16827,205
29-01-2021,thirupathur,19,1,1,0,19,7455,1,110,0,7566,7422,125
29-01-2021,thiruvallur,200,28,51,0,177,43476,28,10,0,43514,42646,691
29-01-2021,thiruvannamalai,29,2,4,0,27,18953,2,393,0,19348,19038,283
29-01-2021,thiruvarur,77,2,17,0,62,11140,2,37,0,11179,11008,109
29-01-2021,thoothukudi,47,2,4,0,45,15997,2,273,0,16272,16086,141
29-01-2021,tirunelveli,58,8,3,0,63,15133,8,420,0,15561,15285,213
29-01-2021,tiruppur,179,21,23,0,177,17818,21,11,0,17850,17452,221
29-01-2021,trichy,112,9,14,0,107,14610,9,36,0,14655,14368,180
29-01-2021,vellore,97,18,10,1,104,20311,15,383,3,20712,20260,348
29-01-2021,villupuram,42,1,2,0,41,15001,1,174,0,15176,15023,112
29-01-2021,virudhunagar,23,3,4,0,22,16445,3,104,0,16552,16299,231
29-01-2021,airport surveillance (international),2,0,0,0,2,0,0,940,0,940,937,1
29-01-2021,airport surveillance (domestic),4,2,0,0,6,0,0,1036,2,1038,1031,1
29-01-2021,railway surveillance,0,0,0,0,0,0,0,428,0,428,428,0
30-01-2021,ariyalur,16,0,1,0,15,4666,0,20,0,4686,4622,49
30-01-2021,chengalpattu,355,46,56,2,343,51450,46,5,0,51501,50390,768
30-01-2021,chennai,1581,145,162,1,1563,230956,145,47,0,231148,225487,4098
30-01-2021,coimbatore,429,48,55,0,422,54231,48,51,0,54330,53237,671
30-01-2021,cuddalore,39,3,3,0,39,24720,3,202,0,24925,24601,285
30-01-2021,dharmapuri,29,1,2,0,28,6365,1,214,0,6580,6498,54
30-01-2021,dindigul,79,6,6,0,79,11157,6,77,0,11240,10963,198
30-01-2021,erode,190,21,20,0,191,14228,21,94,0,14343,14002,150
30-01-2021,kallakurichi,4,1,2,0,3,10464,1,404,0,10869,10758,108
30-01-2021,kancheepuram,135,15,14,0,136,29227,15,3,0,29245,28670,439
30-01-2021,kanyakumari,110,14,11,0,113,16692,14,109,0,16815,16445,257
30-01-2021,karur,34,5,4,0,35,5345,5,46,0,5396,5311,50
30-01-2021,krishnagiri,37,3,4,0,36,7895,3,169,0,8067,7914,117
30-01-2021,madurai,112,18,14,0,116,20816,18,158,0,20992,20419,457
30-01-2021,nagapattinam,71,7,12,0,66,8349,7,88,0,8444,8246,132
30-01-2021,namakkal,91,11,12,1,89,11496,10,105,1,11612,11412,111
30-01-2021,nilgiris,65,4,6,0,63,8177,4,22,0,8203,8093,47
30-01-2021,perambalur,3,0,0,0,3,2261,0,2,0,2263,2239,21
30-01-2021,pudukottai,27,7,2,0,32,11515,7,33,0,11555,11367,156
30-01-2021,ramanathapuram,14,0,3,0,11,6278,0,133,0,6411,6263,137
30-01-2021,ranipet,46,4,6,0,44,16061,4,49,0,16114,15883,187
30-01-2021,salem,132,20,21,0,131,31964,20,420,0,32404,31807,466
30-01-2021,sivagangai,23,4,2,0,25,6585,4,68,0,6657,6506,126
30-01-2021,tenkasi,46,2,6,0,42,8365,2,49,0,8416,8216,158
30-01-2021,thanjavur,57,14,8,0,63,17627,14,22,0,17663,17354,246
30-01-2021,theni,36,3,6,0,33,17023,3,45,0,17071,16833,205
30-01-2021,thirupathur,21,2,3,1,19,7458,2,110,0,7570,7425,126
30-01-2021,thiruvallur,167,23,27,0,163,43494,23,10,0,43527,42673,691
30-01-2021,thiruvannamalai,27,5,3,0,29,18955,5,393,0,19353,19041,283
30-01-2021,thiruvarur,60,5,3,0,62,11140,5,37,0,11182,11011,109
30-01-2021,thoothukudi,45,1,6,0,40,15999,1,273,0,16273,16092,141
30-01-2021,tirunelveli,62,7,5,0,64,15140,7,420,0,15567,15290,213
30-01-2021,tiruppur,179,20,16,0,183,17841,20,11,0,17872,17468,221
30-01-2021,trichy,105,14,9,0,110,14617,14,36,0,14667,14377,180
30-01-2021,vellore,103,13,10,0,106,20325,12,386,1,20724,20270,348
30-01-2021,villupuram,40,5,4,0,41,15001,5,174,0,15180,15027,112
30-01-2021,virudhunagar,23,8,2,0,29,16449,8,104,0,16561,16301,231
30-01-2021,airport surveillance (international),2,0,0,0,2,0,0,940,0,940,937,1
30-01-2021,airport surveillance (domestic),6,0,0,0,6,0,0,1038,0,1038,1031,1
30-01-2021,railway surveillance,0,0,0,0,0,0,0,428,0,428,428,0
31-01-2021,ariyalur,16,3,2,0,17,4667,3,20,0,4690,4624,49
31-01-2021,chengalpattu,344,38,62,0,320,51497,38,5,0,51540,50452,768
31-01-2021,chennai,1560,141,143,4,1554,231098,141,47,0,231286,225630,4102
31-01-2021,coimbatore,423,53,52,0,424,54280,53,51,0,54384,53289,671
31-01-2021,cuddalore,39,9,2,0,46,24723,9,202,0,24934,24603,285
31-01-2021,dharmapuri,27,3,5,0,25,6365,3,214,0,6582,6503,54
31-01-2021,dindigul,79,13,9,1,82,11163,13,77,0,11253,10972,199
31-01-2021,erode,189,20,23,0,186,14247,20,94,0,14361,14025,150
31-01-2021,kallakurichi,3,3,1,0,5,10465,3,404,0,10872,10759,108
31-01-2021,kancheepuram,136,18,12,0,142,29242,18,3,0,29263,28682,439
31-01-2021,kanyakumari,113,10,8,0,115,16706,10,109,0,16825,16453,257
31-01-2021,karur,34,1,5,0,30,5349,1,46,0,5396,5316,50
31-01-2021,krishnagiri,37,4,2,0,39,7899,4,169,0,8072,7916,117
31-01-2021,madurai,115,12,18,0,109,20833,12,158,0,21003,20437,457
31-01-2021,nagapattinam,66,3,7,0,62,8356,3,88,0,8447,8253,132
31-01-2021,namakkal,92,22,10,0,104,11509,22,106,0,11637,11422,111
31-01-2021,nilgiris,63,6,2,0,67,8181,6,22,0,8209,8095,47
31-01-2021,perambalur,3,3,0,0,6,2261,3,2,0,2266,2239,21
31-01-2021,pudukottai,32,6,2,0,36,11522,6,33,0,11561,11369,156
31-01-2021,ramanathapuram,11,1,1,0,11,6278,1,133,0,6412,6264,137
31-01-2021,ranipet,44,8,8,0,44,16065,8,49,0,16122,15891,187
31-01-2021,salem,132,13,17,0,128,31985,13,420,0,32418,31824,466
31-01-2021,sivagangai,24,1,1,0,24,6588,1,68,0,6657,6507,126
31-01-2021,tenkasi,42,4,8,0,38,8367,4,49,0,8420,8224,158
31-01-2021,thanjavur,64,10,15,1,58,17642,10,22,0,17674,17369,247
31-01-2021,theni,33,4,7,0,30,17026,4,45,0,17075,16840,205
31-01-2021,thirupathur,19,0,3,0,16,7460,0,110,0,7570,7428,126
31-01-2021,thiruvallur,164,19,29,0,154,43518,19,10,0,43547,42702,691
31-01-2021,thiruvannamalai,29,4,2,0,31,18960,4,393,0,19357,19043,283
31-01-2021,thiruvarur,62,9,11,0,60,11145,9,37,0,11191,11022,109
31-01-2021,thoothukudi,40,2,3,0,39,16000,2,273,0,16275,16095,141
31-01-2021,tirunelveli,62,8,4,0,66,15145,8,420,0,15573,15294,213
31-01-2021,tiruppur,183,21,9,0,195,17861,21,11,0,17893,17477,221
31-01-2021,trichy,111,10,12,0,109,14632,10,36,0,14678,14389,180
31-01-2021,vellore,106,19,15,0,110,20337,19,387,0,20743,20285,348
31-01-2021,villupuram,41,4,7,0,38,15006,4,174,0,15184,15034,112
31-01-2021,virudhunagar,29,3,6,0,26,16457,3,104,0,16564,16307,231
31-01-2021,airport surveillance (international),2,0,0,0,2,0,0,940,0,940,937,1
31-01-2021,airport surveillance (domestic),6,0,0,0,6,0,0,1038,0,1038,1031,1
31-01-2021,railway surveillance,0,0,0,0,0,0,0,428,0,428,428,0
01-02-2021,ariyalur,16,5,4,0,17,4669,5,20,0,4694,4628,49
01-02-2021,chengalpattu,329,30,60,0,299,51544,30,5,0,51579,50512,768
01-02-2021,chennai,1558,134,99,7,1586,231243,134,47,0,231424,225729,4109
01-02-2021,coimbatore,425,59,62,0,422,54334,59,51,0,54444,53351,671
01-02-2021,cuddalore,46,6,3,0,49,24732,6,202,0,24940,24606,285
01-02-2021,dharmapuri,25,5,3,0,27,6368,5,214,0,6587,6506,54
01-02-2021,dindigul,82,15,12,0,85,11176,15,77,0,11268,10984,199
01-02-2021,erode,185,24,24,0,185,14266,24,94,0,14384,14049,150
01-02-2021,kallakurichi,6,2,0,0,8,10469,2,404,0,10875,10759,108
01-02-2021,kancheepuram,134,10,11,0,133,29252,10,3,0,29265,28693,439
01-02-2021,kanyakumari,115,13,14,0,114,16716,13,109,0,16838,16467,257
01-02-2021,karur,30,4,4,0,30,5350,4,46,0,5400,5320,50
01-02-2021,krishnagiri,38,6,4,0,40,7902,6,169,0,8077,7920,117
01-02-2021,madurai,110,7,21,0,96,20846,7,158,0,21011,20458,457
01-02-2021,nagapattinam,62,3,3,0,62,8359,3,88,0,8450,8256,132
01-02-2021,namakkal,104,9,13,0,100,11531,9,106,0,11646,11435,111
01-02-2021,nilgiris,67,1,14,0,54,8187,1,22,0,8210,8109,47
01-02-2021,perambalur,5,2,0,0,7,2263,2,2,0,2267,2239,21
01-02-2021,pudukottai,36,8,6,0,38,11528,8,33,0,11569,11375,156
01-02-2021,ramanathapuram,11,2,1,0,12,6279,2,133,0,6414,6265,137
01-02-2021,ranipet,43,4,5,0,42,16072,4,49,0,16125,15896,187
01-02-2021,salem,129,9,15,0,123,31999,9,420,0,32428,31839,466
01-02-2021,sivagangai,24,3,2,0,25,6589,3,68,0,6660,6509,126
01-02-2021,tenkasi,39,8,9,0,38,8372,8,49,0,8429,8233,158
01-02-2021,thanjavur,56,25,7,0,74,17650,25,22,0,17697,17376,247
01-02-2021,theni,30,3,9,0,24,17030,3,45,0,17078,16849,205
01-02-2021,thirupathur,17,8,2,0,23,7461,8,110,0,7579,7430,126
01-02-2021,thiruvallur,153,17,31,0,139,43536,17,10,0,43563,42733,691
01-02-2021,thiruvannamalai,31,5,4,0,32,18964,5,393,0,19362,19047,283
01-02-2021,thiruvarur,60,10,13,0,57,11154,10,37,0,11201,11035,109
01-02-2021,thoothukudi,39,2,4,0,37,16002,2,273,0,16277,16099,141
01-02-2021,tirunelveli,66,4,6,0,64,15153,4,420,0,15577,15300,213
01-02-2021,tiruppur,195,27,11,0,211,17882,27,11,0,17920,17488,221
01-02-2021,trichy,107,11,14,0,104,14640,11,36,0,14687,14403,180
01-02-2021,vellore,110,8,14,0,104,20356,8,387,0,20751,20299,348
01-02-2021,villupuram,37,8,5,0,40,15009,8,174,0,15191,15039,112
01-02-2021,virudhunagar,26,5,8,0,23,16460,5,104,0,16569,16315,231
01-02-2021,airport surveillance (international),2,0,0,0,2,0,0,940,0,940,937,1
01-02-2021,airport surveillance (domestic),6,0,0,0,6,0,0,1038,0,1038,1031,1
01-02-2021,railway surveillance,0,0,0,0,0,0,0,428,0,428,428,0
02-02-2021,ariyalur,17,4,1,0,20,4674,4,20,0,4698,4629,49
02-02-2021,chengalpattu,300,27,32,0,295,51575,27,5,0,51607,50544,768
02-02-2021,chennai,1583,142,140,1,1584,231374,142,47,0,231563,225869,4110
02-02-2021,coimbatore,424,54,56,0,422,54395,54,51,0,54500,53407,671
02-02-2021,cuddalore,49,2,5,0,46,24738,2,202,0,24942,24611,285
02-02-2021,dharmapuri,27,6,4,0,29,6373,6,214,0,6593,6510,54
02-02-2021,dindigul,84,7,10,0,81,11190,7,77,0,11274,10994,199
02-02-2021,erode,184,27,29,0,182,14289,27,94,0,14410,14078,150
02-02-2021,kallakurichi,9,2,0,0,11,10472,2,404,0,10878,10759,108
02-02-2021,kancheepuram,132,17,15,0,134,29261,17,3,0,29281,28708,439
02-02-2021,kanyakumari,114,9,21,1,101,16729,9,109,0,16847,16488,258
02-02-2021,karur,30,6,3,0,33,5354,6,46,0,5406,5323,50
02-02-2021,krishnagiri,40,5,5,0,40,7908,5,169,0,8082,7925,117
02-02-2021,madurai,96,14,13,0,97,20853,14,158,0,21025,20471,457
02-02-2021,nagapattinam,63,4,8,0,59,8363,4,88,0,8455,8264,132
02-02-2021,namakkal,101,12,16,0,97,11541,12,106,0,11659,11451,111
02-02-2021,nilgiris,53,6,6,0,53,8187,6,22,0,8215,8115,47
02-02-2021,perambalur,7,0,1,0,6,2265,0,2,0,2267,2240,21
02-02-2021,pudukottai,39,4,3,0,40,11537,4,33,0,11574,11378,156
02-02-2021,ramanathapuram,13,1,3,0,11,6282,1,133,0,6416,6268,137
02-02-2021,ranipet,42,6,6,0,42,16076,6,49,0,16131,15902,187
02-02-2021,salem,123,17,11,0,129,32008,17,420,0,32445,31850,466
02-02-2021,sivagangai,25,5,6,1,23,6592,5,68,0,6665,6515,127
02-02-2021,tenkasi,37,3,6,1,33,8379,3,49,0,8431,8239,159
02-02-2021,thanjavur,74,18,6,0,86,17675,18,22,0,17715,17382,247
02-02-2021,theni,25,2,2,0,25,17034,2,45,0,17081,16851,205
02-02-2021,thirupathur,23,3,4,0,22,7469,3,110,0,7582,7434,126
02-02-2021,thiruvallur,137,33,16,0,154,43551,33,10,0,43594,42749,691
02-02-2021,thiruvannamalai,32,3,5,0,30,18969,3,393,0,19365,19052,283
02-02-2021,thiruvarur,57,5,10,0,52,11164,4,37,1,11206,11045,109
02-02-2021,thoothukudi,37,3,14,0,26,16004,3,273,0,16280,16113,141
02-02-2021,tirunelveli,65,12,8,0,69,15158,12,420,0,15590,15308,213
02-02-2021,tiruppur,210,24,24,0,210,17908,24,11,0,17943,17512,221
02-02-2021,trichy,104,12,8,0,108,14651,12,36,0,14699,14411,180
02-02-2021,vellore,105,7,11,0,101,20365,6,387,1,20759,20310,348
02-02-2021,villupuram,40,4,9,0,35,15017,4,174,0,15195,15048,112
02-02-2021,virudhunagar,23,4,2,0,25,16465,4,104,0,16573,16317,231
02-02-2021,airport surveillance (international),2,0,0,0,2,0,0,940,0,940,937,1
02-02-2021,airport surveillance (domestic),6,0,2,0,4,0,0,1038,0,1038,1033,1
02-02-2021,railway surveillance,0,0,0,0,0,0,0,428,0,428,428,0
03-02-2021,ariyalur,18,1,2,0,17,4676,1,20,0,4697,4631,49
03-02-2021,chengalpattu,303,25,40,1,287,51611,25,5,0,51641,50584,770
03-02-2021,chennai,1587,145,144,1,1587,231519,145,47,0,231711,226013,4111
03-02-2021,coimbatore,423,74,54,0,443,54450,74,51,0,54575,53461,671
03-02-2021,cuddalore,46,6,6,0,46,24740,6,202,0,24948,24617,285
03-02-2021,dharmapuri,29,1,6,0,24,6379,1,214,0,6594,6516,54
03-02-2021,dindigul,81,3,12,0,72,11197,3,77,0,11277,11006,199
03-02-2021,erode,183,17,20,0,180,14317,17,94,0,14428,14098,150
03-02-2021,kallakurichi,11,0,1,0,10,10474,0,404,0,10878,10760,108
03-02-2021,kancheepuram,122,19,20,0,121,29266,19,3,0,29288,28728,439
03-02-2021,kanyakumari,101,15,15,0,101,16738,15,109,0,16862,16503,258
03-02-2021,karur,33,7,2,0,38,5360,7,46,0,5413,5325,50
03-02-2021,krishnagiri,40,2,7,0,35,7913,2,169,0,8084,7932,117
03-02-2021,madurai,97,8,15,1,89,20867,8,158,0,21033,20486,458
03-02-2021,nagapattinam,59,10,9,1,59,8367,10,88,0,8465,8273,133
03-02-2021,namakkal,93,9,12,0,90,11549,9,106,0,11664,11463,111
03-02-2021,nilgiris,53,8,3,0,58,8193,8,22,0,8223,8118,47
03-02-2021,perambalur,7,1,1,0,7,2266,1,2,0,2269,2241,21
03-02-2021,pudukottai,40,2,2,0,40,11541,2,33,0,11576,11380,156
03-02-2021,ramanathapuram,12,0,3,0,9,6284,0,133,0,6417,6271,137
03-02-2021,ranipet,41,4,10,0,35,16081,4,49,0,16134,15912,187
03-02-2021,salem,131,10,19,0,122,32027,10,420,0,32457,31869,466
03-02-2021,sivagangai,24,7,5,0,26,6597,7,68,0,6672,6520,126
03-02-2021,tenkasi,34,3,5,0,32,8383,3,49,0,8435,8244,159
03-02-2021,thanjavur,88,30,7,0,111,17695,30,22,0,17747,17389,247
03-02-2021,theni,25,5,5,0,25,17036,5,45,0,17086,16856,205
03-02-2021,thirupathur,22,2,3,0,21,7472,2,110,0,7584,7437,126
03-02-2021,thiruvallur,152,34,21,0,165,43582,34,10,0,43626,42770,691
03-02-2021,thiruvannamalai,30,4,3,0,31,18972,4,393,0,19369,19055,283
03-02-2021,thiruvarur,52,4,9,0,47,11168,4,38,0,11210,11054,109
03-02-2021,thoothukudi,27,2,10,0,19,16008,2,273,0,16283,16123,141
03-02-2021,tirunelveli,68,11,11,0,68,15169,11,420,0,15600,15319,213
03-02-2021,tiruppur,210,22,19,0,213,17932,22,11,0,17965,17531,221
03-02-2021,trichy,107,10,13,0,104,14662,10,36,0,14708,14424,180
03-02-2021,vellore,102,9,9,0,102,20372,7,388,2,20769,20319,348
03-02-2021,villupuram,35,2,5,0,32,15021,2,174,0,15197,15053,112
03-02-2021,virudhunagar,25,2,5,0,22,16469,2,104,0,16575,16322,231
03-02-2021,airport surveillance (international),2,0,0,0,2,0,0,940,0,940,937,1
03-02-2021,airport surveillance (domestic),4,0,0,0,4,0,0,1038,0,1038,1033,1
03-02-2021,railway surveillance,0,0,0,0,0,0,0,428,0,428,428,0
04-02-2021,ariyalur,19,2,2,0,19,4679,2,20,0,4701,4633,49
04-02-2021,chengalpattu,290,28,34,0,284,51639,28,5,0,51672,50618,770
04-02-2021,chennai,1582,149,159,0,1572,231659,149,47,0,231855,226172,4111
04-02-2021,coimbatore,444,58,55,1,446,54525,58,51,0,54634,53516,672
04-02-2021,cuddalore,47,25,7,1,64,24747,25,202,0,24974,24624,286
04-02-2021,dharmapuri,24,3,2,0,25,6380,3,214,0,6597,6518,54
04-02-2021,dindigul,72,6,15,0,63,11200,6,77,0,11283,11021,199
04-02-2021,erode,179,22,25,0,176,14333,22,94,0,14449,14123,150
04-02-2021,kallakurichi,10,1,5,0,6,10474,1,404,0,10879,10765,108
04-02-2021,kancheepuram,123,9,27,1,104,29287,9,3,0,29299,28755,440
04-02-2021,kanyakumari,98,16,11,1,102,16750,16,109,0,16875,16514,259
04-02-2021,karur,38,5,5,0,38,5367,5,46,0,5418,5330,50
04-02-2021,krishnagiri,35,3,3,0,35,7915,3,169,0,8087,7935,117
04-02-2021,madurai,88,14,8,0,94,20874,14,158,0,21046,20494,458
04-02-2021,nagapattinam,59,3,7,0,55,8377,3,88,0,8468,8280,133
04-02-2021,namakkal,90,10,7,0,93,11558,10,106,0,11674,11470,111
04-02-2021,nilgiris,58,5,8,0,55,8201,5,22,0,8228,8126,47
04-02-2021,perambalur,7,0,1,0,6,2267,0,2,0,2269,2242,21
04-02-2021,pudukottai,40,1,4,0,37,11543,1,33,0,11577,11384,156
04-02-2021,ramanathapuram,10,1,3,0,8,6285,1,133,0,6419,6274,137
04-02-2021,ranipet,34,7,2,0,39,16084,7,49,0,16140,15914,187
04-02-2021,salem,122,12,16,0,118,32037,12,420,0,32469,31885,466
04-02-2021,sivagangai,27,4,3,0,28,6605,4,68,0,6677,6523,126
04-02-2021,tenkasi,31,4,4,0,31,8385,4,49,0,8438,8248,159
04-02-2021,thanjavur,113,3,8,0,108,17727,3,22,0,17752,17397,247
04-02-2021,theni,25,4,2,0,27,17041,4,45,0,17090,16858,205
04-02-2021,thirupathur,21,3,3,0,21,7474,3,110,0,7587,7440,126
04-02-2021,thiruvallur,159,29,13,0,175,43610,29,10,0,43649,42783,691
04-02-2021,thiruvannamalai,31,18,3,0,46,18976,18,393,0,19387,19058,283
04-02-2021,thiruvarur,47,10,4,0,53,11172,10,38,0,11220,11058,109
04-02-2021,thoothukudi,19,1,2,0,18,16010,1,273,0,16284,16125,141
04-02-2021,tirunelveli,69,1,3,0,67,15181,1,420,0,15602,15322,213
04-02-2021,tiruppur,214,17,24,0,207,17955,17,11,0,17983,17555,221
04-02-2021,trichy,106,11,20,0,97,14674,10,36,1,14721,14444,180
04-02-2021,vellore,103,8,16,0,95,20380,6,390,2,20778,20335,348
04-02-2021,villupuram,32,0,0,0,32,15023,0,174,0,15197,15053,112
04-02-2021,virudhunagar,22,0,4,0,18,16471,0,104,0,16575,16326,231
04-02-2021,airport surveillance (international),2,1,0,0,3,0,0,940,1,941,937,1
04-02-2021,airport surveillance (domestic),4,0,2,0,2,0,0,1038,0,1038,1035,1
04-02-2021,railway surveillance,0,0,0,0,0,0,0,428,0,428,428,0
05-02-2021,ariyalur,19,3,1,0,21,4681,3,20,0,4704,4634,49
05-02-2021,chengalpattu,284,45,32,0,297,51667,45,5,0,51717,50650,770
05-02-2021,chennai,1572,158,153,2,1575,231808,158,47,0,232013,226325,4113
05-02-2021,coimbatore,446,54,41,1,458,54583,54,51,0,54688,53557,673
05-02-2021,cuddalore,64,4,5,0,63,24772,4,202,0,24978,24629,286
05-02-2021,dharmapuri,25,1,3,0,23,6383,1,214,0,6598,6521,54
05-02-2021,dindigul,63,9,8,0,64,11206,9,77,0,11292,11029,199
05-02-2021,erode,176,23,21,0,178,14355,23,94,0,14472,14144,150
05-02-2021,kallakurichi,6,0,2,0,4,10475,0,404,0,10879,10767,108
05-02-2021,kancheepuram,104,15,8,0,111,29296,15,3,0,29314,28763,440
05-02-2021,kanyakumari,102,2,14,0,90,16766,2,109,0,16877,16528,259
05-02-2021,karur,38,1,4,0,35,5372,1,46,0,5419,5334,50
05-02-2021,krishnagiri,35,0,4,0,31,7918,0,169,0,8087,7939,117
05-02-2021,madurai,94,9,11,0,92,20888,9,158,0,21055,20505,458
05-02-2021,nagapattinam,55,8,15,0,48,8380,8,88,0,8476,8295,133
05-02-2021,namakkal,93,2,16,0,79,11568,2,106,0,11676,11486,111
05-02-2021,nilgiris,55,5,9,0,51,8206,5,22,0,8233,8135,47
05-02-2021,perambalur,6,0,0,0,6,2267,0,2,0,2269,2242,21
05-02-2021,pudukottai,37,1,3,0,35,11544,1,33,0,11578,11387,156
05-02-2021,ramanathapuram,8,1,2,0,7,6286,1,133,0,6420,6276,137
05-02-2021,ranipet,39,3,4,0,38,16091,3,49,0,16143,15918,187
05-02-2021,salem,118,9,14,0,113,32049,9,420,0,32478,31899,466
05-02-2021,sivagangai,28,0,5,0,23,6609,0,68,0,6677,6528,126
05-02-2021,tenkasi,31,1,7,0,25,8389,1,49,0,8439,8255,159
05-02-2021,thanjavur,108,20,5,1,122,17730,20,22,0,17772,17402,248
05-02-2021,theni,27,6,6,0,27,17045,6,45,0,17096,16864,205
05-02-2021,thirupathur,21,5,4,0,22,7477,5,110,0,7592,7444,126
05-02-2021,thiruvallur,175,35,11,0,199,43639,35,10,0,43684,42794,691
05-02-2021,thiruvannamalai,46,3,4,0,45,18994,3,393,0,19390,19062,283
05-02-2021,thiruvarur,53,8,8,0,53,11182,8,38,0,11228,11066,109
05-02-2021,thoothukudi,18,1,5,0,14,16011,1,273,0,16285,16130,141
05-02-2021,tirunelveli,67,6,11,0,62,15182,6,420,0,15608,15333,213
05-02-2021,tiruppur,207,13,29,0,191,17972,13,11,0,17996,17584,221
05-02-2021,trichy,97,20,23,0,94,14684,20,37,0,14741,14467,180
05-02-2021,vellore,95,6,11,0,90,20386,4,392,2,20784,20346,348
05-02-2021,villupuram,32,2,6,0,28,15023,2,174,0,15199,15059,112
05-02-2021,virudhunagar,18,9,1,0,26,16471,9,104,0,16584,16327,231
05-02-2021,airport surveillance (international),3,0,0,0,3,0,0,941,0,941,937,1
05-02-2021,airport surveillance (domestic),2,1,0,0,3,0,0,1038,1,1039,1035,1
05-02-2021,railway surveillance,0,0,0,0,0,0,0,428,0,428,428,0
06-02-2021,ariyalur,23,1,4,0,20,4686,1,20,0,4707,4638,49
06-02-2021,chengalpattu,308,36,47,0,297,51723,36,5,0,51764,50697,770
06-02-2021,chennai,1574,156,162,1,1567,231965,156,47,0,232168,226487,4114
06-02-2021,coimbatore,458,65,49,0,474,54637,65,51,0,54753,53606,673
06-02-2021,cuddalore,65,5,7,1,62,24778,5,202,0,24985,24636,287
06-02-2021,dharmapuri,23,2,2,0,23,6384,2,214,0,6600,6523,54
06-02-2021,dindigul,63,3,4,0,62,11214,3,77,0,11294,11033,199
06-02-2021,erode,173,20,20,0,173,14373,20,94,0,14487,14164,150
06-02-2021,kallakurichi,5,3,2,0,6,10476,3,404,0,10883,10769,108
06-02-2021,kancheepuram,105,12,7,0,110,29305,12,3,0,29320,28770,440
06-02-2021,kanyakumari,90,12,9,0,93,16768,12,109,0,16889,16537,259
06-02-2021,karur,36,5,5,0,36,5374,5,46,0,5425,5339,50
06-02-2021,krishnagiri,32,1,6,0,27,7919,1,169,0,8089,7945,117
06-02-2021,madurai,95,18,12,1,100,20900,18,158,0,21076,20517,459
06-02-2021,nagapattinam,49,9,11,0,47,8389,9,88,0,8486,8306,133
06-02-2021,namakkal,80,1,5,0,76,11571,1,106,0,11678,11491,111
06-02-2021,nilgiris,51,7,11,0,47,8211,7,22,0,8240,8146,47
06-02-2021,perambalur,6,0,1,0,5,2267,0,2,0,2269,2243,21
06-02-2021,pudukottai,36,2,5,0,33,11546,2,33,0,11581,11392,156
06-02-2021,ramanathapuram,7,3,1,0,9,6287,3,133,0,6423,6277,137
06-02-2021,ranipet,38,1,3,0,36,16094,1,49,0,16144,15921,187
06-02-2021,salem,114,7,17,0,104,32059,7,420,0,32486,31916,466
06-02-2021,sivagangai,24,3,2,0,25,6610,3,68,0,6681,6530,126
06-02-2021,tenkasi,25,1,1,0,25,8390,1,49,0,8440,8256,159
06-02-2021,thanjavur,116,10,4,0,122,17744,10,22,0,17776,17406,248
06-02-2021,theni,27,5,3,0,29,17051,5,45,0,17101,16867,205
06-02-2021,thirupathur,22,1,2,0,21,7482,1,110,0,7593,7446,126
06-02-2021,thiruvallur,184,26,12,0,198,43659,26,10,0,43695,42806,691
06-02-2021,thiruvannamalai,47,2,4,0,45,18999,2,393,0,19394,19066,283
06-02-2021,thiruvarur,54,3,4,0,53,11191,3,38,0,11232,11070,109
06-02-2021,thoothukudi,17,1,4,0,14,16015,1,273,0,16289,16134,141
06-02-2021,tirunelveli,59,12,9,0,62,15185,12,420,0,15617,15342,213
06-02-2021,tiruppur,193,16,35,0,174,17987,16,11,0,18014,17619,221
06-02-2021,trichy,93,10,10,0,93,14703,10,37,0,14750,14477,180
06-02-2021,vellore,91,10,16,0,85,20391,4,394,6,20795,20362,348
06-02-2021,villupuram,28,4,4,0,28,15025,4,174,0,15203,15063,112
06-02-2021,virudhunagar,29,4,1,0,32,16483,4,104,0,16591,16328,231
06-02-2021,airport surveillance (international),3,0,0,0,3,0,0,941,0,941,937,1
06-02-2021,airport surveillance (domestic),3,0,2,0,1,0,0,1039,0,1039,1037,1
06-02-2021,railway surveillance,0,0,0,0,0,0,0,428,0,428,428,0
07-02-2021,ariyalur,20,0,2,0,18,4687,0,20,0,4707,4640,49
07-02-2021,chengalpattu,303,25,52,0,276,51765,25,5,0,51795,50749,770
07-02-2021,chennai,1564,151,156,0,1559,232118,151,47,0,232316,226643,4114
07-02-2021,coimbatore,474,48,56,1,465,54702,48,51,0,54801,53662,674
07-02-2021,cuddalore,62,14,4,0,72,24783,14,202,0,24999,24640,287
07-02-2021,dharmapuri,23,1,3,0,21,6386,1,214,0,6601,6526,54
07-02-2021,dindigul,62,11,6,0,67,11217,11,77,0,11305,11039,199
07-02-2021,erode,173,22,19,0,176,14393,22,94,0,14509,14183,150
07-02-2021,kallakurichi,8,1,1,0,8,10481,1,404,0,10886,10770,108
07-02-2021,kancheepuram,105,10,8,0,107,29312,10,3,0,29325,28778,440
07-02-2021,kanyakumari,93,8,16,0,85,16780,8,109,0,16897,16553,259
07-02-2021,karur,36,2,4,0,34,5379,2,46,0,5427,5343,50
07-02-2021,krishnagiri,27,5,7,0,25,7920,5,169,0,8094,7952,117
07-02-2021,madurai,98,10,11,0,97,20916,10,158,0,21084,20528,459
07-02-2021,nagapattinam,47,2,5,0,44,8398,2,88,0,8488,8311,133
07-02-2021,namakkal,76,9,7,0,78,11572,9,106,0,11687,11498,111
07-02-2021,nilgiris,47,5,9,0,43,8218,5,22,0,8245,8155,47
07-02-2021,perambalur,5,1,0,0,6,2267,1,2,0,2270,2243,21
07-02-2021,pudukottai,33,0,6,0,27,11548,0,33,0,11581,11398,156
07-02-2021,ramanathapuram,10,0,1,0,9,6291,0,133,0,6424,6278,137
07-02-2021,ranipet,36,2,2,0,36,16095,2,49,0,16146,15923,187
07-02-2021,salem,104,12,21,0,95,32066,12,420,0,32498,31937,466
07-02-2021,sivagangai,24,1,1,0,24,6612,1,68,0,6681,6531,126
07-02-2021,tenkasi,25,9,2,0,32,8391,9,49,0,8449,8258,159
07-02-2021,thanjavur,122,29,6,0,145,17754,29,22,0,17805,17412,248
07-02-2021,theni,29,3,1,0,31,17056,3,45,0,17104,16868,205
07-02-2021,thirupathur,21,4,1,0,24,7483,4,110,0,7597,7447,126
07-02-2021,thiruvallur,199,22,9,0,212,43686,22,10,0,43718,42815,691
07-02-2021,thiruvannamalai,45,1,5,0,41,19001,1,393,0,19395,19071,283
07-02-2021,thiruvarur,54,5,6,0,53,11195,5,38,0,11238,11076,109
07-02-2021,thoothukudi,14,1,2,0,13,16016,1,273,0,16290,16136,141
07-02-2021,tirunelveli,64,5,7,0,62,15199,5,420,0,15624,15349,213
07-02-2021,tiruppur,174,13,32,0,155,18003,13,11,0,18027,17651,221
07-02-2021,trichy,91,18,8,0,101,14711,17,37,1,14766,14485,180
07-02-2021,vellore,85,14,14,0,85,20395,14,400,0,20809,20376,348
07-02-2021,villupuram,26,5,2,0,29,15027,5,174,0,15206,15065,112
07-02-2021,virudhunagar,34,1,6,0,29,16489,1,104,0,16594,16334,231
07-02-2021,airport surveillance (international),3,1,0,0,4,0,0,941,1,942,937,1
07-02-2021,airport surveillance (domestic),1,0,0,0,1,0,0,1039,0,1039,1037,1
07-02-2021,railway surveillance,0,0,0,0,0,0,0,428,0,428,428,0
08-02-2021,ariyalur,18,1,1,0,18,4687,1,20,0,4708,4641,49
08-02-2021,chengalpattu,293,28,51,0,270,51807,28,5,0,51840,50800,770
08-02-2021,chennai,1564,143,154,2,1551,232274,143,47,0,232464,226797,4116
08-02-2021,coimbatore,466,49,60,0,455,54751,49,51,0,54851,53722,674
08-02-2021,cuddalore,73,11,6,0,78,24798,11,202,0,25011,24646,287
08-02-2021,dharmapuri,21,1,1,0,21,6387,1,214,0,6602,6527,54
08-02-2021,dindigul,67,4,12,0,59,11228,4,77,0,11309,11051,199
08-02-2021,erode,176,17,10,0,183,14415,17,94,0,14526,14193,150
08-02-2021,kallakurichi,8,1,0,0,9,10482,1,404,0,10887,10770,108
08-02-2021,kancheepuram,92,18,7,0,103,29307,18,3,0,29328,28785,440
08-02-2021,kanyakumari,85,16,10,0,91,16788,16,109,0,16913,16563,259
08-02-2021,karur,34,1,3,0,32,5381,1,46,0,5428,5346,50
08-02-2021,krishnagiri,25,4,4,0,25,7925,4,169,0,8098,7956,117
08-02-2021,madurai,95,7,12,0,90,20924,7,158,0,21089,20540,459
08-02-2021,nagapattinam,45,4,2,0,47,8401,3,88,1,8493,8313,133
08-02-2021,namakkal,78,12,11,0,79,11581,12,106,0,11699,11509,111
08-02-2021,nilgiris,43,3,6,0,40,8223,3,22,0,8248,8161,47
08-02-2021,perambalur,6,1,2,0,5,2268,1,2,0,2271,2245,21
08-02-2021,pudukottai,27,2,4,0,25,11548,2,33,0,11583,11402,156
08-02-2021,ramanathapuram,9,2,1,0,10,6291,2,133,0,6426,6279,137
08-02-2021,ranipet,36,4,10,1,29,16097,4,49,0,16150,15933,188
08-02-2021,salem,95,13,17,0,91,32078,13,420,0,32511,31954,466
08-02-2021,sivagangai,22,1,2,0,21,6611,1,68,0,6680,6533,126
08-02-2021,tenkasi,32,0,4,0,28,8400,0,49,0,8449,8262,159
08-02-2021,thanjavur,145,13,9,0,149,17783,13,22,0,17818,17421,248
08-02-2021,theni,31,4,3,0,32,17059,4,45,0,17108,16871,205
08-02-2021,thirupathur,24,2,2,0,24,7487,2,110,0,7599,7449,126
08-02-2021,thiruvallur,203,26,10,0,219,43699,26,10,0,43735,42825,691
08-02-2021,thiruvannamalai,41,2,4,0,39,19002,2,393,0,19397,19075,283
08-02-2021,thiruvarur,53,4,7,0,50,11200,4,38,0,11242,11083,109
08-02-2021,thoothukudi,13,2,3,0,12,16017,2,273,0,16292,16139,141
08-02-2021,tirunelveli,62,6,9,1,58,15204,6,420,0,15630,15358,214
08-02-2021,tiruppur,156,21,21,0,156,18017,21,11,0,18049,17672,221
08-02-2021,trichy,102,18,11,0,109,14729,18,38,0,14785,14496,180
08-02-2021,vellore,85,12,16,0,81,20409,9,400,3,20821,20392,348
08-02-2021,villupuram,30,3,5,0,28,15033,3,174,0,15210,15070,112
08-02-2021,virudhunagar,29,7,5,0,31,16490,7,104,0,16601,16339,231
08-02-2021,airport surveillance (international),4,1,0,0,5,0,0,942,1,943,937,1
08-02-2021,airport surveillance (domestic),1,0,0,0,1,0,0,1039,0,1039,1037,1
08-02-2021,railway surveillance,0,0,0,0,0,0,0,428,0,428,428,0
09-02-2021,ariyalur,18,1,4,0,15,4688,1,20,0,4709,4645,49
09-02-2021,chengalpattu,268,37,48,1,256,51833,37,5,0,51875,50848,771
09-02-2021,chennai,1551,139,138,2,1550,232417,139,47,0,232603,226935,4118
09-02-2021,coimbatore,456,53,51,0,458,54801,53,51,0,54905,53773,674
09-02-2021,cuddalore,75,4,11,0,68,24806,4,202,0,25012,24657,287
09-02-2021,dharmapuri,21,8,4,0,25,6388,8,214,0,6610,6531,54
09-02-2021,dindigul,59,6,13,0,52,11232,6,77,0,11315,11064,199
09-02-2021,erode,183,25,18,0,190,14432,25,94,0,14551,14211,150
09-02-2021,kallakurichi,9,4,1,0,12,10483,4,404,0,10891,10771,108
09-02-2021,kancheepuram,106,11,10,0,107,29328,11,3,0,29342,28795,440
09-02-2021,kanyakumari,91,11,13,0,89,16804,11,109,0,16924,16576,259
09-02-2021,karur,32,6,4,0,34,5382,6,46,0,5434,5350,50
09-02-2021,krishnagiri,25,1,5,0,21,7929,1,169,0,8099,7961,117
09-02-2021,madurai,89,5,9,0,85,20930,5,158,0,21093,20549,459
09-02-2021,nagapattinam,47,9,4,0,52,8404,9,89,0,8502,8317,133
09-02-2021,namakkal,79,10,12,0,77,11593,10,106,0,11709,11521,111
09-02-2021,nilgiris,43,4,2,0,45,8229,4,22,0,8255,8163,47
09-02-2021,perambalur,5,0,0,0,5,2269,0,2,0,2271,2245,21
09-02-2021,pudukottai,25,5,6,0,24,11550,5,33,0,11588,11408,156
09-02-2021,ramanathapuram,10,0,1,0,9,6293,0,133,0,6426,6280,137
09-02-2021,ranipet,29,3,2,0,30,16101,3,49,0,16153,15935,188
09-02-2021,salem,91,17,11,0,97,32091,17,420,0,32528,31965,466
09-02-2021,sivagangai,20,0,1,0,19,6611,0,68,0,6679,6534,126
09-02-2021,tenkasi,30,4,6,0,28,8402,4,49,0,8455,8268,159
09-02-2021,thanjavur,146,15,12,0,149,17793,15,22,0,17830,17433,248
09-02-2021,theni,32,3,3,0,32,17063,3,45,0,17111,16874,205
09-02-2021,thirupathur,24,3,4,0,23,7489,3,110,0,7602,7453,126
09-02-2021,thiruvallur,220,35,14,1,240,43726,35,10,0,43771,42839,692
09-02-2021,thiruvannamalai,40,4,6,0,38,19005,4,393,0,19402,19081,283
09-02-2021,thiruvarur,50,2,8,0,44,11204,2,38,0,11244,11091,109
09-02-2021,thoothukudi,12,4,1,0,15,16019,4,273,0,16296,16140,141
09-02-2021,tirunelveli,57,8,4,0,61,15209,8,420,0,15637,15362,214
09-02-2021,tiruppur,155,10,27,0,138,18037,10,11,0,18058,17699,221
09-02-2021,trichy,107,14,10,0,111,14745,14,38,0,14797,14506,180
09-02-2021,vellore,81,5,14,0,72,20418,4,403,1,20826,20406,348
09-02-2021,villupuram,31,2,7,0,26,15039,2,174,0,15215,15077,112
09-02-2021,virudhunagar,31,1,5,0,27,16497,1,104,0,16602,16344,231
09-02-2021,airport surveillance (international),5,0,2,0,3,0,0,943,0,943,939,1
09-02-2021,airport surveillance (domestic),1,0,0,0,1,0,0,1039,0,1039,1037,1
09-02-2021,railway surveillance,0,0,0,0,0,0,0,428,0,428,428,0
10-02-2021,ariyalur,15,0,3,0,12,4689,0,20,0,4709,4648,49
10-02-2021,chengalpattu,257,36,31,1,261,51871,36,5,0,51912,50879,772
10-02-2021,chennai,1563,149,156,0,1556,232569,149,47,0,232765,227091,4118
10-02-2021,coimbatore,461,62,55,1,467,54857,62,51,0,54970,53828,675
10-02-2021,cuddalore,67,6,4,0,69,24809,6,202,0,25017,24661,287
10-02-2021,dharmapuri,25,9,6,0,28,6396,9,214,0,6619,6537,54
10-02-2021,dindigul,52,8,9,0,51,11238,8,77,0,11323,11073,199
10-02-2021,erode,186,14,24,0,176,14453,14,94,0,14561,14235,150
10-02-2021,kallakurichi,12,1,2,0,11,10487,1,404,0,10892,10773,108
10-02-2021,kancheepuram,99,10,9,0,100,29331,10,3,0,29344,28804,440
10-02-2021,kanyakumari,87,8,7,0,88,16813,8,109,0,16930,16583,259
10-02-2021,karur,34,7,8,0,33,5388,7,46,0,5441,5358,50
10-02-2021,krishnagiri,21,1,4,0,18,7930,1,169,0,8100,7965,117
10-02-2021,madurai,83,2,11,0,74,20933,2,158,0,21093,20560,459
10-02-2021,nagapattinam,52,8,3,0,57,8413,8,89,0,8510,8320,133
10-02-2021,namakkal,78,3,14,0,67,11604,3,106,0,11713,11535,111
10-02-2021,nilgiris,45,5,5,0,45,8233,5,22,0,8260,8168,47
10-02-2021,perambalur,5,3,1,0,7,2269,3,2,0,2274,2246,21
10-02-2021,pudukottai,24,7,5,0,26,11555,7,33,0,11595,11413,156
10-02-2021,ramanathapuram,9,1,1,0,9,6293,1,133,0,6427,6281,137
10-02-2021,ranipet,30,2,4,0,28,16104,2,49,0,16155,15939,188
10-02-2021,salem,98,11,15,0,94,32109,11,420,0,32540,31980,466
10-02-2021,sivagangai,20,9,4,0,25,6612,9,68,0,6689,6538,126
10-02-2021,tenkasi,28,9,5,0,32,8406,9,49,0,8464,8273,159
10-02-2021,thanjavur,149,10,18,0,141,17808,10,22,0,17840,17451,248
10-02-2021,theni,32,3,3,1,31,17066,3,45,0,17114,16877,206
10-02-2021,thirupathur,25,2,3,0,24,7494,2,110,0,7606,7456,126
10-02-2021,thiruvallur,236,23,22,0,237,43757,23,10,0,43790,42861,692
10-02-2021,thiruvannamalai,38,6,4,0,40,19009,6,393,0,19408,19085,283
10-02-2021,thiruvarur,44,7,6,0,45,11206,7,38,0,11251,11097,109
10-02-2021,thoothukudi,15,3,2,0,16,16023,3,273,0,16299,16142,141
10-02-2021,tirunelveli,61,9,7,0,63,15217,9,420,0,15646,15369,214
10-02-2021,tiruppur,138,19,21,1,135,18047,19,11,0,18077,17720,222
10-02-2021,trichy,111,9,8,1,111,14759,9,38,0,14806,14514,181
10-02-2021,vellore,71,8,6,0,73,20421,7,404,1,20833,20412,348
10-02-2021,villupuram,26,3,5,0,24,15041,3,174,0,15218,15082,112
10-02-2021,virudhunagar,27,6,2,0,31,16498,6,104,0,16608,16346,231
10-02-2021,airport surveillance (international),3,0,0,0,3,0,0,943,0,943,939,1
10-02-2021,airport surveillance (domestic),1,0,0,0,1,0,0,1039,0,1039,1037,1
10-02-2021,railway surveillance,0,0,0,0,0,0,0,428,0,428,428,0
11-02-2021,ariyalur,12,0,2,0,10,4689,0,20,0,4709,4650,49
11-02-2021,chengalpattu,270,33,33,0,270,51916,33,5,0,51954,50912,772
11-02-2021,chennai,1563,146,135,2,1572,232725,146,47,0,232918,227226,4120
11-02-2021,coimbatore,468,47,51,1,463,54920,47,51,0,55018,53879,676
11-02-2021,cuddalore,69,16,6,0,79,24815,16,202,0,25033,24667,287
11-02-2021,dharmapuri,27,3,3,0,27,6404,3,214,0,6621,6540,54
11-02-2021,dindigul,50,9,11,0,48,11245,9,77,0,11331,11084,199
11-02-2021,erode,175,19,20,0,174,14466,19,94,0,14579,14255,150
11-02-2021,kallakurichi,11,1,1,0,11,10488,1,404,0,10893,10774,108
11-02-2021,kancheepuram,95,9,13,1,90,29336,9,3,0,29348,28817,441
11-02-2021,kanyakumari,88,5,10,0,83,16821,5,109,0,16935,16593,259
11-02-2021,karur,34,3,6,0,31,5396,3,46,0,5445,5364,50
11-02-2021,krishnagiri,18,1,3,0,16,7931,1,169,0,8101,7968,117
11-02-2021,madurai,74,13,15,0,72,20935,13,158,0,21106,20575,459
11-02-2021,nagapattinam,58,6,9,0,55,8422,6,89,0,8517,8329,133
11-02-2021,namakkal,68,5,16,0,57,11608,5,106,0,11719,11551,111
11-02-2021,nilgiris,45,6,7,0,44,8238,6,22,0,8266,8175,47
11-02-2021,perambalur,7,1,1,0,7,2272,1,2,0,2275,2247,21
11-02-2021,pudukottai,26,9,4,0,31,11562,9,33,0,11604,11417,156
11-02-2021,ramanathapuram,9,1,1,0,9,6294,1,133,0,6428,6282,137
11-02-2021,ranipet,27,8,2,0,33,16105,8,49,0,16162,15941,188
11-02-2021,salem,94,12,14,0,92,32120,12,420,0,32552,31994,466
11-02-2021,sivagangai,24,5,6,0,23,6620,5,68,0,6693,6544,126
11-02-2021,tenkasi,31,4,3,0,32,8414,4,49,0,8467,8276,159
11-02-2021,thanjavur,140,20,22,0,138,17817,20,22,0,17859,17473,248
11-02-2021,theni,31,4,2,0,33,17069,4,45,0,17118,16879,206
11-02-2021,thirupathur,24,2,4,0,22,7496,2,110,0,7608,7460,126
11-02-2021,thiruvallur,231,29,20,0,240,43774,29,10,0,43813,42881,692
11-02-2021,thiruvannamalai,40,5,7,1,37,19015,5,393,0,19413,19092,284
11-02-2021,thiruvarur,45,6,7,0,44,11213,6,38,0,11257,11104,109
11-02-2021,thoothukudi,17,2,3,0,16,16027,2,273,0,16302,16145,141
11-02-2021,tirunelveli,61,1,8,0,54,15224,1,420,0,15645,15377,214
11-02-2021,tiruppur,135,14,22,0,127,18066,14,11,0,18091,17742,222
11-02-2021,trichy,110,15,10,0,115,14767,15,38,0,14820,14524,181
11-02-2021,vellore,73,12,8,1,76,20428,11,405,1,20845,20420,349
11-02-2021,villupuram,24,2,2,0,24,15044,2,174,0,15220,15084,112
11-02-2021,virudhunagar,31,3,3,0,31,16504,3,104,0,16611,16349,231
11-02-2021,airport surveillance (international),3,3,0,0,6,0,0,943,3,946,939,1
11-02-2021,airport surveillance (domestic),1,1,0,0,2,0,0,1039,1,1040,1037,1
11-02-2021,railway surveillance,0,0,0,0,0,0,0,428,0,428,428,0
12-02-2021,ariyalur,10,0,1,0,9,4689,0,20,0,4709,4651,49
12-02-2021,chengalpattu,274,45,34,0,285,51953,45,5,0,52003,50946,772
12-02-2021,chennai,1558,142,137,1,1562,232857,142,47,0,233046,227363,4121
12-02-2021,coimbatore,463,45,46,1,461,54967,45,51,0,55063,53925,677
12-02-2021,cuddalore,79,12,5,0,86,24831,12,202,0,25045,24672,287
12-02-2021,dharmapuri,27,0,2,0,25,6407,0,214,0,6621,6542,54
12-02-2021,dindigul,47,11,9,0,49,11253,11,77,0,11341,11093,199
12-02-2021,erode,170,15,28,0,157,14481,15,94,0,14590,14283,150
12-02-2021,kallakurichi,12,1,2,0,11,10490,1,404,0,10895,10776,108
12-02-2021,kancheepuram,93,11,15,0,89,29348,11,3,0,29362,28832,441
12-02-2021,kanyakumari,83,10,14,0,79,16826,10,109,0,16945,16607,259
12-02-2021,karur,33,4,8,0,29,5401,4,46,0,5451,5372,50
12-02-2021,krishnagiri,16,1,2,0,15,7932,1,169,0,8102,7970,117
12-02-2021,madurai,69,15,12,1,71,20945,15,158,0,21118,20587,460
12-02-2021,nagapattinam,57,9,6,0,60,8430,9,89,0,8528,8335,133
12-02-2021,namakkal,57,4,12,0,49,11613,4,106,0,11723,11563,111
12-02-2021,nilgiris,44,5,5,0,44,8244,5,22,0,8271,8180,47
12-02-2021,perambalur,7,2,1,0,8,2273,2,2,0,2277,2248,21
12-02-2021,pudukottai,32,4,7,0,29,11572,4,33,0,11609,11424,156
12-02-2021,ramanathapuram,9,1,1,0,9,6295,1,133,0,6429,6283,137
12-02-2021,ranipet,34,9,4,1,38,16114,9,49,0,16172,15945,189
12-02-2021,salem,92,9,18,0,83,32132,9,420,0,32561,32012,466
12-02-2021,sivagangai,26,1,4,0,23,6628,1,68,0,6697,6548,126
12-02-2021,tenkasi,32,13,2,0,43,8418,13,49,0,8480,8278,159
12-02-2021,thanjavur,139,16,24,1,130,17838,16,22,0,17876,17497,249
12-02-2021,theni,33,4,4,1,32,17073,4,45,0,17122,16883,207
12-02-2021,thirupathur,23,0,3,0,20,7499,0,110,0,7609,7463,126
12-02-2021,thiruvallur,240,21,22,0,239,43803,21,10,0,43834,42903,692
12-02-2021,thiruvannamalai,37,3,5,0,35,19020,3,393,0,19416,19097,284
12-02-2021,thiruvarur,45,7,4,0,48,11220,7,38,0,11265,11108,109
12-02-2021,thoothukudi,17,1,4,0,14,16030,1,273,0,16304,16149,141
12-02-2021,tirunelveli,53,12,5,0,60,15224,12,420,0,15656,15382,214
12-02-2021,tiruppur,129,13,17,0,125,18082,13,11,0,18106,17759,222
12-02-2021,trichy,115,17,12,0,120,14782,17,38,0,14837,14536,181
12-02-2021,vellore,77,15,6,0,86,20440,10,406,5,20861,20426,349
12-02-2021,villupuram,23,4,3,0,24,15045,4,174,0,15223,15087,112
12-02-2021,virudhunagar,31,1,2,0,30,16507,1,104,0,16612,16351,231
12-02-2021,airport surveillance (international),6,0,0,0,6,0,0,946,0,946,939,1
12-02-2021,airport surveillance (domestic),2,0,0,0,2,0,0,1040,0,1040,1037,1
12-02-2021,railway surveillance,0,0,0,0,0,0,0,428,0,428,428,0
13-02-2021,ariyalur,9,1,1,0,9,4689,1,20,0,4710,4652,49
13-02-2021,chengalpattu,287,47,38,0,296,52000,47,5,0,52052,50984,772
13-02-2021,chennai,1561,149,129,1,1580,232998,149,47,0,233194,227492,4122
13-02-2021,coimbatore,462,43,52,0,453,55013,43,51,0,55107,53977,677
13-02-2021,cuddalore,87,11,7,0,91,24844,11,202,0,25057,24679,287
13-02-2021,dharmapuri,25,3,3,1,24,6407,3,214,0,6624,6545,55
13-02-2021,dindigul,47,10,4,0,53,11262,10,77,0,11349,11097,199
13-02-2021,erode,157,11,26,0,142,14496,11,94,0,14601,14309,150
13-02-2021,kallakurichi,12,2,1,0,13,10492,2,404,0,10898,10777,108
13-02-2021,kancheepuram,85,10,12,0,83,29355,10,3,0,29368,28844,441
13-02-2021,kanyakumari,80,9,11,0,78,16837,9,109,0,16955,16618,259
13-02-2021,karur,29,5,4,0,30,5405,5,46,0,5456,5376,50
13-02-2021,krishnagiri,15,3,3,0,15,7933,3,169,0,8105,7973,117
13-02-2021,madurai,69,21,11,0,79,20958,21,158,0,21137,20598,460
13-02-2021,nagapattinam,60,8,7,0,61,8439,8,89,0,8536,8342,133
13-02-2021,namakkal,49,5,10,0,44,11617,5,106,0,11728,11573,111
13-02-2021,nilgiris,44,2,4,1,41,8249,2,22,0,8273,8184,48
13-02-2021,perambalur,8,1,1,0,8,2275,1,2,0,2278,2249,21
13-02-2021,pudukottai,30,3,5,0,28,11577,3,33,0,11613,11429,156
13-02-2021,ramanathapuram,10,2,1,0,11,6297,2,133,0,6432,6284,137
13-02-2021,ranipet,39,8,6,0,41,16124,8,49,0,16181,15951,189
13-02-2021,salem,83,8,17,0,74,32141,8,420,0,32569,32029,466
13-02-2021,sivagangai,24,6,2,0,28,6630,6,68,0,6704,6550,126
13-02-2021,tenkasi,43,6,3,0,46,8431,6,49,0,8486,8281,159
13-02-2021,thanjavur,130,13,22,0,121,17854,13,22,0,17889,17519,249
13-02-2021,theni,33,5,5,0,33,17078,5,45,0,17128,16888,207
13-02-2021,thirupathur,20,1,3,0,18,7499,1,110,0,7610,7466,126
13-02-2021,thiruvallur,235,19,33,1,220,43820,19,10,0,43849,42936,693
13-02-2021,thiruvannamalai,35,5,3,0,37,19023,5,393,0,19421,19100,284
13-02-2021,thiruvarur,48,6,8,0,46,11227,6,38,0,11271,11116,109
13-02-2021,thoothukudi,14,3,1,1,15,16031,3,273,0,16307,16150,142
13-02-2021,tirunelveli,60,7,6,0,61,15236,7,420,0,15663,15388,214
13-02-2021,tiruppur,126,14,18,0,122,18096,14,11,0,18121,17777,222
13-02-2021,trichy,120,15,10,0,125,14799,15,38,0,14852,14546,181
13-02-2021,vellore,87,8,8,0,87,20451,8,411,0,20870,20434,349
13-02-2021,villupuram,24,3,2,0,25,15049,3,174,0,15226,15089,112
13-02-2021,virudhunagar,30,4,5,0,29,16508,4,104,0,16616,16356,231
13-02-2021,airport surveillance (international),6,0,0,0,6,0,0,946,0,946,939,1
13-02-2021,airport surveillance (domestic),2,0,0,0,2,0,0,1040,0,1040,1037,1
13-02-2021,railway surveillance,0,0,0,0,0,0,0,428,0,428,428,0
14-02-2021,ariyalur,9,0,1,0,8,4690,0,20,0,4710,4653,49
14-02-2021,chengalpattu,296,43,35,1,303,52047,43,5,0,52095,51019,773
14-02-2021,chennai,1580,140,160,1,1559,233147,140,47,0,233334,227652,4123
14-02-2021,coimbatore,453,45,43,1,454,55056,45,51,0,55152,54020,678
14-02-2021,cuddalore,91,10,8,0,93,24855,10,202,0,25067,24687,287
14-02-2021,dharmapuri,24,2,2,0,24,6410,2,214,0,6626,6547,55
14-02-2021,dindigul,53,11,8,0,56,11272,11,77,0,11360,11105,199
14-02-2021,erode,142,12,16,0,138,14507,12,94,0,14613,14325,150
14-02-2021,kallakurichi,13,1,1,0,13,10494,1,404,0,10899,10778,108
14-02-2021,kancheepuram,83,11,10,1,83,29365,11,3,0,29379,28854,442
14-02-2021,kanyakumari,78,8,15,1,70,16846,8,109,0,16963,16633,260
14-02-2021,karur,30,9,1,0,38,5410,9,46,0,5465,5377,50
14-02-2021,krishnagiri,15,8,2,0,21,7936,8,169,0,8113,7975,117
14-02-2021,madurai,79,20,10,0,89,20979,20,158,0,21157,20608,460
14-02-2021,nagapattinam,61,8,9,0,60,8447,8,89,0,8544,8351,133
14-02-2021,namakkal,44,5,6,0,43,11622,5,106,0,11733,11579,111
14-02-2021,nilgiris,41,3,3,0,41,8251,3,22,0,8276,8187,48
14-02-2021,perambalur,8,0,1,0,7,2276,0,2,0,2278,2250,21
14-02-2021,pudukottai,28,1,1,0,28,11580,1,33,0,11614,11430,156
14-02-2021,ramanathapuram,11,1,2,0,10,6299,1,133,0,6433,6286,137
14-02-2021,ranipet,41,6,9,0,38,16132,6,49,0,16187,15960,189
14-02-2021,salem,74,9,11,0,72,32149,9,420,0,32578,32040,466
14-02-2021,sivagangai,28,6,1,0,33,6636,6,68,0,6710,6551,126
14-02-2021,tenkasi,46,5,3,0,48,8437,5,49,0,8491,8284,159
14-02-2021,thanjavur,121,11,14,0,118,17867,11,22,0,17900,17533,249
14-02-2021,theni,33,3,2,0,34,17083,3,45,0,17131,16890,207
14-02-2021,thirupathur,18,2,3,0,17,7500,2,110,0,7612,7469,126
14-02-2021,thiruvallur,220,20,26,0,214,43839,20,10,0,43869,42962,693
14-02-2021,thiruvannamalai,37,5,7,0,35,19028,5,393,0,19426,19107,284
14-02-2021,thiruvarur,46,5,3,1,47,11233,5,38,0,11276,11119,110
14-02-2021,thoothukudi,15,8,4,0,19,16034,8,273,0,16315,16154,142
14-02-2021,tirunelveli,61,4,3,0,62,15243,4,420,0,15667,15391,214
14-02-2021,tiruppur,122,19,21,0,120,18110,19,11,0,18140,17798,222
14-02-2021,trichy,125,14,15,0,124,14814,14,38,0,14866,14561,181
14-02-2021,vellore,87,8,12,0,83,20459,8,411,0,20878,20446,349
14-02-2021,villupuram,25,4,3,0,26,15052,4,174,0,15230,15092,112
14-02-2021,virudhunagar,29,3,8,0,24,16512,3,104,0,16619,16364,231
14-02-2021,airport surveillance (international),6,0,0,0,6,0,0,946,0,946,939,1
14-02-2021,airport surveillance (domestic),2,0,0,0,2,0,0,1040,0,1040,1037,1
14-02-2021,railway surveillance,0,0,0,0,0,0,0,428,0,428,428,0
15-02-2021,ariyalur,10,1,1,0,10,4692,1,20,0,4713,4654,49
15-02-2021,chengalpattu,303,39,28,0,314,52090,39,5,0,52134,51047,773
15-02-2021,chennai,1564,143,137,2,1568,233292,143,47,0,233482,227789,4125
15-02-2021,coimbatore,456,46,57,1,444,55103,46,51,0,55200,54077,679
15-02-2021,cuddalore,94,6,4,0,96,24866,6,202,0,25074,24691,287
15-02-2021,dharmapuri,24,2,3,0,23,6412,2,214,0,6628,6550,55
15-02-2021,dindigul,55,10,10,0,55,11282,10,77,0,11369,11115,199
15-02-2021,erode,136,13,15,0,134,14517,13,94,0,14624,14340,150
15-02-2021,kallakurichi,12,3,1,0,14,10494,3,404,0,10901,10779,108
15-02-2021,kancheepuram,86,20,8,0,98,29379,20,3,0,29402,28862,442
15-02-2021,kanyakumari,70,11,16,0,65,16854,11,109,0,16974,16649,260
15-02-2021,karur,38,5,2,0,41,5419,5,46,0,5470,5379,50
15-02-2021,krishnagiri,21,5,1,0,25,7944,5,169,0,8118,7976,117
15-02-2021,madurai,76,12,7,0,81,20986,12,158,0,21156,20615,460
15-02-2021,nagapattinam,62,2,5,0,59,8457,2,89,0,8548,8356,133
15-02-2021,namakkal,44,9,7,0,46,11628,9,106,0,11743,11586,111
15-02-2021,nilgiris,41,5,5,0,41,8254,5,22,0,8281,8192,48
15-02-2021,perambalur,8,0,1,0,7,2277,0,2,0,2279,2251,21
15-02-2021,pudukottai,28,4,1,0,31,11581,4,33,0,11618,11431,156
15-02-2021,ramanathapuram,11,5,1,0,15,6301,5,133,0,6439,6287,137
15-02-2021,ranipet,39,4,7,0,36,16139,4,49,0,16192,15967,189
15-02-2021,salem,72,10,13,0,69,32158,10,420,0,32588,32053,466
15-02-2021,sivagangai,36,4,2,0,38,6645,4,68,0,6717,6553,126
15-02-2021,tenkasi,49,1,2,0,48,8443,1,49,0,8493,8286,159
15-02-2021,thanjavur,120,10,20,0,110,17880,10,22,0,17912,17553,249
15-02-2021,theni,34,3,5,0,32,17086,3,45,0,17134,16895,207
15-02-2021,thirupathur,17,2,3,0,16,7502,2,110,0,7614,7472,126
15-02-2021,thiruvallur,206,21,30,1,196,43851,21,10,0,43882,42992,694
15-02-2021,thiruvannamalai,36,0,2,0,34,19034,0,393,0,19427,19109,284
15-02-2021,thiruvarur,48,7,8,0,47,11239,7,38,0,11284,11127,110
15-02-2021,thoothukudi,21,5,3,0,23,16044,5,273,0,16322,16157,142
15-02-2021,tirunelveli,59,4,8,0,55,15244,4,420,0,15668,15399,214
15-02-2021,tiruppur,124,18,19,0,123,18133,18,11,0,18162,17817,222
15-02-2021,trichy,118,12,22,2,106,14822,12,38,0,14872,14583,183
15-02-2021,vellore,84,7,15,0,76,20468,7,411,0,20886,20461,349
15-02-2021,villupuram,26,4,2,0,28,15056,4,174,0,15234,15094,112
15-02-2021,virudhunagar,24,2,6,0,20,16515,2,104,0,16621,16370,231
15-02-2021,airport surveillance (international),6,0,0,0,6,0,0,946,0,946,939,1
15-02-2021,airport surveillance (domestic),2,0,0,0,2,0,0,1040,0,1040,1037,1
15-02-2021,railway surveillance,0,0,0,0,0,0,0,428,0,428,428,0
16-02-2021,ariyalur,10,3,1,0,12,4693,3,20,0,4716,4655,49
16-02-2021,chengalpattu,326,31,41,1,315,52141,31,5,0,52177,51088,774
16-02-2021,chennai,1556,149,139,2,1564,233423,149,47,0,233619,227928,4127
16-02-2021,coimbatore,444,40,51,0,433,55149,40,51,0,55240,54128,679
16-02-2021,cuddalore,100,5,12,0,93,24876,5,202,0,25083,24703,287
16-02-2021,dharmapuri,23,3,0,0,26,6414,3,214,0,6631,6550,55
16-02-2021,dindigul,55,11,6,0,60,11292,11,77,0,11380,11121,199
16-02-2021,erode,133,16,16,0,133,14529,16,94,0,14639,14356,150
16-02-2021,kallakurichi,14,2,1,0,15,10497,2,404,0,10903,10780,108
16-02-2021,kancheepuram,88,18,14,0,92,29389,18,3,0,29410,28876,442
16-02-2021,kanyakumari,65,12,9,0,68,16865,12,109,0,16986,16658,260
16-02-2021,karur,41,4,1,0,44,5424,4,46,0,5474,5380,50
16-02-2021,krishnagiri,25,4,3,1,25,7949,4,169,0,8122,7979,118
16-02-2021,madurai,81,10,10,0,81,20998,10,158,0,21166,20625,460
16-02-2021,nagapattinam,59,5,3,0,61,8459,5,89,0,8553,8359,133
16-02-2021,namakkal,46,6,4,0,48,11637,6,106,0,11749,11590,111
16-02-2021,nilgiris,41,4,3,0,42,8259,4,22,0,8285,8195,48
16-02-2021,perambalur,7,0,0,0,7,2277,0,2,0,2279,2251,21
16-02-2021,pudukottai,31,3,2,0,32,11585,3,33,0,11621,11433,156
16-02-2021,ramanathapuram,16,2,2,0,16,6307,2,133,0,6442,6289,137
16-02-2021,ranipet,36,0,3,0,33,16143,0,49,0,16192,15970,189
16-02-2021,salem,69,11,17,0,63,32168,11,420,0,32599,32070,466
16-02-2021,sivagangai,39,3,1,0,41,6650,3,68,0,6721,6554,126
16-02-2021,tenkasi,46,2,3,0,45,8442,2,49,0,8493,8289,159
16-02-2021,thanjavur,111,10,13,0,108,17891,10,22,0,17923,17566,249
16-02-2021,theni,32,2,2,0,32,17089,2,45,0,17136,16897,207
16-02-2021,thirupathur,16,2,2,0,16,7504,2,110,0,7616,7474,126
16-02-2021,thiruvallur,194,38,35,1,196,43870,38,10,0,43918,43027,695
16-02-2021,thiruvannamalai,34,7,5,0,36,19034,7,393,0,19434,19114,284
16-02-2021,thiruvarur,46,6,4,0,48,11245,6,38,0,11289,11131,110
16-02-2021,thoothukudi,25,2,3,1,23,16051,2,273,0,16326,16160,143
16-02-2021,tirunelveli,59,6,6,0,59,15252,6,420,0,15678,15405,214
16-02-2021,tiruppur,123,12,17,0,118,18151,12,11,0,18174,17834,222
16-02-2021,trichy,107,10,25,0,92,14835,10,38,0,14883,14608,183
16-02-2021,vellore,76,7,11,1,71,20475,7,411,0,20893,20472,350
16-02-2021,villupuram,29,2,3,0,28,15061,2,174,0,15237,15097,112
16-02-2021,virudhunagar,21,3,2,0,22,16518,3,104,0,16625,16372,231
16-02-2021,airport surveillance (international),6,0,0,0,6,0,0,946,0,946,939,1
16-02-2021,airport surveillance (domestic),2,0,0,0,2,0,0,1040,0,1040,1037,1
16-02-2021,railway surveillance,0,0,0,0,0,0,0,428,0,428,428,0
17-02-2021,ariyalur,12,1,2,0,11,4696,1,20,0,4717,4657,49
17-02-2021,chengalpattu,319,33,38,0,314,52178,33,5,0,52216,51126,776
17-02-2021,chennai,1578,147,120,1,1604,233585,147,47,0,233779,228048,4127
17-02-2021,coimbatore,433,38,54,0,417,55189,38,51,0,55278,54182,679
17-02-2021,cuddalore,93,7,11,0,89,24881,7,202,0,25090,24714,287
17-02-2021,dharmapuri,26,4,2,0,28,6417,4,214,0,6635,6552,55
17-02-2021,dindigul,61,8,9,0,60,11304,8,77,0,11389,11130,199
17-02-2021,erode,132,20,21,0,131,14544,20,94,0,14658,14377,150
17-02-2021,kallakurichi,15,0,1,0,14,10499,0,404,0,10903,10781,108
17-02-2021,kancheepuram,88,26,12,2,100,29403,26,3,0,29432,28888,444
17-02-2021,kanyakumari,69,9,10,0,68,16878,9,109,0,16996,16668,260
17-02-2021,karur,44,3,3,0,44,5428,3,46,0,5477,5383,50
17-02-2021,krishnagiri,25,3,2,0,26,7953,3,169,0,8125,7981,118
17-02-2021,madurai,77,11,9,0,79,21004,11,158,0,21173,20634,460
17-02-2021,nagapattinam,61,4,5,0,60,8464,4,89,0,8557,8364,133
17-02-2021,namakkal,48,7,6,0,49,11643,7,106,0,11756,11596,111
17-02-2021,nilgiris,42,3,2,0,43,8263,3,22,0,8288,8197,48
17-02-2021,perambalur,7,2,1,0,8,2277,2,2,0,2281,2252,21
17-02-2021,pudukottai,32,1,3,0,30,11588,1,33,0,11622,11436,156
17-02-2021,ramanathapuram,16,1,3,0,14,6309,1,133,0,6443,6292,137
17-02-2021,ranipet,33,5,4,0,34,16143,5,49,0,16197,15974,189
17-02-2021,salem,63,12,15,0,60,32179,12,420,0,32611,32085,466
17-02-2021,sivagangai,45,6,3,0,48,6657,6,68,0,6731,6557,126
17-02-2021,tenkasi,49,2,2,0,49,8448,2,49,0,8499,8291,159
17-02-2021,thanjavur,109,11,11,0,109,17902,11,22,0,17935,17577,249
17-02-2021,theni,32,1,3,0,30,17091,1,45,0,17137,16900,207
17-02-2021,thirupathur,16,3,3,0,16,7506,3,110,0,7619,7477,126
17-02-2021,thiruvallur,179,35,33,1,180,43890,35,10,0,43935,43060,695
17-02-2021,thiruvannamalai,37,6,3,0,40,19042,6,393,0,19441,19117,284
17-02-2021,thiruvarur,48,4,5,0,47,11251,4,38,0,11293,11136,110
17-02-2021,thoothukudi,23,2,2,0,23,16053,2,273,0,16328,16162,143
17-02-2021,tirunelveli,54,5,5,0,54,15253,5,420,0,15678,15410,214
17-02-2021,tiruppur,119,10,19,1,109,18164,10,11,0,18185,17853,223
17-02-2021,trichy,93,9,21,0,81,14846,9,38,0,14893,14629,183
17-02-2021,vellore,69,8,14,0,63,20480,6,411,2,20899,20486,350
17-02-2021,villupuram,28,3,2,0,29,15063,3,174,0,15240,15099,112
17-02-2021,virudhunagar,23,3,3,1,22,16522,3,104,0,16629,16375,232
17-02-2021,airport surveillance (international),6,0,0,0,6,0,0,946,0,946,939,1
17-02-2021,airport surveillance (domestic),2,1,0,0,3,0,0,1040,1,1041,1037,1
17-02-2021,railway surveillance,0,0,0,0,0,0,0,428,0,428,428,0
18-02-2021,ariyalur,11,0,1,0,10,4697,0,20,0,4717,4658,49
18-02-2021,chengalpattu,360,48,42,0,366,52257,48,5,0,52310,51168,776
18-02-2021,chennai,1623,138,128,4,1629,233751,138,47,0,233936,228176,4131
18-02-2021,coimbatore,418,40,55,0,403,55228,40,51,0,55319,54237,679
18-02-2021,cuddalore,85,9,7,0,87,24884,9,202,0,25095,24721,287
18-02-2021,dharmapuri,28,4,3,0,29,6421,4,214,0,6639,6555,55
18-02-2021,dindigul,60,4,8,0,56,11312,4,77,0,11393,11138,199
18-02-2021,erode,129,19,19,0,129,14562,19,94,0,14675,14396,150
18-02-2021,kallakurichi,14,0,2,0,12,10499,0,404,0,10903,10783,108
18-02-2021,kancheepuram,54,19,9,0,64,29383,19,3,0,29405,28897,444
18-02-2021,kanyakumari,68,8,7,0,69,16887,8,109,0,17004,16675,260
18-02-2021,karur,43,4,4,0,43,5430,4,46,0,5480,5387,50
18-02-2021,krishnagiri,26,2,1,0,27,7956,2,169,0,8127,7982,118
18-02-2021,madurai,74,7,8,0,73,21010,7,158,0,21175,20642,460
18-02-2021,nagapattinam,59,3,6,0,56,8467,3,89,0,8559,8370,133
18-02-2021,namakkal,49,5,8,0,46,11650,5,106,0,11761,11604,111
18-02-2021,nilgiris,43,9,4,0,48,8266,9,22,0,8297,8201,48
18-02-2021,perambalur,8,0,1,0,7,2279,0,2,0,2281,2253,21
18-02-2021,pudukottai,31,4,4,0,31,11590,4,33,0,11627,11440,156
18-02-2021,ramanathapuram,15,3,3,0,15,6311,3,133,0,6447,6295,137
18-02-2021,ranipet,35,2,3,0,34,16149,2,49,0,16200,15977,189
18-02-2021,salem,61,8,13,0,56,32192,8,420,0,32620,32098,466
18-02-2021,sivagangai,51,5,2,0,54,6666,5,68,0,6739,6559,126
18-02-2021,tenkasi,47,4,3,0,48,8448,4,49,0,8501,8294,159
18-02-2021,thanjavur,106,10,16,0,100,17910,10,22,0,17942,17593,249
18-02-2021,theni,30,1,2,0,29,17092,1,45,0,17138,16902,207
18-02-2021,thirupathur,16,2,2,0,16,7509,2,110,0,7621,7479,126
18-02-2021,thiruvallur,172,34,40,1,165,43917,34,10,0,43961,43100,696
18-02-2021,thiruvannamalai,40,9,4,0,45,19048,9,393,0,19450,19121,284
18-02-2021,thiruvarur,50,3,3,0,50,11258,3,38,0,11299,11139,110
18-02-2021,thoothukudi,23,3,3,0,23,16055,3,273,0,16331,16165,143
18-02-2021,tirunelveli,52,8,6,0,54,15256,8,420,0,15684,15416,214
18-02-2021,tiruppur,109,13,14,0,108,18174,13,11,0,18198,17867,223
18-02-2021,trichy,79,10,19,1,69,14853,10,38,0,14901,14648,184
18-02-2021,vellore,63,11,13,0,61,20486,10,413,1,20910,20499,350
18-02-2021,villupuram,29,2,3,0,28,15066,2,174,0,15242,15102,112
18-02-2021,virudhunagar,22,4,4,0,22,16525,4,104,0,16633,16379,232
18-02-2021,airport surveillance (international),6,0,0,0,6,0,0,946,0,946,939,1
18-02-2021,airport surveillance (domestic),3,2,0,0,5,0,0,1041,2,1043,1037,1
18-02-2021,railway surveillance,0,0,0,0,0,0,0,428,0,428,428,0
19-02-2021,ariyalur,10,3,2,0,11,4697,3,20,0,4720,4660,49
19-02-2021,chengalpattu,366,46,38,0,374,52305,46,5,0,52356,51206,776
19-02-2021,chennai,1629,136,139,3,1623,233889,136,47,0,234072,228315,4134
19-02-2021,coimbatore,403,49,45,0,407,55268,49,51,0,55368,54282,679
19-02-2021,cuddalore,87,7,8,0,86,24893,7,202,0,25102,24729,287
19-02-2021,dharmapuri,29,3,2,0,30,6425,3,214,0,6642,6557,55
19-02-2021,dindigul,56,3,4,0,55,11316,3,77,0,11396,11142,199
19-02-2021,erode,129,17,15,0,131,14581,17,94,0,14692,14411,150
19-02-2021,kallakurichi,12,0,1,0,11,10499,0,404,0,10903,10784,108
19-02-2021,kancheepuram,64,16,13,1,66,29402,16,3,0,29421,28910,445
19-02-2021,kanyakumari,69,10,10,1,68,16895,10,109,0,17014,16685,261
19-02-2021,karur,43,3,3,0,43,5434,3,46,0,5483,5390,50
19-02-2021,krishnagiri,27,2,2,0,27,7958,2,169,0,8129,7984,118
19-02-2021,madurai,73,6,7,0,72,21017,6,158,0,21181,20649,460
19-02-2021,nagapattinam,56,3,4,0,55,8470,3,89,0,8562,8374,133
19-02-2021,namakkal,46,4,6,0,44,11655,4,106,0,11765,11610,111
19-02-2021,nilgiris,48,11,3,0,56,8275,11,22,0,8308,8204,48
19-02-2021,perambalur,7,0,1,0,6,2279,0,2,0,2281,2254,21
19-02-2021,pudukottai,31,1,5,1,26,11594,1,33,0,11628,11445,157
19-02-2021,ramanathapuram,15,3,4,0,14,6314,3,133,0,6450,6299,137
19-02-2021,ranipet,34,1,5,0,30,16151,1,49,0,16201,15982,189
19-02-2021,salem,56,12,15,0,53,32200,12,420,0,32632,32113,466
19-02-2021,sivagangai,54,1,7,0,48,6671,1,68,0,6740,6566,126
19-02-2021,tenkasi,48,3,7,0,44,8452,3,49,0,8504,8301,159
19-02-2021,thanjavur,100,12,11,0,101,17920,12,22,0,17954,17604,249
19-02-2021,theni,29,2,6,0,25,17093,2,45,0,17140,16908,207
19-02-2021,thirupathur,16,1,2,0,15,7511,1,110,0,7622,7481,126
19-02-2021,thiruvallur,165,31,36,0,160,43951,31,10,0,43992,43136,696
19-02-2021,thiruvannamalai,45,5,5,0,45,19057,5,393,0,19455,19126,284
19-02-2021,thiruvarur,50,10,6,1,53,11261,10,38,0,11309,11145,111
19-02-2021,thoothukudi,23,2,2,0,23,16058,2,273,0,16333,16167,143
19-02-2021,tirunelveli,54,5,6,0,53,15264,5,420,0,15689,15422,214
19-02-2021,tiruppur,108,16,12,0,112,18187,16,11,0,18214,17879,223
19-02-2021,trichy,69,11,13,0,67,14863,8,38,3,14912,14661,184
19-02-2021,vellore,61,7,11,0,57,20496,7,414,0,20917,20510,350
19-02-2021,villupuram,28,3,5,0,26,15068,3,174,0,15245,15107,112
19-02-2021,virudhunagar,22,3,6,0,19,16529,3,104,0,16636,16385,232
19-02-2021,airport surveillance (international),6,0,0,0,6,0,0,946,0,946,939,1
19-02-2021,airport surveillance (domestic),5,0,0,0,5,0,0,1043,0,1043,1037,1
19-02-2021,railway surveillance,0,0,0,0,0,0,0,428,0,428,428,0
20-02-2021,ariyalur,11,2,2,0,11,4700,2,20,0,4722,4662,49
20-02-2021,chengalpattu,383,41,35,1,388,52360,41,5,0,52406,51241,777
20-02-2021,chennai,1603,139,145,3,1594,234005,139,47,0,234191,228460,4137
20-02-2021,coimbatore,407,47,46,0,408,55317,47,51,0,55415,54328,679
20-02-2021,cuddalore,86,5,15,0,76,24900,5,202,0,25107,24744,287
20-02-2021,dharmapuri,30,1,3,0,28,6428,1,214,0,6643,6560,55
20-02-2021,dindigul,55,6,6,0,55,11319,6,77,0,11402,11148,199
20-02-2021,erode,129,15,12,0,132,14596,15,94,0,14705,14423,150
20-02-2021,kallakurichi,11,1,1,0,11,10499,1,404,0,10904,10785,108
20-02-2021,kancheepuram,67,22,9,0,80,29419,22,3,0,29444,28919,445
20-02-2021,kanyakumari,68,8,19,0,57,16905,8,109,0,17022,16704,261
20-02-2021,karur,45,0,3,0,42,5439,0,46,0,5485,5393,50
20-02-2021,krishnagiri,27,4,1,0,30,7960,4,169,0,8133,7985,118
20-02-2021,madurai,72,5,8,0,69,21023,5,158,0,21186,20657,460
20-02-2021,nagapattinam,55,2,6,0,51,8473,2,89,0,8564,8380,133
20-02-2021,namakkal,44,3,7,0,40,11659,3,106,0,11768,11617,111
20-02-2021,nilgiris,56,10,5,0,61,8286,10,22,0,8318,8209,48
20-02-2021,perambalur,6,0,0,0,6,2279,0,2,0,2281,2254,21
20-02-2021,pudukottai,26,2,2,0,26,11595,2,33,0,11630,11447,157
20-02-2021,ramanathapuram,15,2,3,0,14,6318,2,133,0,6453,6302,137
20-02-2021,ranipet,30,1,3,0,28,16152,1,49,0,16202,15985,189
20-02-2021,salem,54,16,10,0,60,32213,16,420,0,32649,32123,466
20-02-2021,sivagangai,48,9,8,0,49,6672,9,68,0,6749,6574,126
20-02-2021,tenkasi,44,2,6,0,40,8455,2,49,0,8506,8307,159
20-02-2021,thanjavur,102,14,15,1,100,17933,14,22,0,17969,17619,250
20-02-2021,theni,25,1,8,0,18,17095,1,45,0,17141,16916,207
20-02-2021,thirupathur,16,1,3,0,14,7513,1,110,0,7624,7484,126
20-02-2021,thiruvallur,165,31,27,0,169,43987,31,10,0,44028,43163,696
20-02-2021,thiruvannamalai,45,4,3,0,46,19062,4,393,0,19459,19129,284
20-02-2021,thiruvarur,53,8,5,0,56,11271,8,38,0,11317,11150,111
20-02-2021,thoothukudi,23,1,4,0,20,16060,1,273,0,16334,16171,143
20-02-2021,tirunelveli,53,4,8,0,49,15269,4,420,0,15693,15430,214
20-02-2021,tiruppur,114,15,10,0,119,18205,15,11,0,18231,17889,223
20-02-2021,trichy,65,9,8,0,66,14869,9,41,0,14919,14669,184
20-02-2021,vellore,57,5,7,0,55,20503,5,414,0,20922,20517,350
20-02-2021,villupuram,26,0,2,1,23,15071,0,174,0,15245,15109,113
20-02-2021,virudhunagar,20,2,4,0,18,16533,2,104,0,16639,16389,232
20-02-2021,airport surveillance (international),6,0,0,0,6,0,0,946,0,946,939,1
20-02-2021,airport surveillance (domestic),5,0,0,0,5,0,0,1043,0,1043,1037,1
20-02-2021,railway surveillance,0,0,0,0,0,0,0,428,0,428,428,0
21-02-2021,ariyalur,11,3,2,0,12,4702,3,20,0,4725,4664,49
21-02-2021,chengalpattu,388,40,40,0,388,52401,40,5,0,52446,51281,777
21-02-2021,chennai,1594,154,120,1,1627,234144,154,47,0,234345,228580,4138
21-02-2021,coimbatore,408,45,47,0,406,55364,45,51,0,55460,54375,679
21-02-2021,cuddalore,76,3,16,0,63,24905,3,202,0,25110,24760,287
21-02-2021,dharmapuri,28,1,4,0,25,6429,1,214,0,6644,6564,55
21-02-2021,dindigul,55,5,5,1,54,11325,5,77,0,11407,11153,200
21-02-2021,erode,132,14,15,0,131,14611,14,94,0,14719,14438,150
21-02-2021,kallakurichi,11,1,3,0,9,10500,1,404,0,10905,10788,108
21-02-2021,kancheepuram,80,18,11,0,87,29441,18,3,0,29462,28930,445
21-02-2021,kanyakumari,57,13,15,0,55,16913,13,109,0,17035,16719,261
21-02-2021,karur,42,2,5,0,39,5439,2,46,0,5487,5398,50
21-02-2021,krishnagiri,30,2,4,0,28,7964,2,169,0,8135,7989,118
21-02-2021,madurai,69,7,12,0,64,21028,7,158,0,21193,20669,460
21-02-2021,nagapattinam,51,4,7,0,48,8475,4,89,0,8568,8387,133
21-02-2021,namakkal,40,5,5,0,40,11662,5,106,0,11773,11622,111
21-02-2021,nilgiris,61,8,6,0,63,8296,8,22,0,8326,8215,48
21-02-2021,perambalur,6,0,1,0,5,2279,0,2,0,2281,2255,21
21-02-2021,pudukottai,26,2,5,0,23,11597,2,33,0,11632,11452,157
21-02-2021,ramanathapuram,14,2,4,0,12,6320,2,133,0,6455,6306,137
21-02-2021,ranipet,28,2,6,0,24,16153,2,49,0,16204,15991,189
21-02-2021,salem,60,15,11,0,64,32229,15,420,0,32664,32134,466
21-02-2021,sivagangai,49,7,6,0,50,6681,7,68,0,6756,6580,126
21-02-2021,tenkasi,40,1,7,0,34,8457,1,49,0,8507,8314,159
21-02-2021,thanjavur,100,18,16,0,102,17947,18,22,0,17987,17635,250
21-02-2021,theni,18,2,8,0,12,17096,2,45,0,17143,16924,207
21-02-2021,thirupathur,14,2,4,0,12,7514,2,110,0,7626,7488,126
21-02-2021,thiruvallur,169,30,23,0,176,44018,30,10,0,44058,43186,696
21-02-2021,thiruvannamalai,46,2,7,0,41,19066,2,393,0,19461,19136,284
21-02-2021,thiruvarur,56,4,6,0,54,11279,4,38,0,11321,11156,111
21-02-2021,thoothukudi,20,1,3,0,18,16061,1,273,0,16335,16174,143
21-02-2021,tirunelveli,49,6,4,0,51,15273,6,420,0,15699,15434,214
21-02-2021,tiruppur,119,14,9,1,123,18220,14,11,0,18245,17898,224
21-02-2021,trichy,66,7,6,0,67,14878,7,41,0,14926,14675,184
21-02-2021,vellore,55,7,8,0,54,20508,5,414,2,20929,20525,350
21-02-2021,villupuram,23,2,3,0,22,15071,2,174,0,15247,15112,113
21-02-2021,virudhunagar,18,3,6,0,15,16535,3,104,0,16642,16395,232
21-02-2021,airport surveillance (international),6,0,0,0,6,0,0,946,0,946,939,1
21-02-2021,airport surveillance (domestic),5,0,0,0,5,0,0,1043,0,1043,1037,1
21-02-2021,railway surveillance,0,0,0,0,0,0,0,428,0,428,428,0
22-02-2021,ariyalur,12,3,1,0,14,4705,3,20,0,4728,4665,49
22-02-2021,chengalpattu,405,34,47,1,391,52458,34,5,0,52497,51328,778
22-02-2021,chennai,1622,151,117,4,1652,234293,151,47,0,234491,228697,4142
22-02-2021,coimbatore,408,40,44,1,403,55411,40,51,0,55502,54419,680
22-02-2021,cuddalore,65,7,12,0,60,24910,7,202,0,25119,24772,287
22-02-2021,dharmapuri,26,2,3,0,25,6431,2,214,0,6647,6567,55
22-02-2021,dindigul,54,8,7,0,55,11330,8,77,0,11415,11160,200
22-02-2021,erode,130,15,17,0,128,14624,15,94,0,14733,14455,150
22-02-2021,kallakurichi,9,0,1,0,8,10501,0,404,0,10905,10789,108
22-02-2021,kancheepuram,76,16,12,0,80,29448,16,3,0,29467,28942,445
22-02-2021,kanyakumari,55,10,6,0,59,16926,10,109,0,17045,16725,261
22-02-2021,karur,37,3,4,0,36,5439,3,46,0,5488,5402,50
22-02-2021,krishnagiri,28,5,5,0,28,7966,5,169,0,8140,7994,118
22-02-2021,madurai,62,9,11,0,60,21033,9,158,0,21200,20680,460
22-02-2021,nagapattinam,50,3,5,0,48,8481,3,89,0,8573,8392,133
22-02-2021,namakkal,40,6,6,0,40,11667,6,106,0,11779,11628,111
22-02-2021,nilgiris,62,6,4,0,64,8303,6,22,0,8331,8219,48
22-02-2021,perambalur,5,1,3,0,3,2279,1,2,0,2282,2258,21
22-02-2021,pudukottai,23,3,4,0,22,11599,3,33,0,11635,11456,157
22-02-2021,ramanathapuram,15,3,3,0,15,6325,3,133,0,6461,6309,137
22-02-2021,ranipet,24,5,7,0,22,16155,5,49,0,16209,15998,189
22-02-2021,salem,64,14,10,0,68,32244,14,420,0,32678,32144,466
22-02-2021,sivagangai,52,6,5,0,53,6690,6,68,0,6764,6585,126
22-02-2021,tenkasi,36,3,5,0,34,8460,3,49,0,8512,8319,159
22-02-2021,thanjavur,101,16,21,0,96,17964,16,22,0,18002,17656,250
22-02-2021,theni,12,3,5,0,10,17098,3,45,0,17146,16929,207
22-02-2021,thirupathur,12,1,3,0,10,7516,1,110,0,7627,7491,126
22-02-2021,thiruvallur,171,25,28,0,168,44043,25,10,0,44078,43214,696
22-02-2021,thiruvannamalai,41,3,8,0,36,19068,3,393,0,19464,19144,284
22-02-2021,thiruvarur,53,6,7,0,52,11282,6,38,0,11326,11163,111
22-02-2021,thoothukudi,20,2,1,0,21,16064,2,273,0,16339,16175,143
22-02-2021,tirunelveli,47,5,5,0,47,15275,5,420,0,15700,15439,214
22-02-2021,tiruppur,125,12,14,0,123,18236,12,11,0,18259,17912,224
22-02-2021,trichy,64,6,9,0,61,14882,6,41,0,14929,14684,184
22-02-2021,vellore,55,11,13,0,53,20514,9,416,2,20941,20538,350
22-02-2021,villupuram,22,4,4,0,22,15073,4,174,0,15251,15116,113
22-02-2021,virudhunagar,15,2,4,0,13,16538,2,104,0,16644,16399,232
22-02-2021,airport surveillance (international),6,0,0,0,6,0,0,946,0,946,939,1
22-02-2021,airport surveillance (domestic),5,0,0,0,5,0,0,1043,0,1043,1037,1
22-02-2021,railway surveillance,0,0,0,0,0,0,0,428,0,428,428,0
23-02-2021,ariyalur,14,2,1,0,15,4708,2,20,0,4730,4666,49
23-02-2021,chengalpattu,404,33,55,1,381,52505,33,5,0,52543,51383,779
23-02-2021,chennai,1665,148,113,0,1700,234457,148,47,0,234652,228810,4142
23-02-2021,coimbatore,403,42,41,2,402,55451,42,51,0,55544,54460,682
23-02-2021,cuddalore,60,5,11,0,54,24917,5,202,0,25124,24783,287
23-02-2021,dharmapuri,25,2,4,0,23,6433,2,214,0,6649,6571,55
23-02-2021,dindigul,56,9,9,0,56,11339,9,77,0,11425,11169,200
23-02-2021,erode,127,13,16,0,124,14638,13,94,0,14745,14471,150
23-02-2021,kallakurichi,8,0,2,0,6,10501,0,404,0,10905,10791,108
23-02-2021,kancheepuram,73,17,15,1,74,29457,17,3,0,29477,28957,446
23-02-2021,kanyakumari,59,11,7,0,63,16936,11,109,0,17056,16732,261
23-02-2021,karur,36,3,6,0,33,5442,3,46,0,5491,5408,50
23-02-2021,krishnagiri,28,4,4,0,28,7971,4,169,0,8144,7998,118
23-02-2021,madurai,58,8,9,0,57,21040,8,158,0,21206,20689,460
23-02-2021,nagapattinam,48,4,6,0,46,8484,4,89,0,8577,8398,133
23-02-2021,namakkal,41,5,7,0,39,11674,5,106,0,11785,11635,111
23-02-2021,nilgiris,64,4,5,0,63,8309,4,22,0,8335,8224,48
23-02-2021,perambalur,3,0,0,0,3,2280,0,2,0,2282,2258,21
23-02-2021,pudukottai,22,3,3,0,22,11602,3,33,0,11638,11459,157
23-02-2021,ramanathapuram,15,3,2,0,16,6328,3,133,0,6464,6311,137
23-02-2021,ranipet,22,1,6,0,17,16160,1,49,0,16210,16004,189
23-02-2021,salem,68,12,9,0,71,32258,12,420,0,32690,32153,466
23-02-2021,sivagangai,52,6,5,0,53,6695,6,68,0,6769,6590,126
23-02-2021,tenkasi,34,4,4,0,34,8463,4,49,0,8516,8323,159
23-02-2021,thanjavur,97,14,19,0,92,17981,14,22,0,18017,17675,250
23-02-2021,theni,10,2,3,0,9,17101,2,45,0,17148,16932,207
23-02-2021,thirupathur,10,2,2,0,10,7517,2,110,0,7629,7493,126
23-02-2021,thiruvallur,148,30,25,2,151,44048,30,10,0,44088,43239,698
23-02-2021,thiruvannamalai,36,5,9,0,32,19071,5,393,0,19469,19153,284
23-02-2021,thiruvarur,52,6,6,0,52,11288,6,38,0,11332,11169,111
23-02-2021,thoothukudi,21,2,4,0,19,16066,2,273,0,16341,16179,143
23-02-2021,tirunelveli,49,8,4,0,53,15282,8,420,0,15710,15443,214
23-02-2021,tiruppur,123,12,15,0,120,18248,12,11,0,18271,17927,224
23-02-2021,trichy,61,9,11,0,59,14888,9,41,0,14938,14695,184
23-02-2021,vellore,53,8,10,0,51,20523,8,418,0,20949,20548,350
23-02-2021,villupuram,22,3,3,0,22,15077,3,174,0,15254,15119,113
23-02-2021,virudhunagar,13,1,2,0,12,16540,1,104,0,16645,16401,232
23-02-2021,airport surveillance (international),6,1,0,0,7,0,0,946,1,947,939,1
23-02-2021,airport surveillance (domestic),5,0,0,0,5,0,0,1043,0,1043,1037,1
23-02-2021,railway surveillance,0,0,0,0,0,0,0,428,0,428,428,0
24-02-2021,ariyalur,15,3,1,0,17,4710,3,20,0,4733,4667,49
24-02-2021,chengalpattu,381,30,53,1,357,52538,30,5,0,52573,51436,780
24-02-2021,chennai,1716,169,132,2,1750,234621,169,47,0,234837,228942,4145
24-02-2021,coimbatore,402,46,49,0,399,55493,46,51,0,55590,54509,682
24-02-2021,cuddalore,54,8,9,0,53,24922,8,202,0,25132,24792,287
24-02-2021,dharmapuri,23,1,3,0,21,6435,1,214,0,6650,6574,55
24-02-2021,dindigul,56,11,11,0,56,11348,11,77,0,11436,11180,200
24-02-2021,erode,124,11,15,0,120,14651,11,94,0,14756,14486,150
24-02-2021,kallakurichi,6,0,2,0,4,10501,0,404,0,10905,10793,108
24-02-2021,kancheepuram,71,16,16,0,71,29471,16,3,0,29490,28973,446
24-02-2021,kanyakumari,63,7,8,0,62,16947,7,109,0,17063,16740,261
24-02-2021,karur,34,2,5,0,31,5446,2,46,0,5494,5413,50
24-02-2021,krishnagiri,28,6,3,0,31,7975,6,169,0,8150,8001,118
24-02-2021,madurai,56,7,8,0,55,21047,7,158,0,21212,20697,460
24-02-2021,nagapattinam,47,5,4,0,48,8489,5,89,0,8583,8402,133
24-02-2021,namakkal,39,6,6,0,39,11679,6,106,0,11791,11641,111
24-02-2021,nilgiris,63,4,4,0,63,8313,4,22,0,8339,8228,48
24-02-2021,perambalur,3,1,0,0,4,2280,1,2,0,2283,2258,21
24-02-2021,pudukottai,23,4,6,0,21,11606,4,33,0,11643,11465,157
24-02-2021,ramanathapuram,16,2,3,0,15,6331,2,133,0,6466,6314,137
24-02-2021,ranipet,21,4,4,0,21,16165,4,49,0,16218,16008,189
24-02-2021,salem,71,9,8,1,71,32270,9,420,0,32699,32161,467
24-02-2021,sivagangai,52,3,7,0,48,6700,3,68,0,6771,6597,126
24-02-2021,tenkasi,36,3,3,0,36,8469,3,49,0,8521,8326,159
24-02-2021,thanjavur,93,15,16,2,90,17996,15,22,0,18033,17691,252
24-02-2021,theni,9,3,2,0,10,17103,3,45,0,17151,16934,207
24-02-2021,thirupathur,10,1,2,0,9,7519,1,110,0,7630,7495,126
24-02-2021,thiruvallur,137,33,23,0,147,44064,33,10,0,44107,43262,698
24-02-2021,thiruvannamalai,32,3,7,0,28,19076,3,393,0,19472,19160,284
24-02-2021,thiruvarur,52,3,7,0,48,11294,3,38,0,11335,11176,111
24-02-2021,thoothukudi,19,6,3,0,22,16068,6,273,0,16347,16182,143
24-02-2021,tirunelveli,50,6,5,0,51,15287,6,420,0,15713,15448,214
24-02-2021,tiruppur,120,15,18,0,117,18260,15,11,0,18286,17945,224
24-02-2021,trichy,55,7,14,0,49,14893,7,41,0,14941,14709,183
24-02-2021,vellore,51,7,9,0,49,20531,7,418,0,20956,20557,350
24-02-2021,villupuram,22,1,2,0,21,15080,1,174,0,15255,15121,113
24-02-2021,virudhunagar,12,5,1,0,16,16541,5,104,0,16650,16402,232
24-02-2021,airport surveillance (international),7,0,0,0,7,0,0,947,0,947,939,1
24-02-2021,airport surveillance (domestic),5,0,0,0,5,0,0,1043,0,1043,1037,1
24-02-2021,railway surveillance,0,0,0,0,0,0,0,428,0,428,428,0
25-02-2021,ariyalur,17,1,1,0,17,4713,1,20,0,4734,4668,49
25-02-2021,chengalpattu,357,45,55,0,347,52568,45,5,0,52618,51491,780
25-02-2021,chennai,1750,168,138,3,1777,234790,168,47,0,235005,229080,4148
25-02-2021,coimbatore,399,40,47,1,391,55539,40,51,0,55630,54556,683
25-02-2021,cuddalore,53,9,7,0,55,24930,9,202,0,25141,24799,287
25-02-2021,dharmapuri,21,1,2,0,20,6436,1,214,0,6651,6576,55
25-02-2021,dindigul,56,12,12,0,56,11359,12,77,0,11448,11192,200
25-02-2021,erode,120,13,17,0,116,14662,13,94,0,14769,14503,150
25-02-2021,kallakurichi,4,0,1,0,3,10501,0,404,0,10905,10794,108
25-02-2021,kancheepuram,71,12,13,0,70,29487,12,3,0,29502,28986,446
25-02-2021,kanyakumari,62,6,6,0,62,16954,6,109,0,17069,16746,261
25-02-2021,karur,31,3,4,0,30,5448,3,46,0,5497,5417,50
25-02-2021,krishnagiri,31,5,5,0,31,7981,5,169,0,8155,8006,118
25-02-2021,madurai,55,8,9,0,54,21054,8,158,0,21220,20706,460
25-02-2021,nagapattinam,48,4,6,0,46,8494,4,89,0,8587,8408,133
25-02-2021,namakkal,39,4,5,0,38,11685,4,106,0,11795,11646,111
25-02-2021,nilgiris,63,1,5,0,59,8317,1,22,0,8340,8233,48
25-02-2021,perambalur,4,0,0,0,4,2281,0,2,0,2283,2258,21
25-02-2021,pudukottai,21,3,5,0,19,11610,3,33,0,11646,11470,157
25-02-2021,ramanathapuram,15,1,2,0,14,6333,1,133,0,6467,6316,137
25-02-2021,ranipet,21,2,5,0,18,16169,2,49,0,16220,16013,189
25-02-2021,salem,71,10,10,0,71,32279,10,420,0,32709,32171,467
25-02-2021,sivagangai,48,3,6,0,45,6703,3,68,0,6774,6603,126
25-02-2021,tenkasi,36,11,5,0,42,8472,11,49,0,8532,8331,159
25-02-2021,thanjavur,90,14,15,1,88,18011,14,22,0,18047,17706,253
25-02-2021,theni,10,1,2,0,9,17106,1,45,0,17152,16936,207
25-02-2021,thirupathur,9,1,1,0,9,7520,1,110,0,7631,7496,126
25-02-2021,thiruvallur,147,35,27,0,155,44097,35,10,0,44142,43289,698
25-02-2021,thiruvannamalai,28,1,5,0,24,19079,1,393,0,19473,19165,284
25-02-2021,thiruvarur,48,4,6,0,46,11297,4,38,0,11339,11182,111
25-02-2021,thoothukudi,22,2,2,0,22,16074,2,273,0,16349,16184,143
25-02-2021,tirunelveli,51,10,4,0,57,15293,10,420,0,15723,15452,214
25-02-2021,tiruppur,117,17,17,0,117,18275,17,11,0,18303,17962,224
25-02-2021,trichy,49,8,12,0,45,14900,8,41,0,14949,14721,183
25-02-2021,vellore,49,6,8,0,47,20538,6,418,0,20962,20565,350
25-02-2021,villupuram,21,1,3,0,19,15081,1,174,0,15256,15124,113
25-02-2021,virudhunagar,16,4,2,0,18,16546,4,104,0,16654,16404,232
25-02-2021,airport surveillance (international),7,1,0,0,8,0,0,947,1,948,939,1
25-02-2021,airport surveillance (domestic),5,0,1,0,4,0,0,1043,0,1043,1038,1
25-02-2021,railway surveillance,0,0,0,0,0,0,0,428,0,428,428,0
26-02-2021,ariyalur,18,1,2,0,17,4715,1,20,0,4736,4670,49
26-02-2021,chengalpattu,357,49,58,0,348,52623,49,5,0,52677,51549,780
26-02-2021,chennai,1761,180,153,2,1786,234942,180,47,0,235169,229233,4150
26-02-2021,coimbatore,393,41,48,0,386,55581,41,51,0,55673,54604,683
26-02-2021,cuddalore,55,7,8,0,54,24939,7,202,0,25148,24807,287
26-02-2021,dharmapuri,20,1,3,0,18,6437,1,214,0,6652,6579,55
26-02-2021,dindigul,57,11,11,0,57,11372,11,77,0,11460,11203,200
26-02-2021,erode,115,8,16,0,107,14674,8,94,0,14776,14519,150
26-02-2021,kallakurichi,3,2,1,0,4,10501,2,404,0,10907,10795,108
26-02-2021,kancheepuram,66,10,11,1,64,29495,10,3,0,29508,28997,447
26-02-2021,kanyakumari,62,1,7,0,56,16960,1,109,0,17070,16753,261
26-02-2021,karur,30,1,5,0,26,5451,1,46,0,5498,5422,50
26-02-2021,krishnagiri,31,3,4,0,30,7986,3,169,0,8158,8010,118
26-02-2021,madurai,54,5,8,0,51,21062,5,158,0,21225,20714,460
26-02-2021,nagapattinam,48,6,8,0,46,8500,6,89,0,8595,8416,133
26-02-2021,namakkal,40,2,6,0,36,11691,2,106,0,11799,11652,111
26-02-2021,nilgiris,59,4,4,0,59,8318,4,22,0,8344,8237,48
26-02-2021,perambalur,4,0,0,0,4,2281,0,2,0,2283,2258,21
26-02-2021,pudukottai,19,1,4,0,16,11613,1,33,0,11647,11474,157
26-02-2021,ramanathapuram,15,1,2,0,14,6335,1,133,0,6469,6318,137
26-02-2021,ranipet,29,3,6,0,26,16182,3,49,0,16234,16019,189
26-02-2021,salem,72,12,12,0,72,32290,12,420,0,32722,32183,467
26-02-2021,sivagangai,43,2,5,0,40,6704,2,68,0,6774,6608,126
26-02-2021,tenkasi,42,10,4,0,48,8483,10,49,0,8542,8335,159
26-02-2021,thanjavur,88,22,12,2,96,18025,22,22,0,18069,17718,255
26-02-2021,theni,9,1,1,0,9,17107,1,45,0,17153,16937,207
26-02-2021,thirupathur,10,0,2,0,8,7522,0,110,0,7632,7498,126
26-02-2021,thiruvallur,139,37,21,0,155,44116,37,10,0,44163,43310,698
26-02-2021,thiruvannamalai,26,17,4,0,39,19082,17,393,0,19492,19169,284
26-02-2021,thiruvarur,45,4,7,0,42,11300,4,38,0,11342,11189,111
26-02-2021,thoothukudi,22,2,3,0,21,16076,2,273,0,16351,16187,143
26-02-2021,tirunelveli,53,5,5,0,53,15299,5,420,0,15724,15457,214
26-02-2021,tiruppur,118,18,16,0,120,18293,18,11,0,18322,17978,224
26-02-2021,trichy,49,8,11,0,46,14912,8,41,0,14961,14732,183
26-02-2021,vellore,47,3,10,0,40,20544,3,418,0,20965,20575,350
26-02-2021,villupuram,20,1,2,0,19,15083,1,174,0,15258,15126,113
26-02-2021,virudhunagar,22,1,3,0,20,16554,1,104,0,16659,16407,232
26-02-2021,airport surveillance (international),8,1,0,0,9,0,0,948,1,949,939,1
26-02-2021,airport surveillance (domestic),4,0,0,0,4,0,0,1043,0,1043,1038,1
26-02-2021,railway surveillance,0,0,0,0,0,0,0,428,0,428,428,0
27-02-2021,ariyalur,17,1,2,0,16,4716,1,20,0,4737,4672,49
27-02-2021,chengalpattu,354,36,54,0,336,52678,36,5,0,52719,51603,780
27-02-2021,chennai,1780,187,191,2,1774,235116,187,47,0,235350,229424,4152
27-02-2021,coimbatore,386,40,44,0,382,55622,40,51,0,55713,54648,683
27-02-2021,cuddalore,54,6,10,0,50,24946,6,202,0,25154,24817,287
27-02-2021,dharmapuri,18,0,2,0,16,6438,0,214,0,6652,6581,55
27-02-2021,dindigul,57,13,10,0,60,11383,13,77,0,11473,11213,200
27-02-2021,erode,107,6,15,0,98,14682,6,94,0,14782,14534,150
27-02-2021,kallakurichi,4,0,0,0,4,10503,0,404,0,10907,10795,108
27-02-2021,kancheepuram,59,21,9,0,71,29500,21,3,0,29524,29006,447
27-02-2021,kanyakumari,56,2,8,0,50,16961,2,109,0,17072,16761,261
27-02-2021,karur,25,5,4,0,26,5451,5,46,0,5502,5426,50
27-02-2021,krishnagiri,30,4,5,0,29,7989,4,169,0,8162,8015,118
27-02-2021,madurai,50,9,9,0,50,21066,9,158,0,21233,20723,460
27-02-2021,nagapattinam,46,4,9,0,41,8506,4,89,0,8599,8425,133
27-02-2021,namakkal,37,3,7,0,33,11694,3,106,0,11803,11659,111
27-02-2021,nilgiris,59,2,3,0,58,8322,2,22,0,8346,8240,48
27-02-2021,perambalur,4,1,1,0,4,2281,1,2,0,2284,2259,21
27-02-2021,pudukottai,16,2,2,0,16,11614,2,33,0,11649,11476,157
27-02-2021,ramanathapuram,14,2,3,0,13,6336,2,133,0,6471,6321,137
27-02-2021,ranipet,28,3,4,0,27,16187,3,49,0,16239,16023,189
27-02-2021,salem,73,12,13,0,72,32303,12,420,0,32735,32196,467
27-02-2021,sivagangai,41,4,3,0,42,6707,4,68,0,6779,6611,126
27-02-2021,tenkasi,45,6,6,0,45,8490,6,49,0,8545,8341,159
27-02-2021,thanjavur,97,28,8,1,116,18048,28,22,0,18098,17726,256
27-02-2021,theni,9,1,1,0,9,17108,1,45,0,17154,16938,207
27-02-2021,thirupathur,7,1,1,0,7,7521,1,110,0,7632,7499,126
27-02-2021,thiruvallur,157,35,19,1,172,44155,35,10,0,44200,43329,699
27-02-2021,thiruvannamalai,39,1,6,0,34,19099,1,393,0,19493,19175,284
27-02-2021,thiruvarur,42,4,5,0,41,11304,4,38,0,11346,11194,111
27-02-2021,thoothukudi,22,1,4,0,19,16079,1,273,0,16353,16191,143
27-02-2021,tirunelveli,53,4,2,0,55,15304,4,420,0,15728,15459,214
27-02-2021,tiruppur,120,14,12,0,122,18311,14,11,0,18336,17990,224
27-02-2021,trichy,48,11,6,0,53,14922,10,41,1,14974,14738,183
27-02-2021,vellore,39,11,6,1,43,20546,10,418,1,20975,20581,351
27-02-2021,villupuram,20,2,3,0,19,15085,2,174,0,15261,15129,113
27-02-2021,virudhunagar,20,3,4,0,19,16555,3,104,0,16662,16411,232
27-02-2021,airport surveillance (international),9,1,0,0,10,0,0,949,1,950,939,1
27-02-2021,airport surveillance (domestic),4,0,0,0,4,0,0,1043,0,1043,1038,1
27-02-2021,railway surveillance,0,0,0,0,0,0,0,428,0,428,428,0
28-02-2021,ariyalur,16,2,2,0,16,4717,2,20,0,4739,4674,49
28-02-2021,chengalpattu,336,46,51,0,331,52714,46,5,0,52765,51654,780
28-02-2021,chennai,1774,182,179,1,1776,235303,182,47,0,235532,229603,4153
28-02-2021,coimbatore,382,42,47,0,377,55662,42,51,0,55755,54695,683
28-02-2021,cuddalore,50,9,6,1,52,24952,9,202,0,25163,24823,288
28-02-2021,dharmapuri,16,2,3,0,15,6438,2,214,0,6654,6584,55
28-02-2021,dindigul,60,10,12,0,58,11396,10,77,0,11483,11225,200
28-02-2021,erode,98,11,13,0,96,14688,11,94,0,14793,14547,150
28-02-2021,kallakurichi,4,0,0,0,4,10503,0,404,0,10907,10795,108
28-02-2021,kancheepuram,71,20,14,0,77,29521,20,3,0,29544,29020,447
28-02-2021,kanyakumari,50,5,9,0,46,16963,5,109,0,17077,16770,261
28-02-2021,karur,26,1,5,1,21,5456,1,46,0,5503,5431,51
28-02-2021,krishnagiri,29,3,4,0,28,7993,3,169,0,8165,8019,118
28-02-2021,madurai,50,8,8,0,50,21075,8,158,0,21241,20731,460
28-02-2021,nagapattinam,41,4,7,0,38,8510,4,89,0,8603,8432,133
28-02-2021,namakkal,33,2,6,0,29,11697,2,106,0,11805,11665,111
28-02-2021,nilgiris,58,6,4,0,60,8324,6,22,0,8352,8244,48
28-02-2021,perambalur,4,0,0,0,4,2282,0,2,0,2284,2259,21
28-02-2021,pudukottai,16,3,2,0,17,11616,3,33,0,11652,11478,157
28-02-2021,ramanathapuram,13,1,1,0,13,6338,1,133,0,6472,6322,137
28-02-2021,ranipet,27,2,5,0,24,16190,2,49,0,16241,16028,189
28-02-2021,salem,72,11,15,0,68,32315,11,420,0,32746,32211,467
28-02-2021,sivagangai,42,7,4,0,45,6711,7,68,0,6786,6615,126
28-02-2021,tenkasi,45,2,3,0,44,8496,2,49,0,8547,8344,159
28-02-2021,thanjavur,116,15,10,0,121,18076,15,22,0,18113,17736,256
28-02-2021,theni,9,2,1,0,10,17109,2,45,0,17156,16939,207
28-02-2021,thirupathur,7,1,1,0,7,7522,1,110,0,7633,7500,126
28-02-2021,thiruvallur,172,30,24,0,178,44190,30,10,0,44230,43353,699
28-02-2021,thiruvannamalai,34,2,4,0,32,19100,2,393,0,19495,19179,284
28-02-2021,thiruvarur,41,7,8,0,40,11308,7,38,0,11353,11202,111
28-02-2021,thoothukudi,19,2,3,0,18,16080,2,273,0,16355,16194,143
28-02-2021,tirunelveli,55,5,4,0,56,15308,5,420,0,15733,15463,214
28-02-2021,tiruppur,122,11,18,0,115,18325,11,11,0,18347,18008,224
28-02-2021,trichy,53,10,7,0,56,14932,10,42,0,14984,14745,183
28-02-2021,vellore,43,9,5,0,47,20556,9,419,0,20984,20586,351
28-02-2021,villupuram,19,4,2,0,21,15087,4,174,0,15265,15131,113
28-02-2021,virudhunagar,19,2,3,0,18,16558,2,104,0,16664,16414,232
28-02-2021,airport surveillance (international),10,0,0,0,10,0,0,950,0,950,939,1
28-02-2021,airport surveillance (domestic),4,0,0,0,4,0,0,1043,0,1043,1038,1
28-02-2021,railway surveillance,0,0,0,0,0,0,0,428,0,428,428,0
01-03-2021,ariyalur,16,2,3,0,15,4719,2,20,0,4741,4677,49
01-03-2021,chengalpattu,345,40,48,2,335,52774,40,5,0,52819,51702,782
01-03-2021,chennai,1794,171,180,2,1783,235503,171,47,0,235721,229783,4155
01-03-2021,coimbatore,380,41,42,0,379,55707,41,51,0,55799,54737,683
01-03-2021,cuddalore,52,10,9,0,53,24961,10,202,0,25173,24832,288
01-03-2021,dharmapuri,15,2,4,0,13,6440,2,214,0,6656,6588,55
01-03-2021,dindigul,59,8,9,0,58,11407,8,77,0,11492,11234,200
01-03-2021,erode,96,9,11,0,94,14699,9,94,0,14802,14558,150
01-03-2021,kallakurichi,4,0,1,0,3,10503,0,404,0,10907,10796,108
01-03-2021,kancheepuram,66,18,12,1,71,29530,18,3,0,29551,29032,448
01-03-2021,kanyakumari,46,12,10,0,48,16968,12,109,0,17089,16780,261
01-03-2021,karur,21,3,4,0,20,5457,3,46,0,5506,5435,51
01-03-2021,krishnagiri,28,4,3,0,29,7996,4,169,0,8169,8022,118
01-03-2021,madurai,47,11,7,0,51,21080,11,158,0,21249,20738,460
01-03-2021,nagapattinam,39,5,8,0,36,8515,5,89,0,8609,8440,133
01-03-2021,namakkal,30,4,5,0,29,11700,4,106,0,11810,11670,111
01-03-2021,nilgiris,60,7,6,0,61,8330,7,22,0,8359,8250,48
01-03-2021,perambalur,4,0,1,0,3,2282,0,2,0,2284,2260,21
01-03-2021,pudukottai,18,4,3,0,19,11620,4,33,0,11657,11481,157
01-03-2021,ramanathapuram,14,2,3,0,13,6340,2,133,0,6475,6325,137
01-03-2021,ranipet,23,2,4,0,21,16191,2,49,0,16242,16032,189
01-03-2021,salem,68,9,9,0,68,32326,9,420,0,32755,32220,467
01-03-2021,sivagangai,44,6,6,0,44,6717,6,68,0,6791,6621,126
01-03-2021,tenkasi,43,4,6,0,41,8497,4,49,0,8550,8350,159
01-03-2021,thanjavur,121,13,16,0,118,18091,13,22,0,18126,17752,256
01-03-2021,theni,11,5,1,0,15,17112,5,45,0,17162,16940,207
01-03-2021,thirupathur,8,2,1,0,9,7524,2,110,0,7636,7501,126
01-03-2021,thiruvallur,160,25,17,0,168,44202,25,10,0,44237,43370,699
01-03-2021,thiruvannamalai,33,3,5,0,31,19103,3,393,0,19499,19184,284
01-03-2021,thiruvarur,39,6,7,0,38,11314,6,38,0,11358,11209,111
01-03-2021,thoothukudi,19,3,2,0,20,16083,3,273,0,16359,16196,143
01-03-2021,tirunelveli,57,3,8,0,52,15314,3,420,0,15737,15471,214
01-03-2021,tiruppur,115,14,13,0,116,18336,14,11,0,18361,18021,224
01-03-2021,trichy,47,9,9,0,47,14933,9,42,0,14984,14754,183
01-03-2021,vellore,47,11,4,0,54,20565,7,419,4,20995,20590,351
01-03-2021,villupuram,21,3,1,0,23,15091,3,174,0,15268,15132,113
01-03-2021,virudhunagar,18,3,4,0,17,16560,3,104,0,16667,16418,232
01-03-2021,airport surveillance (international),10,0,0,0,10,0,0,950,0,950,939,1
01-03-2021,airport surveillance (domestic),4,0,0,0,4,0,0,1043,0,1043,1038,1
01-03-2021,railway surveillance,0,0,0,0,0,0,0,428,0,428,428,0
02-03-2021,ariyalur,15,1,2,0,14,4721,1,20,0,4742,4679,49
02-03-2021,chengalpattu,335,33,56,0,312,52814,33,5,0,52852,51758,782
02-03-2021,chennai,1783,167,178,1,1771,235674,167,47,0,235888,229961,4156
02-03-2021,coimbatore,379,39,39,0,379,55748,39,51,0,55838,54776,683
02-03-2021,cuddalore,53,11,9,0,55,24971,11,202,0,25184,24841,288
02-03-2021,dharmapuri,13,2,3,0,12,6442,2,214,0,6658,6591,55
02-03-2021,dindigul,58,6,4,0,60,11415,6,77,0,11498,11238,200
02-03-2021,erode,94,13,13,0,94,14708,13,94,0,14815,14571,150
02-03-2021,kallakurichi,3,1,0,0,4,10503,1,404,0,10908,10796,108
02-03-2021,kancheepuram,71,17,10,0,78,29548,17,3,0,29568,29042,448
02-03-2021,kanyakumari,48,9,9,0,48,16980,9,109,0,17098,16789,261
02-03-2021,karur,20,2,3,0,19,5460,2,46,0,5508,5438,51
02-03-2021,krishnagiri,29,3,4,0,28,8000,3,169,0,8172,8026,118
02-03-2021,madurai,51,14,5,0,60,21091,14,158,0,21263,20743,460
02-03-2021,nagapattinam,36,4,6,0,34,8520,4,89,0,8613,8446,133
02-03-2021,namakkal,29,3,6,0,26,11704,3,106,0,11813,11676,111
02-03-2021,nilgiris,61,6,8,0,59,8337,6,22,0,8365,8258,48
02-03-2021,perambalur,3,1,1,0,3,2282,1,2,0,2285,2261,21
02-03-2021,pudukottai,19,5,2,0,22,11624,5,33,0,11662,11483,157
02-03-2021,ramanathapuram,13,2,2,0,13,6342,2,133,0,6477,6327,137
02-03-2021,ranipet,21,3,6,0,18,16193,3,49,0,16245,16038,189
02-03-2021,salem,68,10,7,0,71,32335,10,420,0,32765,32227,467
02-03-2021,sivagangai,44,5,7,0,42,6723,5,68,0,6796,6628,126
02-03-2021,tenkasi,41,6,4,0,43,8501,5,49,1,8556,8354,159
02-03-2021,thanjavur,118,19,9,0,128,18104,19,22,0,18145,17761,256
02-03-2021,theni,15,3,2,0,16,17117,3,45,0,17165,16942,207
02-03-2021,thirupathur,9,0,2,0,7,7526,0,110,0,7636,7503,126
02-03-2021,thiruvallur,168,21,19,0,170,44227,21,10,0,44258,43389,699
02-03-2021,thiruvannamalai,31,2,4,0,29,19106,2,393,0,19501,19188,284
02-03-2021,thiruvarur,38,6,6,0,38,11320,6,38,0,11364,11215,111
02-03-2021,thoothukudi,20,2,2,0,20,16086,2,273,0,16361,16198,143
02-03-2021,tirunelveli,52,6,10,0,48,15317,6,420,0,15743,15481,214
02-03-2021,tiruppur,116,15,15,0,116,18350,15,11,0,18376,18036,224
02-03-2021,trichy,47,12,7,0,52,14942,12,42,0,14996,14761,183
02-03-2021,vellore,54,7,6,0,55,20572,7,423,0,21002,20596,351
02-03-2021,villupuram,23,4,4,0,23,15094,4,174,0,15272,15136,113
02-03-2021,virudhunagar,17,2,3,0,16,16563,2,104,0,16669,16421,232
02-03-2021,airport surveillance (international),10,0,0,0,10,0,0,950,0,950,939,1
02-03-2021,airport surveillance (domestic),4,0,0,0,4,0,0,1043,0,1043,1038,1
02-03-2021,railway surveillance,0,0,0,0,0,0,0,428,0,428,428,0
03-03-2021,ariyalur,14,3,1,0,16,4722,3,20,0,4745,4680,49
03-03-2021,chengalpattu,330,45,53,1,321,52865,45,5,0,52915,51811,783
03-03-2021,chennai,1771,184,170,1,1784,235841,184,47,0,236072,230131,4157
03-03-2021,coimbatore,380,44,44,0,380,55788,44,51,0,55883,54820,683
03-03-2021,cuddalore,56,12,8,0,60,24983,12,202,0,25197,24849,288
03-03-2021,dharmapuri,12,1,2,0,11,6444,1,214,0,6659,6593,55
03-03-2021,dindigul,58,7,16,0,49,11419,7,77,0,11503,11254,200
03-03-2021,erode,95,10,17,0,88,14722,10,94,0,14826,14588,150
03-03-2021,kallakurichi,3,1,0,0,4,10503,1,404,0,10908,10796,108
03-03-2021,kancheepuram,63,21,11,0,73,29550,21,3,0,29574,29053,448
03-03-2021,kanyakumari,48,8,12,0,44,16989,8,109,0,17106,16801,261
03-03-2021,karur,19,3,4,0,18,5462,3,46,0,5511,5442,51
03-03-2021,krishnagiri,28,4,5,0,27,8003,4,169,0,8176,8031,118
03-03-2021,madurai,58,9,8,0,59,21103,9,158,0,21270,20751,460
03-03-2021,nagapattinam,34,5,6,0,33,8524,5,89,0,8618,8452,133
03-03-2021,namakkal,26,4,7,0,23,11707,4,106,0,11817,11683,111
03-03-2021,nilgiris,59,5,9,0,55,8343,5,22,0,8370,8267,48
03-03-2021,perambalur,3,1,0,0,4,2283,1,2,0,2286,2261,21
03-03-2021,pudukottai,22,2,5,0,19,11629,2,33,0,11664,11488,157
03-03-2021,ramanathapuram,15,1,4,0,12,6346,1,133,0,6480,6331,137
03-03-2021,ranipet,17,2,5,0,14,16195,2,49,0,16246,16043,189
03-03-2021,salem,71,7,8,0,70,32345,7,420,0,32772,32235,467
03-03-2021,sivagangai,43,4,8,0,39,6729,4,68,0,6801,6636,126
03-03-2021,tenkasi,44,3,6,0,41,8507,3,50,0,8560,8360,159
03-03-2021,thanjavur,128,17,7,0,138,18123,17,22,0,18162,17768,256
03-03-2021,theni,16,4,3,0,17,17120,4,45,0,17169,16945,207
03-03-2021,thirupathur,8,2,1,0,9,7527,2,110,0,7639,7504,126
03-03-2021,thiruvallur,163,20,17,0,166,44241,20,10,0,44271,43406,699
03-03-2021,thiruvannamalai,32,3,6,0,29,19111,3,393,0,19507,19194,284
03-03-2021,thiruvarur,38,8,8,0,38,11326,8,38,0,11372,11223,111
03-03-2021,thoothukudi,20,2,3,0,19,16088,2,273,0,16363,16201,143
03-03-2021,tirunelveli,47,5,8,0,44,15322,5,420,0,15747,15489,214
03-03-2021,tiruppur,116,18,12,0,122,18365,18,11,0,18394,18048,224
03-03-2021,trichy,51,10,5,0,56,14953,10,42,0,15005,14766,183
03-03-2021,vellore,56,8,7,0,57,20580,8,423,0,21011,20603,351
03-03-2021,villupuram,23,2,6,0,19,15098,2,174,0,15274,15142,113
03-03-2021,virudhunagar,16,4,2,0,18,16565,4,104,0,16673,16423,232
03-03-2021,airport surveillance (international),10,0,0,0,10,0,0,950,0,950,939,1
03-03-2021,airport surveillance (domestic),4,0,0,0,4,0,0,1043,0,1043,1038,1
03-03-2021,railway surveillance,0,0,0,0,0,0,0,428,0,428,428,0
04-03-2021,ariyalur,16,0,3,0,13,4725,0,20,0,4745,4683,49
04-03-2021,chengalpattu,327,42,49,0,320,52916,42,5,0,52963,51860,783
04-03-2021,chennai,1783,189,167,3,1802,236024,189,47,0,236260,230298,4160
04-03-2021,coimbatore,380,48,51,0,377,55832,48,51,0,55931,54871,683
04-03-2021,cuddalore,61,7,8,0,60,24996,7,202,0,25205,24857,288
04-03-2021,dharmapuri,11,1,3,0,9,6445,1,214,0,6660,6596,55
04-03-2021,dindigul,51,8,8,0,51,11428,8,77,0,11513,11262,200
04-03-2021,erode,88,11,18,0,81,14732,11,94,0,14837,14606,150
04-03-2021,kallakurichi,4,0,1,0,3,10504,0,404,0,10908,10797,108
04-03-2021,kancheepuram,68,19,9,0,78,29566,19,3,0,29588,29062,448
04-03-2021,kanyakumari,45,7,10,0,42,16998,7,109,0,17114,16811,261
04-03-2021,karur,17,2,3,0,16,5464,2,46,0,5512,5445,51
04-03-2021,krishnagiri,27,3,4,0,26,8007,3,169,0,8179,8035,118
04-03-2021,madurai,57,6,7,0,56,21110,6,158,0,21274,20758,460
04-03-2021,nagapattinam,34,4,7,1,30,8530,4,89,0,8623,8459,134
04-03-2021,namakkal,24,5,6,0,23,11712,5,106,0,11823,11689,111
04-03-2021,nilgiris,55,4,10,0,49,8348,4,22,0,8374,8277,48
04-03-2021,perambalur,2,0,0,0,2,2282,0,2,0,2284,2261,21
04-03-2021,pudukottai,19,5,3,0,21,11631,5,33,0,11669,11491,157
04-03-2021,ramanathapuram,12,1,4,0,9,6347,1,133,0,6481,6335,137
04-03-2021,ranipet,14,3,3,0,14,16197,3,49,0,16249,16046,189
04-03-2021,salem,71,8,10,0,69,32353,8,420,0,32781,32245,467
04-03-2021,sivagangai,35,3,6,0,32,6729,3,68,0,6800,6642,126
04-03-2021,tenkasi,42,2,5,0,39,8511,2,50,0,8563,8365,159
04-03-2021,thanjavur,139,15,13,0,141,18141,15,22,0,18178,17781,256
04-03-2021,theni,17,3,1,0,19,17124,3,45,0,17172,16946,207
04-03-2021,thirupathur,10,1,2,0,9,7530,1,110,0,7641,7506,126
04-03-2021,thiruvallur,164,23,15,0,172,44259,23,10,0,44292,43421,699
04-03-2021,thiruvannamalai,30,2,5,0,27,19115,2,393,0,19510,19199,284
04-03-2021,thiruvarur,39,5,7,0,37,11335,5,38,0,11378,11230,111
04-03-2021,thoothukudi,19,1,4,0,16,16090,1,273,0,16364,16205,143
04-03-2021,tirunelveli,42,8,9,0,41,15325,8,420,0,15753,15498,214
04-03-2021,tiruppur,122,20,16,0,126,18383,20,11,0,18414,18064,224
04-03-2021,trichy,57,9,7,0,59,14964,9,42,0,15015,14773,183
04-03-2021,vellore,57,11,9,0,59,20588,8,423,3,21022,20612,351
04-03-2021,villupuram,19,1,4,0,16,15100,1,174,0,15275,15146,113
04-03-2021,virudhunagar,18,3,3,0,18,16569,3,104,0,16676,16426,232
04-03-2021,airport surveillance (international),10,2,0,0,12,0,0,950,2,952,939,1
04-03-2021,airport surveillance (domestic),4,0,0,0,4,0,0,1043,0,1043,1038,1
04-03-2021,railway surveillance,0,0,0,0,0,0,0,428,0,428,428,0
05-03-2021,ariyalur,13,1,3,0,11,4725,1,20,0,4746,4686,49
05-03-2021,chengalpattu,319,46,55,1,309,52958,46,5,0,53009,51915,785
05-03-2021,chennai,1803,225,189,2,1837,236213,225,47,0,236485,230487,4161
05-03-2021,coimbatore,377,51,52,0,376,55880,51,51,0,55982,54923,683
05-03-2021,cuddalore,60,6,10,0,56,25003,6,202,0,25211,24867,288
05-03-2021,dharmapuri,9,1,2,0,8,6446,1,214,0,6661,6598,55
05-03-2021,dindigul,51,7,9,0,49,11436,7,77,0,11520,11271,200
05-03-2021,erode,81,10,16,0,75,14743,10,94,0,14847,14622,150
05-03-2021,kallakurichi,3,0,0,0,3,10504,0,404,0,10908,10797,108
05-03-2021,kancheepuram,78,20,17,1,80,29585,20,3,0,29608,29079,449
05-03-2021,kanyakumari,42,6,8,0,40,17005,6,109,0,17120,16819,261
05-03-2021,karur,16,1,4,0,13,5466,1,46,0,5513,5449,51
05-03-2021,krishnagiri,26,1,6,0,21,8010,1,169,0,8180,8041,118
05-03-2021,madurai,56,10,9,0,57,21116,10,158,0,21284,20767,460
05-03-2021,nagapattinam,30,4,8,0,26,8534,4,89,0,8627,8467,134
05-03-2021,namakkal,23,3,6,0,20,11717,3,106,0,11826,11695,111
05-03-2021,nilgiris,49,3,13,0,39,8352,3,22,0,8377,8290,48
05-03-2021,perambalur,2,1,0,0,3,2282,1,2,0,2285,2261,21
05-03-2021,pudukottai,21,5,4,0,22,11636,5,33,0,11674,11495,157
05-03-2021,ramanathapuram,9,1,3,0,7,6348,1,133,0,6482,6338,137
05-03-2021,ranipet,14,1,6,0,9,16200,1,49,0,16250,16052,189
05-03-2021,salem,69,7,11,0,65,32361,7,420,0,32788,32256,467
05-03-2021,sivagangai,32,2,4,0,30,6732,2,68,0,6802,6646,126
05-03-2021,tenkasi,39,4,6,0,37,8513,4,50,0,8567,8371,159
05-03-2021,thanjavur,141,14,12,0,143,18156,14,22,0,18192,17793,256
05-03-2021,theni,19,1,7,0,13,17127,1,45,0,17173,16953,207
05-03-2021,thirupathur,9,1,2,0,8,7531,1,110,0,7642,7508,126
05-03-2021,thiruvallur,172,33,28,1,176,44282,33,10,0,44325,43449,700
05-03-2021,thiruvannamalai,27,3,6,0,24,19117,3,393,0,19513,19205,284
05-03-2021,thiruvarur,37,4,9,0,32,11340,4,38,0,11382,11239,111
05-03-2021,thoothukudi,16,1,3,0,14,16091,1,273,0,16365,16208,143
05-03-2021,tirunelveli,41,6,11,0,36,15333,6,420,0,15759,15509,214
05-03-2021,tiruppur,126,25,21,0,130,18403,25,11,0,18439,18085,224
05-03-2021,trichy,59,11,5,0,65,14973,11,42,0,15026,14778,183
05-03-2021,vellore,59,16,7,0,68,20596,14,426,2,21038,20619,351
05-03-2021,villupuram,16,3,3,0,16,15101,3,174,0,15278,15149,113
05-03-2021,virudhunagar,18,6,7,0,17,16572,6,104,0,16682,16433,232
05-03-2021,airport surveillance (international),12,2,0,0,14,0,0,952,2,954,939,1
05-03-2021,airport surveillance (domestic),4,1,0,0,5,0,0,1043,1,1044,1038,1
05-03-2021,railway surveillance,0,0,0,0,0,0,0,428,0,428,428,0
06-03-2021,ariyalur,11,0,2,0,9,4726,0,20,0,4746,4688,49
06-03-2021,chengalpattu,309,49,53,1,304,53004,49,5,0,53058,51968,786
06-03-2021,chennai,1837,243,221,2,1857,236438,243,47,0,236728,230708,4163
06-03-2021,coimbatore,376,48,59,1,364,55931,48,51,0,56030,54982,684
06-03-2021,cuddalore,56,3,5,0,54,25009,3,202,0,25214,24872,288
06-03-2021,dharmapuri,8,0,1,0,7,6447,0,214,0,6661,6599,55
06-03-2021,dindigul,49,5,4,0,50,11443,5,77,0,11525,11275,200
06-03-2021,erode,75,13,13,0,75,14753,13,94,0,14860,14635,150
06-03-2021,kallakurichi,3,1,1,0,3,10504,1,404,0,10909,10798,108
06-03-2021,kancheepuram,80,25,7,0,98,29605,25,3,0,29633,29086,449
06-03-2021,kanyakumari,40,6,9,0,37,17011,6,109,0,17126,16828,261
06-03-2021,karur,13,1,3,0,11,5467,1,46,0,5514,5452,51
06-03-2021,krishnagiri,21,1,3,0,19,8011,1,169,0,8181,8044,118
06-03-2021,madurai,57,5,6,0,56,21126,5,158,0,21289,20773,460
06-03-2021,nagapattinam,26,7,5,0,28,8538,7,89,0,8634,8472,134
06-03-2021,namakkal,20,7,3,0,24,11720,7,106,0,11833,11698,111
06-03-2021,nilgiris,39,6,10,0,35,8355,6,22,0,8383,8300,48
06-03-2021,perambalur,3,0,0,0,3,2283,0,2,0,2285,2261,21
06-03-2021,pudukottai,22,4,2,0,24,11641,4,33,0,11678,11497,157
06-03-2021,ramanathapuram,7,1,1,0,7,6349,1,133,0,6483,6339,137
06-03-2021,ranipet,9,2,2,0,9,16201,2,49,0,16252,16054,189
06-03-2021,salem,65,6,9,0,62,32368,6,420,0,32794,32265,467
06-03-2021,sivagangai,30,4,4,0,30,6734,4,68,0,6806,6650,126
06-03-2021,tenkasi,37,2,8,0,31,8517,2,50,0,8569,8379,159
06-03-2021,thanjavur,143,20,23,0,140,18170,20,22,0,18212,17816,256
06-03-2021,theni,13,2,2,0,13,17128,2,45,0,17175,16955,207
06-03-2021,thirupathur,8,1,1,0,8,7532,1,110,0,7643,7509,126
06-03-2021,thiruvallur,176,39,29,0,186,44315,39,10,0,44364,43478,700
06-03-2021,thiruvannamalai,24,1,7,0,18,19120,1,393,0,19514,19212,284
06-03-2021,thiruvarur,32,8,4,0,36,11344,8,38,0,11390,11243,111
06-03-2021,thoothukudi,14,2,2,0,14,16092,2,273,0,16367,16210,143
06-03-2021,tirunelveli,36,7,8,0,35,15339,7,420,0,15766,15517,214
06-03-2021,tiruppur,130,20,30,0,120,18428,20,11,0,18459,18115,224
06-03-2021,trichy,65,7,2,0,70,14984,7,42,0,15033,14780,183
06-03-2021,vellore,68,10,5,0,73,20610,10,428,0,21048,20624,351
06-03-2021,villupuram,16,3,2,0,17,15104,3,174,0,15281,15151,113
06-03-2021,virudhunagar,17,3,3,0,17,16578,3,104,0,16685,16436,232
06-03-2021,airport surveillance (international),14,0,8,0,6,0,0,954,0,954,947,1
06-03-2021,airport surveillance (domestic),5,0,3,0,2,0,0,1044,0,1044,1041,1
06-03-2021,railway surveillance,0,0,0,0,0,0,0,428,0,428,428,0
07-03-2021,ariyalur,9,0,1,0,8,4726,0,20,0,4746,4689,49
07-03-2021,chengalpattu,315,45,51,0,309,53064,45,5,0,53114,52019,786
07-03-2021,chennai,1856,251,228,1,1878,236680,251,47,0,236978,230936,4164
07-03-2021,coimbatore,364,49,55,0,358,55979,49,51,0,56079,55037,684
07-03-2021,cuddalore,58,13,8,0,63,25016,13,202,0,25231,24880,288
07-03-2021,dharmapuri,7,3,1,0,9,6447,3,214,0,6664,6600,55
07-03-2021,dindigul,52,7,5,0,54,11450,7,77,0,11534,11280,200
07-03-2021,erode,77,12,7,0,82,14768,12,94,0,14874,14642,150
07-03-2021,kallakurichi,3,0,0,0,3,10505,0,404,0,10909,10798,108
07-03-2021,kancheepuram,94,19,5,0,108,29626,19,3,0,29648,29091,449
07-03-2021,kanyakumari,39,10,5,0,44,17019,10,109,0,17138,16833,261
07-03-2021,karur,12,1,1,0,12,5469,1,46,0,5516,5453,51
07-03-2021,krishnagiri,19,8,7,0,20,8012,8,169,0,8189,8051,118
07-03-2021,madurai,52,9,4,0,57,21127,9,158,0,21294,20777,460
07-03-2021,nagapattinam,29,4,4,0,29,8546,4,89,0,8639,8476,134
07-03-2021,namakkal,24,8,5,0,27,11727,8,106,0,11841,11703,111
07-03-2021,nilgiris,35,6,6,0,35,8361,6,22,0,8389,8306,48
07-03-2021,perambalur,3,2,1,0,4,2283,2,2,0,2287,2262,21
07-03-2021,pudukottai,24,3,1,0,26,11645,3,33,0,11681,11498,157
07-03-2021,ramanathapuram,7,2,0,0,9,6350,2,133,0,6485,6339,137
07-03-2021,ranipet,10,2,1,0,11,16204,2,49,0,16255,16055,189
07-03-2021,salem,62,6,11,0,57,32374,6,420,0,32800,32276,467
07-03-2021,sivagangai,32,0,3,0,29,6740,0,68,0,6808,6653,126
07-03-2021,tenkasi,32,4,7,0,29,8520,4,50,0,8574,8386,159
07-03-2021,thanjavur,133,11,22,0,122,18183,11,22,0,18216,17838,256
07-03-2021,theni,13,1,0,0,14,17130,1,45,0,17176,16955,207
07-03-2021,thirupathur,8,0,1,0,7,7533,0,110,0,7643,7510,126
07-03-2021,thiruvallur,169,38,23,0,184,44337,38,10,0,44385,43501,700
07-03-2021,thiruvannamalai,20,1,5,0,16,19123,1,393,0,19517,19217,284
07-03-2021,thiruvarur,37,4,1,0,40,11353,4,38,0,11395,11244,111
07-03-2021,thoothukudi,15,2,3,0,14,16095,2,273,0,16370,16213,143
07-03-2021,tirunelveli,32,11,7,0,36,15343,11,420,0,15774,15524,214
07-03-2021,tiruppur,121,14,22,0,113,18449,14,11,0,18474,18137,224
07-03-2021,trichy,72,9,8,0,73,14993,9,42,0,15044,14788,183
07-03-2021,vellore,75,5,7,0,73,20622,5,428,0,21055,20631,351
07-03-2021,villupuram,17,4,1,0,20,15107,4,174,0,15285,15152,113
07-03-2021,virudhunagar,17,3,2,0,18,16581,3,104,0,16688,16438,232
07-03-2021,airport surveillance (international),6,0,2,0,4,0,0,954,0,954,949,1
07-03-2021,airport surveillance (domestic),2,0,0,0,2,0,0,1044,0,1044,1041,1
07-03-2021,railway surveillance,0,0,0,0,0,0,0,428,0,428,428,0
08-03-2021,ariyalur,8,1,1,0,8,4726,1,20,0,4747,4690,49
08-03-2021,chengalpattu,317,46,52,0,311,53117,46,5,0,53168,52071,786
08-03-2021,chennai,1875,229,236,2,1866,236928,229,47,0,237204,231172,4166
08-03-2021,coimbatore,358,48,52,1,353,56028,48,51,0,56127,55089,685
08-03-2021,cuddalore,60,10,7,0,63,25026,10,202,0,25238,24887,288
08-03-2021,dharmapuri,8,2,1,0,9,6449,2,214,0,6665,6601,55
08-03-2021,dindigul,53,6,7,0,52,11456,6,77,0,11539,11287,200
08-03-2021,erode,82,10,9,0,83,14780,10,94,0,14884,14651,150
08-03-2021,kallakurichi,4,0,1,0,3,10506,0,404,0,10910,10799,108
08-03-2021,kancheepuram,105,15,8,0,112,29642,15,3,0,29660,29099,449
08-03-2021,kanyakumari,44,14,9,0,49,17029,14,109,0,17152,16842,261
08-03-2021,karur,13,1,2,0,12,5471,1,46,0,5518,5455,51
08-03-2021,krishnagiri,20,5,4,0,21,8020,5,169,0,8194,8055,118
08-03-2021,madurai,58,7,3,0,62,21137,7,158,0,21302,20780,460
08-03-2021,nagapattinam,31,7,5,0,33,8552,7,89,0,8648,8481,134
08-03-2021,namakkal,27,7,4,0,30,11735,7,106,0,11848,11707,111
08-03-2021,nilgiris,35,3,5,0,33,8367,3,22,0,8392,8311,48
08-03-2021,perambalur,3,0,0,0,3,2284,0,2,0,2286,2262,21
08-03-2021,pudukottai,27,2,2,0,27,11649,2,33,0,11684,11500,157
08-03-2021,ramanathapuram,10,2,1,0,11,6353,2,133,0,6488,6340,137
08-03-2021,ranipet,11,1,1,0,11,16206,1,49,0,16256,16056,189
08-03-2021,salem,58,15,12,0,61,32381,15,420,0,32816,32288,467
08-03-2021,sivagangai,25,3,4,0,24,6736,3,68,0,6807,6657,126
08-03-2021,tenkasi,29,2,4,0,27,8524,2,50,0,8576,8390,159
08-03-2021,thanjavur,123,16,19,0,120,18195,16,22,0,18233,17857,256
08-03-2021,theni,14,3,1,0,16,17131,3,45,0,17179,16956,207
08-03-2021,thirupathur,7,3,2,0,8,7533,3,110,0,7646,7512,126
08-03-2021,thiruvallur,190,29,21,0,198,44381,29,10,0,44420,43522,700
08-03-2021,thiruvannamalai,16,1,1,0,16,19124,1,393,0,19518,19218,284
08-03-2021,thiruvarur,39,19,6,0,52,11356,19,38,0,11413,11250,111
08-03-2021,thoothukudi,14,3,5,0,12,16097,3,273,0,16373,16218,143
08-03-2021,tirunelveli,37,7,6,0,38,15355,7,420,0,15782,15530,214
08-03-2021,tiruppur,114,18,19,0,113,18464,18,11,0,18493,18156,224
08-03-2021,trichy,66,10,10,0,66,14995,10,42,0,15047,14798,183
08-03-2021,vellore,73,6,9,0,70,20627,6,428,0,21061,20640,351
08-03-2021,villupuram,19,2,2,0,19,15110,2,174,0,15286,15154,113
08-03-2021,virudhunagar,18,2,1,0,19,16584,2,104,0,16690,16439,232
08-03-2021,airport surveillance (international),4,1,0,0,5,0,0,954,1,955,949,1
08-03-2021,airport surveillance (domestic),2,0,0,0,2,0,0,1044,0,1044,1041,1
08-03-2021,railway surveillance,0,0,0,0,0,0,0,428,0,428,428,0
09-03-2021,ariyalur,8,2,2,0,8,4727,2,20,0,4749,4692,49
09-03-2021,chengalpattu,365,48,61,0,352,53217,48,5,0,53270,52132,786
09-03-2021,chennai,1870,236,227,3,1876,237161,236,47,0,237444,231399,4169
09-03-2021,coimbatore,353,55,56,0,352,56076,55,51,0,56182,55145,685
09-03-2021,cuddalore,63,5,5,0,63,25036,5,202,0,25243,24892,288
09-03-2021,dharmapuri,9,0,0,0,9,6451,0,214,0,6665,6601,55
09-03-2021,dindigul,52,7,8,0,51,11462,7,77,0,11546,11295,200
09-03-2021,erode,83,6,11,0,78,14790,6,94,0,14890,14662,150
09-03-2021,kallakurichi,4,0,1,0,3,10507,0,404,0,10911,10800,108
09-03-2021,kancheepuram,55,28,6,0,77,29600,28,3,0,29631,29105,449
09-03-2021,kanyakumari,49,7,4,0,52,17043,6,109,1,17159,16846,261
09-03-2021,karur,12,1,3,0,10,5472,1,46,0,5519,5458,51
09-03-2021,krishnagiri,21,1,2,0,20,8025,1,169,0,8195,8057,118
09-03-2021,madurai,61,6,6,1,60,21143,6,158,0,21307,20786,461
09-03-2021,nagapattinam,33,7,2,0,38,8559,7,89,0,8655,8483,134
09-03-2021,namakkal,30,7,3,0,34,11742,7,106,0,11855,11710,111
09-03-2021,nilgiris,34,5,3,0,36,8371,5,22,0,8398,8314,48
09-03-2021,perambalur,3,1,0,0,4,2284,1,2,0,2287,2262,21
09-03-2021,pudukottai,28,2,3,0,27,11652,2,33,0,11687,11503,157
09-03-2021,ramanathapuram,11,1,1,0,11,6355,1,133,0,6489,6341,137
09-03-2021,ranipet,12,3,2,0,13,16208,3,49,0,16260,16058,189
09-03-2021,salem,61,19,8,0,72,32396,19,420,0,32835,32296,467
09-03-2021,sivagangai,24,2,3,0,23,6739,2,68,0,6809,6660,126
09-03-2021,tenkasi,27,3,5,0,25,8526,3,50,0,8579,8395,159
09-03-2021,thanjavur,120,20,18,0,122,18211,20,22,0,18253,17875,256
09-03-2021,theni,16,6,1,0,21,17134,6,45,0,17185,16957,207
09-03-2021,thirupathur,8,2,1,0,9,7536,2,110,0,7648,7513,126
09-03-2021,thiruvallur,185,30,21,0,194,44397,30,10,0,44437,43543,700
09-03-2021,thiruvannamalai,21,2,4,0,19,19130,2,393,0,19525,19222,284
09-03-2021,thiruvarur,52,6,2,0,56,11375,6,38,0,11419,11252,111
09-03-2021,thoothukudi,12,2,1,0,13,16100,2,273,0,16375,16219,143
09-03-2021,tirunelveli,39,5,2,0,42,15363,5,420,0,15788,15532,214
09-03-2021,tiruppur,113,16,18,0,111,18482,16,11,0,18509,18174,224
09-03-2021,trichy,67,13,7,0,73,15006,13,42,0,15061,14805,183
09-03-2021,vellore,70,8,7,0,71,20633,5,428,3,21069,20647,351
09-03-2021,villupuram,21,3,4,0,20,15114,3,174,0,15291,15158,113
09-03-2021,virudhunagar,19,3,2,0,20,16586,3,104,0,16693,16441,232
09-03-2021,airport surveillance (international),5,1,0,0,6,0,0,955,1,956,949,1
09-03-2021,airport surveillance (domestic),2,0,0,0,2,0,0,1044,0,1044,1041,1
09-03-2021,railway surveillance,0,0,0,0,0,0,0,428,0,428,428,0
10-03-2021,ariyalur,8,1,2,0,7,4729,1,20,0,4750,4694,49
10-03-2021,chengalpattu,361,53,63,0,351,53274,53,5,0,53332,52195,786
10-03-2021,chennai,1873,275,231,2,1915,237394,275,47,0,237716,231630,4171
10-03-2021,coimbatore,353,63,57,0,359,56132,63,51,0,56246,55202,685
10-03-2021,cuddalore,63,5,6,0,62,25041,5,202,0,25248,24898,288
10-03-2021,dharmapuri,9,0,1,0,8,6451,0,214,0,6665,6602,55
10-03-2021,dindigul,51,6,5,0,52,11469,6,77,0,11552,11300,200
10-03-2021,erode,80,13,9,0,84,14798,13,94,0,14905,14671,150
10-03-2021,kallakurichi,3,3,1,0,5,10507,3,404,0,10914,10801,108
10-03-2021,kancheepuram,68,34,8,0,94,29619,34,3,0,29656,29113,449
10-03-2021,kanyakumari,52,11,5,0,58,17049,11,110,0,17170,16851,261
10-03-2021,karur,8,2,2,0,8,5471,2,46,0,5519,5460,51
10-03-2021,krishnagiri,21,3,3,0,21,8027,3,169,0,8199,8060,118
10-03-2021,madurai,62,9,9,0,62,21151,9,158,0,21318,20795,461
10-03-2021,nagapattinam,38,8,4,1,41,8566,8,89,0,8663,8487,135
10-03-2021,namakkal,29,9,2,0,36,11744,9,106,0,11859,11712,111
10-03-2021,nilgiris,36,8,4,0,40,8376,8,22,0,8406,8318,48
10-03-2021,perambalur,4,1,1,0,4,2285,1,2,0,2288,2263,21
10-03-2021,pudukottai,27,3,4,0,26,11654,3,33,0,11690,11507,157
10-03-2021,ramanathapuram,11,1,2,0,10,6356,1,133,0,6490,6343,137
10-03-2021,ranipet,13,2,1,0,14,16211,2,49,0,16262,16059,189
10-03-2021,salem,74,11,10,0,75,32417,11,420,0,32848,32306,467
10-03-2021,sivagangai,23,4,5,0,22,6741,4,68,0,6813,6665,126
10-03-2021,tenkasi,24,1,4,1,20,8528,0,50,1,8579,8399,160
10-03-2021,thanjavur,122,15,15,0,122,18231,15,22,0,18268,17890,256
10-03-2021,theni,20,1,1,0,20,17139,1,45,0,17185,16958,207
10-03-2021,thirupathur,10,1,1,1,9,7539,1,110,0,7650,7514,127
10-03-2021,thiruvallur,190,39,24,0,205,44423,39,10,0,44472,43567,700
10-03-2021,thiruvannamalai,22,7,5,0,24,19135,7,393,0,19535,19227,284
10-03-2021,thiruvarur,56,13,4,0,65,11381,13,38,0,11432,11256,111
10-03-2021,thoothukudi,13,1,2,0,12,16102,1,273,0,16376,16221,143
10-03-2021,tirunelveli,43,3,4,0,42,15369,3,420,0,15792,15536,214
10-03-2021,tiruppur,111,28,15,0,124,18498,28,11,0,18537,18189,224
10-03-2021,trichy,77,15,9,0,83,15023,15,42,0,15080,14814,183
10-03-2021,vellore,70,12,8,0,74,20637,8,431,4,21080,20655,351
10-03-2021,villupuram,20,6,2,0,24,15117,6,174,0,15297,15160,113
10-03-2021,virudhunagar,20,4,3,0,21,16589,4,104,0,16697,16444,232
10-03-2021,airport surveillance (international),6,0,0,0,6,0,0,956,0,956,949,1
10-03-2021,airport surveillance (domestic),2,0,0,0,2,0,0,1044,0,1044,1041,1
10-03-2021,railway surveillance,0,0,0,0,0,0,0,428,0,428,428,0
11-03-2021,ariyalur,7,1,1,0,7,4730,1,20,0,4751,4695,49
11-03-2021,chengalpattu,359,51,48,2,360,53335,51,5,0,53391,52243,788
11-03-2021,chennai,1914,292,263,3,1940,237668,292,47,0,238007,231893,4174
11-03-2021,coimbatore,359,52,49,0,362,56195,52,51,0,56298,55251,685
11-03-2021,cuddalore,62,3,9,0,56,25046,3,202,0,25251,24907,288
11-03-2021,dharmapuri,8,3,1,0,10,6451,3,214,0,6668,6603,55
11-03-2021,dindigul,52,12,7,0,57,11475,12,77,0,11564,11307,200
11-03-2021,erode,83,19,13,0,89,14810,19,94,0,14923,14684,150
11-03-2021,kallakurichi,5,1,1,0,5,10510,1,404,0,10915,10802,108
11-03-2021,kancheepuram,85,23,6,0,102,29644,23,3,0,29670,29119,449
11-03-2021,kanyakumari,58,6,4,0,60,17060,6,110,0,17176,16855,261
11-03-2021,karur,8,4,1,0,11,5473,4,46,0,5523,5461,51
11-03-2021,krishnagiri,24,3,4,0,23,8033,3,169,0,8205,8064,118
11-03-2021,madurai,60,8,10,0,58,21158,8,158,0,21324,20805,461
11-03-2021,nagapattinam,41,9,5,0,45,8574,9,89,0,8672,8492,135
11-03-2021,namakkal,37,2,1,0,38,11754,2,106,0,11862,11713,111
11-03-2021,nilgiris,40,4,5,0,39,8384,4,22,0,8410,8323,48
11-03-2021,perambalur,5,0,0,0,5,2287,0,2,0,2289,2263,21
11-03-2021,pudukottai,27,3,4,0,26,11658,3,33,0,11694,11511,157
11-03-2021,ramanathapuram,10,1,1,0,10,6357,1,133,0,6491,6344,137
11-03-2021,ranipet,14,2,1,0,15,16213,2,49,0,16264,16060,189
11-03-2021,salem,75,18,6,0,87,32428,18,420,0,32866,32312,467
11-03-2021,sivagangai,23,4,4,0,23,6746,4,68,0,6818,6669,126
11-03-2021,tenkasi,21,1,3,0,19,8529,1,51,0,8581,8402,160
11-03-2021,thanjavur,121,37,15,0,143,18245,37,22,0,18304,17905,256
11-03-2021,theni,22,3,3,0,22,17142,3,45,0,17190,16961,207
11-03-2021,thirupathur,9,4,1,0,12,7540,4,110,0,7654,7515,127
11-03-2021,thiruvallur,208,49,22,0,235,44465,49,10,0,44524,43589,700
11-03-2021,thiruvannamalai,21,4,5,0,20,19139,4,393,0,19536,19232,284
11-03-2021,thiruvarur,65,6,8,0,63,11394,6,38,0,11438,11264,111
11-03-2021,thoothukudi,12,3,2,0,13,16103,3,273,0,16379,16223,143
11-03-2021,tirunelveli,40,5,3,0,42,15370,5,420,0,15795,15539,214
11-03-2021,tiruppur,125,21,14,0,132,18527,21,11,0,18559,18203,224
11-03-2021,trichy,81,8,8,0,81,15036,8,42,0,15086,14822,183
11-03-2021,vellore,72,19,9,0,82,20643,14,435,5,21097,20664,351
11-03-2021,villupuram,25,1,3,0,23,15124,1,174,0,15299,15163,113
11-03-2021,virudhunagar,21,1,1,0,21,16593,1,104,0,16698,16445,232
11-03-2021,airport surveillance (international),6,2,1,0,7,0,0,956,2,958,950,1
11-03-2021,airport surveillance (domestic),2,0,1,0,1,0,0,1044,0,1044,1042,1
11-03-2021,railway surveillance,0,0,0,0,0,0,0,428,0,428,428,0
12-03-2021,ariyalur,8,1,2,0,7,4732,1,20,0,4753,4697,49
12-03-2021,chengalpattu,361,57,49,0,369,53388,57,5,0,53450,52292,789
12-03-2021,chennai,1957,265,258,3,1961,237976,265,47,0,238288,232151,4176
12-03-2021,coimbatore,362,51,46,0,367,56247,51,51,0,56349,55297,685
12-03-2021,cuddalore,56,9,10,0,55,25049,9,202,0,25260,24917,288
12-03-2021,dharmapuri,10,4,1,0,13,6454,4,214,0,6672,6604,55
12-03-2021,dindigul,57,9,9,0,57,11487,9,77,0,11573,11316,200
12-03-2021,erode,88,17,12,0,93,14828,17,94,0,14939,14696,150
12-03-2021,kallakurichi,4,2,0,0,6,10510,2,404,0,10916,10802,108
12-03-2021,kancheepuram,100,18,9,0,109,29665,18,3,0,29686,29128,449
12-03-2021,kanyakumari,61,7,3,0,65,17067,7,110,0,17184,16858,261
12-03-2021,karur,10,5,1,0,14,5476,5,46,0,5527,5462,51
12-03-2021,krishnagiri,20,5,3,0,22,8033,5,169,0,8207,8067,118
12-03-2021,madurai,58,10,7,0,61,21166,10,158,0,21334,20812,461
12-03-2021,nagapattinam,45,9,4,0,50,8583,9,89,0,8681,8496,135
12-03-2021,namakkal,38,3,2,0,39,11756,3,106,0,11865,11715,111
12-03-2021,nilgiris,38,7,3,0,42,8387,7,22,0,8416,8326,48
12-03-2021,perambalur,5,2,0,0,7,2287,2,2,0,2291,2263,21
12-03-2021,pudukottai,27,5,4,0,28,11662,5,33,0,11700,11515,157
12-03-2021,ramanathapuram,10,1,1,0,10,6358,1,133,0,6492,6345,137
12-03-2021,ranipet,15,6,2,0,19,16215,6,49,0,16270,16062,189
12-03-2021,salem,87,13,8,0,92,32446,13,420,0,32879,32320,467
12-03-2021,sivagangai,22,5,3,0,24,6749,5,68,0,6822,6672,126
12-03-2021,tenkasi,19,1,2,0,18,8530,1,51,0,8582,8404,160
12-03-2021,thanjavur,141,23,15,0,149,18280,23,22,0,18325,17920,256
12-03-2021,theni,22,2,4,0,20,17145,2,45,0,17192,16965,207
12-03-2021,thirupathur,12,3,1,0,14,7544,3,110,0,7657,7516,127
12-03-2021,thiruvallur,221,44,23,1,241,44500,44,10,0,44554,43612,701
12-03-2021,thiruvannamalai,21,5,3,0,23,19144,5,393,0,19542,19235,284
12-03-2021,thiruvarur,64,7,5,0,66,11401,7,38,0,11446,11269,111
12-03-2021,thoothukudi,13,2,1,0,14,16106,2,273,0,16381,16224,143
12-03-2021,tirunelveli,42,4,2,0,44,15375,4,420,0,15799,15541,214
12-03-2021,tiruppur,132,31,13,0,150,18548,31,11,0,18590,18216,224
12-03-2021,trichy,85,12,9,0,88,15048,12,42,0,15102,14831,183
12-03-2021,vellore,81,16,7,0,90,20656,16,440,0,21112,20671,351
12-03-2021,villupuram,23,2,2,0,23,15125,2,174,0,15301,15165,113
12-03-2021,virudhunagar,21,6,1,0,26,16594,6,104,0,16704,16446,232
12-03-2021,airport surveillance (international),7,1,1,0,7,0,0,958,1,959,951,1
12-03-2021,airport surveillance (domestic),1,0,1,0,0,0,0,1044,0,1044,1043,1
12-03-2021,railway surveillance,0,0,0,0,0,0,0,428,0,428,428,0
13-03-2021,ariyalur,7,1,1,0,7,4733,1,20,0,4754,4698,49
13-03-2021,chengalpattu,369,65,48,2,384,53445,65,5,0,53515,52340,791
13-03-2021,chennai,1961,271,251,1,1980,238241,271,47,0,238559,232402,4177
13-03-2021,coimbatore,367,54,44,0,377,56298,54,51,0,56403,55341,685
13-03-2021,cuddalore,55,6,8,0,53,25058,6,202,0,25266,24925,288
13-03-2021,dharmapuri,13,1,2,0,12,6458,1,214,0,6673,6606,55
13-03-2021,dindigul,57,13,7,0,63,11496,13,77,0,11586,11323,200
13-03-2021,erode,93,15,6,0,102,14845,15,94,0,14954,14702,150
13-03-2021,kallakurichi,6,0,1,0,5,10512,0,404,0,10916,10803,108
13-03-2021,kancheepuram,109,24,8,0,125,29683,24,3,0,29710,29136,449
13-03-2021,kanyakumari,65,10,4,0,71,17074,10,110,0,17194,16862,261
13-03-2021,karur,14,3,1,0,16,5481,3,46,0,5530,5463,51
13-03-2021,krishnagiri,22,8,2,0,28,8038,8,169,0,8215,8069,118
13-03-2021,madurai,61,14,8,0,67,21176,14,158,0,21348,20820,461
13-03-2021,nagapattinam,50,10,3,0,57,8592,10,89,0,8691,8499,135
13-03-2021,namakkal,39,4,2,0,41,11759,4,106,0,11869,11717,111
13-03-2021,nilgiris,42,12,4,1,49,8394,12,22,0,8428,8330,49
13-03-2021,perambalur,7,1,1,0,7,2289,1,2,0,2292,2264,21
13-03-2021,pudukottai,28,2,5,0,25,11667,2,33,0,11702,11520,157
13-03-2021,ramanathapuram,10,1,1,0,10,6359,1,133,0,6493,6346,137
13-03-2021,ranipet,19,2,2,0,19,16221,2,49,0,16272,16064,189
13-03-2021,salem,92,11,9,0,94,32459,11,420,0,32890,32329,467
13-03-2021,sivagangai,24,8,2,0,30,6754,8,68,0,6830,6674,126
13-03-2021,tenkasi,18,1,3,0,16,8531,1,51,0,8583,8407,160
13-03-2021,thanjavur,149,20,16,0,153,18303,20,22,0,18345,17936,256
13-03-2021,theni,20,5,3,0,22,17147,5,45,0,17197,16968,207
13-03-2021,thirupathur,14,2,1,0,15,7547,2,110,0,7659,7517,127
13-03-2021,thiruvallur,241,40,21,0,260,44544,40,10,0,44594,43633,701
13-03-2021,thiruvannamalai,23,3,3,0,23,19149,3,393,0,19545,19238,284
13-03-2021,thiruvarur,66,11,4,0,73,11408,11,38,0,11457,11273,111
13-03-2021,thoothukudi,14,6,2,0,18,16108,6,273,0,16387,16226,143
13-03-2021,tirunelveli,44,5,3,0,46,15379,5,420,0,15804,15544,214
13-03-2021,tiruppur,150,27,11,0,166,18579,27,11,0,18617,18227,224
13-03-2021,trichy,88,14,8,0,94,15060,14,42,0,15116,14839,183
13-03-2021,vellore,90,13,11,0,92,20672,9,440,4,21125,20682,351
13-03-2021,villupuram,23,2,2,0,23,15127,2,174,0,15303,15167,113
13-03-2021,virudhunagar,26,9,2,0,33,16600,9,104,0,16713,16448,232
13-03-2021,airport surveillance (international),7,1,2,0,6,0,0,959,1,960,953,1
13-03-2021,airport surveillance (domestic),0,0,0,0,0,0,0,1044,0,1044,1043,1
13-03-2021,railway surveillance,0,0,0,0,0,0,0,428,0,428,428,0
14-03-2021,ariyalur,6,2,1,0,7,4733,2,20,0,4755,4699,49
14-03-2021,chengalpattu,391,63,54,3,397,53517,63,5,0,53585,52394,794
14-03-2021,chennai,1947,294,261,1,1979,238479,294,47,0,238820,232663,4178
14-03-2021,coimbatore,384,58,46,0,396,56359,58,51,0,56468,55387,685
14-03-2021,cuddalore,57,7,6,0,58,25068,7,202,0,25277,24931,288
14-03-2021,dharmapuri,11,1,1,0,11,6458,1,214,0,6673,6607,55
14-03-2021,dindigul,60,11,6,0,65,11506,11,77,0,11594,11329,200
14-03-2021,erode,103,22,11,0,114,14861,22,94,0,14977,14713,150
14-03-2021,kallakurichi,4,0,0,0,4,10511,0,404,0,10915,10803,108
14-03-2021,kancheepuram,126,27,7,0,146,29708,27,3,0,29738,29143,449
14-03-2021,kanyakumari,71,12,5,0,78,17084,12,110,0,17206,16867,261
14-03-2021,karur,15,4,2,0,17,5483,4,46,0,5533,5465,51
14-03-2021,krishnagiri,29,5,2,0,32,8047,5,169,0,8221,8071,118
14-03-2021,madurai,68,11,9,0,70,21191,11,158,0,21360,20829,461
14-03-2021,nagapattinam,58,7,2,0,63,8603,7,89,0,8699,8501,135
14-03-2021,namakkal,42,7,3,0,46,11764,7,106,0,11877,11720,111
14-03-2021,nilgiris,49,13,5,0,57,8406,13,22,0,8441,8335,49
14-03-2021,perambalur,8,1,0,0,9,2291,1,2,0,2294,2264,21
14-03-2021,pudukottai,26,3,4,0,25,11670,3,33,0,11706,11524,157
14-03-2021,ramanathapuram,11,1,1,0,11,6361,1,133,0,6495,6347,137
14-03-2021,ranipet,20,1,2,0,19,16224,1,49,0,16274,16066,189
14-03-2021,salem,95,10,13,0,92,32471,10,420,0,32901,32342,467
14-03-2021,sivagangai,27,6,2,0,31,6759,6,68,0,6833,6676,126
14-03-2021,tenkasi,16,1,3,0,14,8532,1,51,0,8584,8410,160
14-03-2021,thanjavur,152,44,19,0,177,18322,44,22,0,18388,17955,256
14-03-2021,theni,22,2,2,0,22,17152,2,45,0,17199,16970,207
14-03-2021,thirupathur,15,3,1,0,17,7549,3,110,0,7662,7518,127
14-03-2021,thiruvallur,269,42,27,0,284,44593,42,10,0,44645,43660,701
14-03-2021,thiruvannamalai,23,4,2,0,25,19152,4,393,0,19549,19240,284
14-03-2021,thiruvarur,73,10,4,0,79,11419,10,38,0,11467,11277,111
14-03-2021,thoothukudi,18,5,2,0,21,16114,5,273,0,16392,16228,143
14-03-2021,tirunelveli,47,8,3,0,52,15385,8,420,0,15813,15547,214
14-03-2021,tiruppur,168,33,17,0,184,18608,33,11,0,18652,18244,224
14-03-2021,trichy,96,15,7,0,104,15076,15,42,0,15133,14846,183
14-03-2021,vellore,92,12,12,0,92,20681,12,444,0,21137,20694,351
14-03-2021,villupuram,23,3,1,0,25,15129,3,174,0,15306,15168,113
14-03-2021,virudhunagar,34,10,4,0,40,16610,10,104,0,16724,16452,232
14-03-2021,airport surveillance (international),6,1,0,0,7,0,0,960,1,961,953,1
14-03-2021,airport surveillance (domestic),0,0,0,0,0,0,0,1044,0,1044,1043,1
14-03-2021,railway surveillance,0,0,0,0,0,0,0,428,0,428,428,0
15-03-2021,ariyalur,7,1,1,0,7,4735,1,20,0,4756,4700,49
15-03-2021,chengalpattu,404,81,57,0,428,53587,81,5,0,53673,52451,794
15-03-2021,chennai,1973,317,266,1,2023,238767,317,47,0,239131,232929,4179
15-03-2021,coimbatore,401,70,49,1,421,56422,70,51,0,56543,55436,686
15-03-2021,cuddalore,59,8,8,0,59,25076,8,202,0,25286,24939,288
15-03-2021,dharmapuri,12,1,2,0,11,6460,1,214,0,6675,6609,55
15-03-2021,dindigul,65,8,5,0,68,11517,8,77,0,11602,11334,200
15-03-2021,erode,112,19,10,0,121,14881,19,94,0,14994,14723,150
15-03-2021,kallakurichi,4,1,0,0,5,10511,1,404,0,10916,10803,108
15-03-2021,kancheepuram,141,22,8,0,155,29730,22,3,0,29755,29151,449
15-03-2021,kanyakumari,78,15,9,0,84,17096,15,110,0,17221,16876,261
15-03-2021,karur,17,5,1,0,21,5487,5,46,0,5538,5466,51
15-03-2021,krishnagiri,31,6,2,0,35,8051,6,169,0,8226,8073,118
15-03-2021,madurai,68,18,7,1,78,21200,18,158,0,21376,20836,462
15-03-2021,nagapattinam,65,8,5,1,67,8612,8,89,0,8709,8506,136
15-03-2021,namakkal,46,6,4,0,48,11771,6,106,0,11883,11724,111
15-03-2021,nilgiris,58,9,6,0,61,8420,9,22,0,8451,8341,49
15-03-2021,perambalur,9,2,2,0,9,2292,2,2,0,2296,2266,21
15-03-2021,pudukottai,26,8,3,0,31,11674,8,33,0,11715,11527,157
15-03-2021,ramanathapuram,11,1,1,0,11,6362,1,133,0,6496,6348,137
15-03-2021,ranipet,19,2,2,0,19,16225,2,49,0,16276,16068,189
15-03-2021,salem,92,7,11,0,88,32481,7,420,0,32908,32353,467
15-03-2021,sivagangai,29,10,1,0,38,6763,10,68,0,6841,6677,126
15-03-2021,tenkasi,14,1,2,0,13,8533,1,51,0,8585,8412,160
15-03-2021,thanjavur,176,58,18,0,216,18365,58,22,0,18445,17973,256
15-03-2021,theni,22,3,1,0,24,17154,3,45,0,17202,16971,207
15-03-2021,thirupathur,19,2,1,0,20,7554,2,110,0,7666,7519,127
15-03-2021,thiruvallur,282,44,24,0,302,44633,44,10,0,44687,43684,701
15-03-2021,thiruvannamalai,25,2,1,0,26,19156,2,393,0,19551,19241,284
15-03-2021,thiruvarur,80,19,5,0,94,11430,19,38,0,11487,11282,111
15-03-2021,thoothukudi,20,4,1,0,23,16118,4,273,0,16395,16229,143
15-03-2021,tirunelveli,52,9,2,0,59,15393,9,420,0,15822,15549,214
15-03-2021,tiruppur,186,29,16,0,199,18643,29,11,0,18683,18260,224
15-03-2021,trichy,103,16,8,0,111,15090,16,42,0,15148,14854,183
15-03-2021,vellore,92,13,9,0,96,20693,13,444,0,21150,20703,351
15-03-2021,villupuram,25,4,2,0,27,15132,4,174,0,15310,15170,113
15-03-2021,virudhunagar,40,6,3,0,43,16620,6,104,0,16730,16455,232
15-03-2021,airport surveillance (international),7,1,0,0,8,0,0,961,1,962,953,1
15-03-2021,airport surveillance (domestic),0,0,0,0,0,0,0,1044,0,1044,1043,1
15-03-2021,railway surveillance,0,0,0,0,0,0,0,428,0,428,428,0
16-03-2021,ariyalur,7,1,1,0,7,4736,1,20,0,4757,4701,49
16-03-2021,chengalpattu,428,86,59,1,454,53668,86,5,0,53759,52510,795
16-03-2021,chennai,2023,352,237,3,2135,239084,352,47,0,239483,233166,4182
16-03-2021,coimbatore,421,81,54,0,448,56492,81,51,0,56624,55490,686
16-03-2021,cuddalore,59,10,10,0,59,25084,10,202,0,25296,24949,288
16-03-2021,dharmapuri,11,0,1,0,10,6461,0,214,0,6675,6610,55
16-03-2021,dindigul,68,6,7,0,67,11525,6,77,0,11608,11341,200
16-03-2021,erode,121,11,13,0,119,14900,11,94,0,15005,14736,150
16-03-2021,kallakurichi,5,2,0,0,7,10512,2,404,0,10918,10803,108
16-03-2021,kancheepuram,155,23,9,0,169,29752,23,3,0,29778,29160,449
16-03-2021,kanyakumari,84,13,13,0,84,17111,13,110,0,17234,16889,261
16-03-2021,karur,21,6,1,0,26,5492,6,46,0,5544,5467,51
16-03-2021,krishnagiri,35,5,4,0,36,8057,5,169,0,8231,8077,118
16-03-2021,madurai,78,13,9,0,82,21218,12,158,1,21389,20845,462
16-03-2021,nagapattinam,67,13,8,0,72,8620,13,89,0,8722,8514,136
16-03-2021,namakkal,48,5,6,0,47,11777,5,106,0,11888,11730,111
16-03-2021,nilgiris,61,4,8,0,57,8429,4,22,0,8455,8349,49
16-03-2021,perambalur,9,0,1,0,8,2294,0,2,0,2296,2267,21
16-03-2021,pudukottai,31,6,5,0,32,11682,6,33,0,11721,11532,157
16-03-2021,ramanathapuram,11,0,1,0,10,6363,0,133,0,6496,6349,137
16-03-2021,ranipet,19,3,2,0,20,16227,3,49,0,16279,16070,189
16-03-2021,salem,88,15,7,0,96,32488,15,420,0,32923,32360,467
16-03-2021,sivagangai,38,8,2,0,44,6773,8,68,0,6849,6679,126
16-03-2021,tenkasi,13,3,2,0,14,8534,3,51,0,8588,8414,160
16-03-2021,thanjavur,216,51,16,0,251,18423,51,22,0,18496,17989,256
16-03-2021,theni,24,4,2,0,26,17157,4,45,0,17206,16973,207
16-03-2021,thirupathur,20,3,2,0,21,7556,3,110,0,7669,7521,127
16-03-2021,thiruvallur,302,55,26,0,331,44677,55,10,0,44742,43710,701
16-03-2021,thiruvannamalai,26,4,2,0,28,19158,4,393,0,19555,19243,284
16-03-2021,thiruvarur,94,12,4,1,101,11449,12,38,0,11499,11286,112
16-03-2021,thoothukudi,23,2,3,0,22,16122,2,273,0,16397,16232,143
16-03-2021,tirunelveli,59,7,5,0,61,15402,7,420,0,15829,15554,214
16-03-2021,tiruppur,199,23,14,0,208,18672,23,11,0,18706,18274,224
16-03-2021,trichy,111,17,12,0,116,15106,17,42,0,15165,14866,183
16-03-2021,vellore,96,14,6,0,104,20706,13,444,1,21164,20709,351
16-03-2021,villupuram,27,3,4,0,26,15136,3,174,0,15313,15174,113
16-03-2021,virudhunagar,43,5,5,0,43,16626,5,104,0,16735,16460,232
16-03-2021,airport surveillance (international),8,0,0,0,8,0,0,962,0,962,953,1
16-03-2021,airport surveillance (domestic),0,1,0,0,1,0,0,1044,1,1045,1043,1
16-03-2021,railway surveillance,0,0,0,0,0,0,0,428,0,428,428,0
17-03-2021,ariyalur,7,2,1,0,8,4737,2,20,0,4759,4702,49
17-03-2021,chengalpattu,454,103,57,1,499,53754,103,5,0,53862,52567,796
17-03-2021,chennai,2135,395,248,5,2277,239436,395,47,0,239878,233414,4187
17-03-2021,coimbatore,448,107,49,0,506,56573,107,51,0,56731,55539,686
17-03-2021,cuddalore,59,11,9,0,61,25094,11,202,0,25307,24958,288
17-03-2021,dharmapuri,10,5,1,0,14,6461,5,214,0,6680,6611,55
17-03-2021,dindigul,67,12,5,0,74,11531,12,77,0,11620,11346,200
17-03-2021,erode,119,12,11,0,120,14911,12,94,0,15017,14747,150
17-03-2021,kallakurichi,7,1,2,0,6,10514,1,404,0,10919,10805,108
17-03-2021,kancheepuram,169,30,8,0,191,29775,30,3,0,29808,29168,449
17-03-2021,kanyakumari,84,14,14,0,84,17124,11,110,3,17248,16903,261
17-03-2021,karur,26,5,1,0,30,5498,5,46,0,5549,5468,51
17-03-2021,krishnagiri,36,9,3,0,42,8062,9,169,0,8240,8080,118
17-03-2021,madurai,82,19,8,0,93,21230,19,159,0,21408,20853,462
17-03-2021,nagapattinam,72,10,7,0,75,8633,10,89,0,8732,8521,136
17-03-2021,namakkal,47,7,8,0,46,11782,7,106,0,11895,11738,111
17-03-2021,nilgiris,57,10,4,0,63,8433,10,22,0,8465,8353,49
17-03-2021,perambalur,8,0,1,0,7,2294,0,2,0,2296,2268,21
17-03-2021,pudukottai,32,11,4,0,39,11688,11,33,0,11732,11536,157
17-03-2021,ramanathapuram,10,1,2,0,9,6363,1,133,0,6497,6351,137
17-03-2021,ranipet,20,1,3,0,18,16230,1,49,0,16280,16073,189
17-03-2021,salem,96,13,9,0,100,32503,13,420,0,32936,32369,467
17-03-2021,sivagangai,44,5,3,0,46,6781,5,68,0,6854,6682,126
17-03-2021,tenkasi,14,2,2,0,14,8537,2,51,0,8590,8416,160
17-03-2021,thanjavur,251,10,15,0,246,18474,10,22,0,18506,18004,256
17-03-2021,theni,26,2,3,0,25,17161,2,45,0,17208,16976,207
17-03-2021,thirupathur,21,8,2,0,27,7559,8,110,0,7677,7523,127
17-03-2021,thiruvallur,331,56,29,0,358,44732,56,10,0,44798,43739,701
17-03-2021,thiruvannamalai,28,3,3,1,27,19162,3,393,0,19558,19246,285
17-03-2021,thiruvarur,101,7,12,0,96,11461,7,38,0,11506,11298,112
17-03-2021,thoothukudi,22,6,1,0,27,16124,6,273,0,16403,16233,143
17-03-2021,tirunelveli,61,11,9,0,63,15409,11,420,0,15840,15563,214
17-03-2021,tiruppur,208,22,15,0,215,18695,22,11,0,18728,18289,224
17-03-2021,trichy,116,13,13,0,116,15123,13,42,0,15178,14879,183
17-03-2021,vellore,104,11,7,1,107,20719,7,445,4,21175,20716,352
17-03-2021,villupuram,26,5,3,0,28,15139,5,174,0,15318,15177,113
17-03-2021,virudhunagar,43,6,2,0,47,16631,6,104,0,16741,16462,232
17-03-2021,airport surveillance (international),8,0,2,0,6,0,0,962,0,962,955,1
17-03-2021,airport surveillance (domestic),1,0,0,0,1,0,0,1045,0,1045,1043,1
17-03-2021,railway surveillance,0,0,0,0,0,0,0,428,0,428,428,0
18-03-2021,ariyalur,9,2,1,0,10,4740,2,20,0,4762,4703,49
18-03-2021,chengalpattu,515,86,55,1,545,53873,86,5,0,53964,52622,797
18-03-2021,chennai,2250,394,247,3,2394,239804,394,47,0,240245,233661,4190
18-03-2021,coimbatore,512,77,48,0,541,56686,77,51,0,56814,55587,686
18-03-2021,cuddalore,62,14,7,0,69,25106,14,202,0,25322,24965,288
18-03-2021,dharmapuri,14,7,1,0,20,6466,7,214,0,6687,6612,55
18-03-2021,dindigul,76,10,6,0,80,11545,10,77,0,11632,11352,200
18-03-2021,erode,112,17,9,0,120,14915,17,94,0,15026,14756,150
18-03-2021,kallakurichi,5,1,2,0,4,10514,1,404,0,10919,10807,108
18-03-2021,kancheepuram,190,40,14,0,216,29804,40,3,0,29847,29182,449
18-03-2021,kanyakumari,84,11,9,0,86,17135,11,113,0,17259,16912,261
18-03-2021,karur,30,6,1,0,35,5503,6,46,0,5555,5469,51
18-03-2021,krishnagiri,42,8,2,0,48,8071,6,169,2,8248,8082,118
18-03-2021,madurai,85,18,6,0,97,21241,18,159,0,21418,20859,462
18-03-2021,nagapattinam,74,9,6,0,77,8642,9,89,0,8740,8527,136
18-03-2021,namakkal,43,13,5,0,51,11786,13,106,0,11905,11743,111
18-03-2021,nilgiris,61,9,3,0,67,8441,9,22,0,8472,8356,49
18-03-2021,perambalur,7,0,1,0,6,2294,0,2,0,2296,2269,21
18-03-2021,pudukottai,37,7,3,0,41,11697,7,33,0,11737,11539,157
18-03-2021,ramanathapuram,9,2,2,0,9,6364,2,133,0,6499,6353,137
18-03-2021,ranipet,15,3,1,1,16,16228,3,49,0,16280,16074,190
18-03-2021,salem,102,26,11,0,117,32518,26,420,0,32964,32380,467
18-03-2021,sivagangai,46,0,2,1,43,6786,0,68,0,6854,6684,127
18-03-2021,tenkasi,15,3,3,0,15,8540,3,51,0,8594,8419,160
18-03-2021,thanjavur,245,47,12,3,277,18483,47,22,0,18552,18016,259
18-03-2021,theni,25,4,4,0,25,17163,4,45,0,17212,16980,207
18-03-2021,thirupathur,27,1,2,0,26,7567,1,110,0,7678,7525,127
18-03-2021,thiruvallur,369,71,31,0,409,44799,71,10,0,44880,43770,701
18-03-2021,thiruvannamalai,30,5,4,0,31,19168,5,393,0,19566,19250,285
18-03-2021,thiruvarur,98,19,11,0,106,11470,19,38,0,11527,11309,112
18-03-2021,thoothukudi,28,5,2,0,31,16131,5,273,0,16409,16235,143
18-03-2021,tirunelveli,66,6,8,0,64,15423,6,420,0,15849,15571,214
18-03-2021,tiruppur,215,35,17,0,233,18717,35,11,0,18763,18306,224
18-03-2021,trichy,123,8,18,0,113,15143,8,42,0,15193,14897,183
18-03-2021,vellore,108,16,8,0,116,20727,14,449,2,21192,20724,352
18-03-2021,villupuram,28,4,4,0,28,15144,4,174,0,15322,15181,113
18-03-2021,virudhunagar,47,5,3,0,49,16637,5,104,0,16746,16465,232
18-03-2021,airport surveillance (international),6,0,0,0,6,0,0,962,0,962,955,1
18-03-2021,airport surveillance (domestic),1,0,0,0,1,0,0,1045,0,1045,1043,1
18-03-2021,railway surveillance,0,0,0,0,0,0,0,428,0,428,428,0
19-03-2021,ariyalur,10,2,1,0,11,4742,2,20,0,4764,4704,49
19-03-2021,chengalpattu,539,105,57,2,585,53953,105,5,0,54063,52679,799
19-03-2021,chennai,2399,421,264,4,2552,240203,421,47,0,240671,233925,4194
19-03-2021,coimbatore,542,102,54,0,590,56764,102,51,0,56917,55641,686
19-03-2021,cuddalore,72,9,8,0,73,25123,9,202,0,25334,24973,288
19-03-2021,dharmapuri,20,6,1,0,25,6473,6,214,0,6693,6613,55
19-03-2021,dindigul,79,15,7,0,87,11554,15,77,0,11646,11359,200
19-03-2021,erode,118,15,10,0,123,14930,15,94,0,15039,14766,150
19-03-2021,kallakurichi,4,2,0,0,6,10515,2,404,0,10921,10807,108
19-03-2021,kancheepuram,204,37,12,0,229,29832,37,3,0,29872,29194,449
19-03-2021,kanyakumari,84,7,8,0,83,17144,7,113,0,17264,16920,261
19-03-2021,karur,35,8,2,0,41,5509,8,46,0,5563,5471,51
19-03-2021,krishnagiri,47,11,3,0,55,8076,10,171,1,8258,8085,118
19-03-2021,madurai,98,14,7,0,105,21260,14,159,0,21433,20866,462
19-03-2021,nagapattinam,77,13,8,0,82,8651,13,89,0,8753,8535,136
19-03-2021,namakkal,51,7,4,0,54,11799,7,106,0,11912,11747,111
19-03-2021,nilgiris,67,10,4,1,72,8450,10,22,0,8482,8360,50
19-03-2021,perambalur,6,1,0,0,7,2294,1,2,0,2297,2269,21
19-03-2021,pudukottai,41,8,2,0,47,11704,8,33,0,11745,11541,157
19-03-2021,ramanathapuram,9,1,2,0,8,6366,1,133,0,6500,6355,137
19-03-2021,ranipet,19,7,2,0,24,16234,7,49,0,16290,16076,190
19-03-2021,salem,120,27,14,0,133,32547,27,420,0,32994,32394,467
19-03-2021,sivagangai,40,6,1,0,45,6783,6,68,0,6857,6685,127
19-03-2021,tenkasi,16,4,2,0,18,8544,4,51,0,8599,8421,160
19-03-2021,thanjavur,278,64,15,1,326,18531,64,22,0,18617,18031,260
19-03-2021,theni,24,1,3,0,22,17166,1,45,0,17212,16983,207
19-03-2021,thirupathur,26,3,3,0,26,7568,3,110,0,7681,7528,127
19-03-2021,thiruvallur,421,78,44,1,454,44882,78,10,0,44970,43814,702
19-03-2021,thiruvannamalai,31,4,5,0,30,19173,4,393,0,19570,19255,285
19-03-2021,thiruvarur,106,15,9,0,112,11489,15,38,0,11542,11318,112
19-03-2021,thoothukudi,32,4,3,0,33,16137,4,273,0,16414,16238,143
19-03-2021,tirunelveli,65,9,6,0,68,15430,9,420,0,15859,15577,214
19-03-2021,tiruppur,233,29,19,0,243,18752,29,11,0,18792,18325,224
19-03-2021,trichy,109,13,11,0,111,15147,13,42,0,15202,14908,183
19-03-2021,vellore,116,12,12,0,116,20741,12,451,0,21204,20736,352
19-03-2021,villupuram,28,8,3,0,33,15148,8,174,0,15330,15184,113
19-03-2021,virudhunagar,49,6,2,0,53,16642,6,104,0,16752,16467,232
19-03-2021,airport surveillance (international),6,1,2,0,5,0,0,962,1,963,957,1
19-03-2021,airport surveillance (domestic),1,2,0,0,3,0,0,1045,2,1047,1043,1
19-03-2021,railway surveillance,0,0,0,0,0,0,0,428,0,428,428,0
20-03-2021,ariyalur,11,3,1,0,13,4744,3,20,0,4767,4705,49
20-03-2021,chengalpattu,594,134,58,1,669,54067,134,5,0,54206,52737,800
20-03-2021,chennai,2550,458,259,2,2747,240622,458,47,0,241127,234184,4196
20-03-2021,coimbatore,593,103,61,0,635,56869,103,51,0,57023,55702,686
20-03-2021,cuddalore,68,14,6,1,75,25127,14,202,0,25343,24979,289
20-03-2021,dharmapuri,25,8,1,0,32,6479,8,214,0,6701,6614,55
20-03-2021,dindigul,89,16,5,0,100,11571,16,77,0,11664,11364,200
20-03-2021,erode,122,8,13,0,117,14944,8,94,0,15046,14779,150
20-03-2021,kallakurichi,6,1,0,0,7,10517,1,404,0,10922,10807,108
20-03-2021,kancheepuram,224,41,23,1,241,29864,41,3,0,29908,29217,450
20-03-2021,kanyakumari,83,21,9,0,95,17151,21,113,0,17285,16929,261
20-03-2021,karur,42,5,2,0,45,5518,5,46,0,5569,5473,51
20-03-2021,krishnagiri,55,13,4,0,64,8086,13,172,0,8271,8089,118
20-03-2021,madurai,101,17,8,0,110,21270,16,159,1,21446,20874,462
20-03-2021,nagapattinam,82,17,10,0,89,8664,17,89,0,8770,8545,136
20-03-2021,namakkal,54,12,6,0,60,11806,12,106,0,11924,11753,111
20-03-2021,nilgiris,72,11,5,0,78,8460,11,22,0,8493,8365,50
20-03-2021,perambalur,6,1,1,0,6,2294,1,2,0,2297,2270,21
20-03-2021,pudukottai,47,2,3,0,46,11712,2,33,0,11747,11544,157
20-03-2021,ramanathapuram,8,1,1,0,8,6367,1,133,0,6501,6356,137
20-03-2021,ranipet,23,6,3,0,26,16240,6,49,0,16295,16079,190
20-03-2021,salem,133,28,12,0,149,32574,28,420,0,33022,32406,467
20-03-2021,sivagangai,43,9,3,0,49,6787,9,68,0,6864,6688,127
20-03-2021,tenkasi,18,3,1,0,20,8548,3,51,0,8602,8422,160
20-03-2021,thanjavur,326,85,17,1,393,18595,85,22,0,18702,18048,261
20-03-2021,theni,22,4,1,0,25,17167,4,45,0,17216,16984,207
20-03-2021,thirupathur,26,2,2,0,26,7571,2,110,0,7683,7530,127
20-03-2021,thiruvallur,463,87,41,0,509,44969,87,10,0,45066,43855,702
20-03-2021,thiruvannamalai,31,6,6,0,31,19178,6,393,0,19577,19261,285
20-03-2021,thiruvarur,112,22,11,0,123,11504,22,38,0,11564,11329,112
20-03-2021,thoothukudi,32,13,1,0,44,16140,13,273,0,16426,16239,143
20-03-2021,tirunelveli,67,12,4,0,75,15438,12,420,0,15870,15581,214
20-03-2021,tiruppur,241,33,24,0,250,18779,33,11,0,18823,18349,224
20-03-2021,trichy,111,19,14,1,115,15160,19,42,0,15221,14922,184
20-03-2021,vellore,116,18,11,0,123,20753,17,451,1,21222,20747,352
20-03-2021,villupuram,33,5,4,1,33,15156,5,174,0,15335,15188,114
20-03-2021,virudhunagar,53,4,3,0,54,16648,4,104,0,16756,16470,232
20-03-2021,airport surveillance (international),5,1,0,0,6,0,0,963,1,964,957,1
20-03-2021,airport surveillance (domestic),3,0,0,0,3,0,0,1047,0,1047,1043,1
20-03-2021,railway surveillance,0,0,0,0,0,0,0,428,0,428,428,0
21-03-2021,ariyalur,13,4,1,0,16,4747,4,20,0,4771,4706,49
21-03-2021,chengalpattu,672,138,59,1,750,54204,138,5,0,54347,52796,801
21-03-2021,chennai,2777,466,257,1,2985,241110,466,47,0,241623,234441,4197
21-03-2021,coimbatore,635,109,57,0,687,56972,109,51,0,57132,55759,686
21-03-2021,cuddalore,74,16,8,0,82,25140,16,202,0,25358,24987,289
21-03-2021,dharmapuri,32,12,4,0,40,6487,12,214,0,6713,6618,55
21-03-2021,dindigul,100,22,11,0,111,11587,22,77,0,11686,11375,200
21-03-2021,erode,117,14,12,0,119,14952,14,94,0,15060,14791,150
21-03-2021,kallakurichi,5,1,1,0,5,10516,1,404,0,10921,10808,108
21-03-2021,kancheepuram,242,32,19,1,254,29906,32,3,0,29941,29236,451
21-03-2021,kanyakumari,95,12,8,0,99,17172,12,113,0,17297,16937,261
21-03-2021,karur,45,8,4,0,49,5523,8,46,0,5577,5477,51
21-03-2021,krishnagiri,65,17,5,0,77,8100,15,172,2,8289,8094,118
21-03-2021,madurai,109,22,7,0,124,21285,22,160,0,21467,20881,462
21-03-2021,nagapattinam,90,19,12,1,96,8682,19,89,0,8790,8557,137
21-03-2021,namakkal,60,10,8,0,62,11818,10,106,0,11934,11761,111
21-03-2021,nilgiris,79,14,9,0,84,8472,14,22,0,8508,8374,50
21-03-2021,perambalur,6,2,1,0,7,2295,2,2,0,2299,2271,21
21-03-2021,pudukottai,46,5,2,1,48,11714,5,33,0,11752,11546,158
21-03-2021,ramanathapuram,8,3,1,0,10,6368,3,133,0,6504,6357,137
21-03-2021,ranipet,26,10,3,0,33,16246,10,49,0,16305,16082,190
21-03-2021,salem,149,27,19,0,157,32602,27,420,0,33049,32425,467
21-03-2021,sivagangai,49,11,4,0,56,6796,11,68,0,6875,6692,127
21-03-2021,tenkasi,19,15,2,0,32,8550,13,51,2,8616,8424,160
21-03-2021,thanjavur,394,73,19,1,447,18681,73,22,0,18776,18067,262
21-03-2021,theni,25,6,3,0,28,17171,6,45,0,17222,16987,207
21-03-2021,thirupathur,26,6,3,0,29,7573,6,110,0,7689,7533,127
21-03-2021,thiruvallur,480,72,37,1,514,45027,72,10,0,45109,43892,703
21-03-2021,thiruvannamalai,31,5,3,0,33,19184,5,393,0,19582,19264,285
21-03-2021,thiruvarur,123,26,14,0,135,11526,26,38,0,11590,11343,112
21-03-2021,thoothukudi,44,6,4,0,46,16153,6,273,0,16432,16243,143
21-03-2021,tirunelveli,76,18,9,1,84,15451,18,420,0,15889,15590,215
21-03-2021,tiruppur,250,35,27,0,258,18812,35,11,0,18858,18376,224
21-03-2021,trichy,110,21,11,0,120,15174,21,42,0,15237,14933,184
21-03-2021,vellore,123,15,14,1,123,20770,11,452,4,21237,20761,353
21-03-2021,villupuram,33,8,3,0,38,15161,8,174,0,15343,15191,114
21-03-2021,virudhunagar,54,8,7,0,55,16652,8,104,0,16764,16477,232
21-03-2021,airport surveillance (international),6,1,0,0,7,0,0,964,1,965,957,1
21-03-2021,airport surveillance (domestic),3,0,0,0,3,0,0,1047,0,1047,1043,1
21-03-2021,railway surveillance,0,0,0,0,0,0,0,428,0,428,428,0
22-03-2021,ariyalur,16,6,2,0,20,4751,6,20,0,4777,4708,49
22-03-2021,chengalpattu,746,126,53,2,817,54338,126,5,0,54469,52849,803
22-03-2021,chennai,2980,496,261,4,3211,241572,496,47,0,242115,234702,4202
22-03-2021,coimbatore,692,130,52,2,768,57086,130,51,0,57267,55811,688
22-03-2021,cuddalore,82,30,6,0,106,25156,30,202,0,25388,24993,289
22-03-2021,dharmapuri,40,8,3,0,45,6499,8,214,0,6721,6621,55
22-03-2021,dindigul,112,15,14,0,113,11610,15,77,0,11702,11389,200
22-03-2021,erode,119,22,13,0,128,14966,22,94,0,15082,14804,150
22-03-2021,kallakurichi,3,1,0,0,4,10515,1,404,0,10920,10808,108
22-03-2021,kancheepuram,258,35,18,0,275,29942,35,3,0,29980,29254,451
22-03-2021,kanyakumari,99,13,7,0,105,17184,13,113,0,17310,16944,261
22-03-2021,karur,47,7,5,0,49,5529,7,46,0,5582,5482,51
22-03-2021,krishnagiri,76,9,7,0,78,8114,9,174,0,8297,8101,118
22-03-2021,madurai,121,34,4,0,151,21304,34,160,0,21498,20885,462
22-03-2021,nagapattinam,96,15,7,0,104,8701,15,89,0,8805,8564,137
22-03-2021,namakkal,61,13,6,0,68,11827,13,106,0,11946,11767,111
22-03-2021,nilgiris,82,16,9,0,89,8484,16,22,0,8522,8383,50
22-03-2021,perambalur,6,2,0,0,8,2296,2,2,0,2300,2271,21
22-03-2021,pudukottai,48,4,1,0,51,11719,4,33,0,11756,11547,158
22-03-2021,ramanathapuram,10,1,2,0,9,6371,1,133,0,6505,6359,137
22-03-2021,ranipet,33,15,2,0,46,16256,15,49,0,16320,16084,190
22-03-2021,salem,158,35,15,1,177,32630,35,420,0,33085,32440,468
22-03-2021,sivagangai,56,12,5,0,63,6807,12,68,0,6887,6697,127
22-03-2021,tenkasi,32,20,2,0,50,8563,19,53,1,8636,8426,160
22-03-2021,thanjavur,448,83,26,1,504,18755,83,22,0,18860,18093,263
22-03-2021,theni,28,9,4,0,33,17177,9,45,0,17231,16991,207
22-03-2021,thirupathur,29,15,3,0,41,7579,15,110,0,7704,7536,127
22-03-2021,thiruvallur,519,62,38,0,543,45104,62,10,0,45176,43930,703
22-03-2021,thiruvannamalai,34,4,4,0,34,19190,3,393,1,19587,19268,285
22-03-2021,thiruvarur,135,35,13,0,157,11552,35,38,0,11625,11356,112
22-03-2021,thoothukudi,46,11,5,0,52,16159,11,273,0,16443,16248,143
22-03-2021,tirunelveli,84,11,6,0,89,15469,11,420,0,15900,15596,215
22-03-2021,tiruppur,259,40,29,0,270,18848,40,11,0,18899,18405,224
22-03-2021,trichy,120,20,10,0,130,15195,20,42,0,15257,14943,184
22-03-2021,vellore,123,10,16,0,117,20781,10,456,0,21247,20777,353
22-03-2021,villupuram,39,15,2,0,52,15169,15,174,0,15358,15193,113
22-03-2021,virudhunagar,56,4,7,0,53,16661,4,104,0,16769,16484,232
22-03-2021,airport surveillance (international),7,1,2,0,6,0,0,965,1,966,959,1
22-03-2021,airport surveillance (domestic),3,0,0,0,3,0,0,1047,0,1047,1043,1
22-03-2021,railway surveillance,0,0,0,0,0,0,0,428,0,428,428,0
23-03-2021,ariyalur,20,5,1,0,24,4757,5,20,0,4782,4709,49
23-03-2021,chengalpattu,817,149,55,2,909,54464,149,5,0,54618,52904,805
23-03-2021,chennai,3211,532,298,4,3441,242068,532,47,0,242647,235000,4206
23-03-2021,coimbatore,768,146,89,0,825,57216,146,51,0,57413,55900,688
23-03-2021,cuddalore,106,15,3,0,118,25186,15,202,0,25403,24996,289
23-03-2021,dharmapuri,45,5,2,0,48,6507,5,214,0,6726,6623,55
23-03-2021,dindigul,113,14,20,0,107,11625,14,77,0,11716,11409,200
23-03-2021,erode,128,30,17,0,141,14988,30,94,0,15112,14821,150
23-03-2021,kallakurichi,4,1,0,0,5,10516,1,404,0,10921,10808,108
23-03-2021,kancheepuram,275,51,40,0,286,29977,51,3,0,30031,29294,451
23-03-2021,kanyakumari,105,27,9,0,123,17197,27,113,0,17337,16953,261
23-03-2021,karur,49,5,4,0,50,5536,5,46,0,5587,5486,51
23-03-2021,krishnagiri,78,10,9,0,79,8123,10,174,0,8307,8110,118
23-03-2021,madurai,151,40,12,0,179,21338,38,160,2,21538,20897,462
23-03-2021,nagapattinam,104,21,9,1,115,8716,21,89,0,8826,8573,138
23-03-2021,namakkal,68,17,2,0,83,11840,17,106,0,11963,11769,111
23-03-2021,nilgiris,89,14,9,0,94,8500,14,22,0,8536,8392,50
23-03-2021,perambalur,8,1,1,0,8,2298,1,2,0,2301,2272,21
23-03-2021,pudukottai,51,3,4,0,50,11723,3,33,0,11759,11551,158
23-03-2021,ramanathapuram,9,4,1,0,12,6372,4,133,0,6509,6360,137
23-03-2021,ranipet,46,7,12,0,41,16271,7,49,0,16327,16096,190
23-03-2021,salem,177,33,13,0,197,32665,33,420,0,33118,32453,468
23-03-2021,sivagangai,63,7,8,0,62,6819,7,68,0,6894,6705,127
23-03-2021,tenkasi,50,10,1,0,59,8582,10,54,0,8646,8427,160
23-03-2021,thanjavur,504,67,69,0,502,18838,67,22,0,18927,18162,263
23-03-2021,theni,33,6,2,0,37,17186,6,45,0,17237,16993,207
23-03-2021,thirupathur,41,11,2,0,50,7594,10,110,1,7715,7538,127
23-03-2021,thiruvallur,543,71,55,2,557,45166,71,10,0,45247,43985,705
23-03-2021,thiruvannamalai,34,2,2,0,34,19193,2,394,0,19589,19270,285
23-03-2021,thiruvarur,157,21,12,0,166,11587,21,38,0,11646,11368,112
23-03-2021,thoothukudi,52,6,4,0,54,16170,6,273,0,16449,16252,143
23-03-2021,tirunelveli,89,19,8,0,100,15480,19,420,0,15919,15604,215
23-03-2021,tiruppur,270,32,43,0,259,18888,32,11,0,18931,18448,224
23-03-2021,trichy,130,13,12,0,131,15215,13,42,0,15270,14955,184
23-03-2021,vellore,117,27,54,0,90,20791,23,456,4,21274,20831,353
23-03-2021,villupuram,52,6,2,0,56,15184,6,174,0,15364,15195,113
23-03-2021,virudhunagar,53,7,18,0,42,16665,7,104,0,16776,16502,232
23-03-2021,airport surveillance (international),6,2,0,0,8,0,0,966,2,968,959,1
23-03-2021,airport surveillance (domestic),3,0,0,0,3,0,0,1047,0,1047,1043,1
23-03-2021,railway surveillance,0,0,0,0,0,0,0,428,0,428,428,0
24-03-2021,ariyalur,21,6,2,0,25,4759,6,20,0,4785,4711,49
24-03-2021,chengalpattu,925,178,87,2,1014,54629,178,5,0,54812,52991,807
24-03-2021,chennai,3448,633,325,5,3751,242607,633,47,0,243287,235325,4211
24-03-2021,coimbatore,828,147,95,1,879,57365,147,51,0,57563,55995,689
24-03-2021,cuddalore,120,19,22,0,117,25203,19,202,0,25424,25018,289
24-03-2021,dharmapuri,48,8,2,0,54,6512,8,214,0,6734,6625,55
24-03-2021,dindigul,105,17,19,0,103,11637,17,77,0,11731,11428,200
24-03-2021,erode,141,29,24,0,146,15018,29,94,0,15141,14845,150
24-03-2021,kallakurichi,5,3,1,0,7,10517,3,404,0,10924,10809,108
24-03-2021,kancheepuram,274,56,25,2,303,30016,56,3,0,30075,29319,453
24-03-2021,kanyakumari,122,12,19,1,114,17223,12,113,0,17348,16972,262
24-03-2021,karur,50,6,3,0,53,5541,6,46,0,5593,5489,51
24-03-2021,krishnagiri,80,19,5,0,94,8134,19,174,0,8327,8115,118
24-03-2021,madurai,175,30,15,0,190,21372,30,162,0,21564,20912,462
24-03-2021,nagapattinam,117,29,15,0,131,8738,29,89,0,8856,8588,137
24-03-2021,namakkal,83,18,8,0,93,11857,18,106,0,11981,11777,111
24-03-2021,nilgiris,94,16,12,0,98,8514,16,22,0,8552,8404,50
24-03-2021,perambalur,8,1,0,0,9,2299,1,2,0,2302,2272,21
24-03-2021,pudukottai,54,6,10,0,50,11730,6,33,0,11769,11561,158
24-03-2021,ramanathapuram,16,3,1,0,18,6380,3,133,0,6516,6361,137
24-03-2021,ranipet,43,10,4,0,49,16280,10,49,0,16339,16100,190
24-03-2021,salem,198,37,21,0,214,32699,37,420,0,33156,32474,468
24-03-2021,sivagangai,58,9,6,0,61,6822,9,68,0,6899,6711,127
24-03-2021,tenkasi,58,11,5,0,64,8591,9,54,2,8656,8432,160
24-03-2021,thanjavur,502,72,124,1,449,18906,72,22,0,19000,18286,265
24-03-2021,theni,36,9,3,0,42,17191,9,45,0,17245,16996,207
24-03-2021,thirupathur,51,10,4,0,57,7605,10,111,0,7726,7542,127
24-03-2021,thiruvallur,546,86,61,0,571,45226,86,10,0,45322,44046,705
24-03-2021,thiruvannamalai,36,6,5,0,37,19197,6,394,0,19597,19275,285
24-03-2021,thiruvarur,166,24,15,0,175,11608,24,38,0,11670,11383,112
24-03-2021,thoothukudi,55,11,2,0,64,16177,11,273,0,16461,16254,143
24-03-2021,tirunelveli,101,10,3,0,108,15500,9,420,1,15930,15607,215
24-03-2021,tiruppur,259,45,34,0,270,18920,45,11,0,18976,18482,224
24-03-2021,trichy,129,16,12,0,133,15226,16,42,0,15284,14967,184
24-03-2021,vellore,88,28,9,0,107,20812,27,460,1,21300,20840,353
24-03-2021,villupuram,52,8,7,0,53,15186,8,174,0,15368,15202,113
24-03-2021,virudhunagar,42,6,18,0,30,16672,6,104,0,16782,16520,232
24-03-2021,airport surveillance (international),8,1,0,0,9,0,0,968,1,969,959,1
24-03-2021,airport surveillance (domestic),3,1,0,0,4,0,0,1047,1,1048,1043,1
24-03-2021,railway surveillance,0,0,0,0,0,0,0,428,0,428,428,0
25-03-2021,ariyalur,25,9,2,0,32,4765,9,20,0,4794,4713,49
25-03-2021,chengalpattu,1016,162,90,0,1088,54809,162,5,0,54976,53081,807
25-03-2021,chennai,3754,664,329,7,4082,243243,664,47,0,243954,235654,4218
25-03-2021,coimbatore,881,153,98,0,936,57514,153,51,0,57718,56093,689
25-03-2021,cuddalore,116,28,10,0,134,25221,28,202,0,25451,25028,289
25-03-2021,dharmapuri,53,4,1,0,56,6519,4,214,0,6737,6626,55
25-03-2021,dindigul,105,21,10,0,116,11656,21,77,0,11754,11438,200
25-03-2021,erode,144,33,20,0,157,15045,33,94,0,15172,14865,150
25-03-2021,kallakurichi,7,2,2,0,7,10520,2,404,0,10926,10811,108
25-03-2021,kancheepuram,306,63,29,1,339,30075,63,3,0,30141,29348,454
25-03-2021,kanyakumari,113,21,8,0,126,17234,19,113,2,17368,16980,262
25-03-2021,karur,55,5,7,0,53,5549,5,46,0,5600,5496,51
25-03-2021,krishnagiri,95,9,6,0,98,8154,9,174,0,8337,8121,118
25-03-2021,madurai,191,43,8,0,226,21403,43,162,0,21608,20920,462
25-03-2021,nagapattinam,131,13,9,0,135,8767,13,89,0,8869,8597,137
25-03-2021,namakkal,95,16,6,0,105,11877,16,106,0,11999,11783,111
25-03-2021,nilgiris,98,14,8,0,104,8530,14,22,0,8566,8412,50
25-03-2021,perambalur,9,0,2,0,7,2300,0,2,0,2302,2274,21
25-03-2021,pudukottai,50,8,9,0,49,11736,8,33,0,11777,11570,158
25-03-2021,ramanathapuram,17,6,0,0,23,6382,6,133,0,6521,6361,137
25-03-2021,ranipet,49,16,0,0,65,16290,16,49,0,16355,16100,190
25-03-2021,salem,216,45,18,0,243,32738,45,420,0,33203,32492,468
25-03-2021,sivagangai,60,11,6,0,65,6830,11,68,0,6909,6717,127
25-03-2021,tenkasi,63,5,3,0,65,8599,5,56,0,8660,8435,160
25-03-2021,thanjavur,448,108,90,1,465,18977,108,22,0,19107,18376,266
25-03-2021,theni,42,8,2,0,48,17200,8,45,0,17253,16998,207
25-03-2021,thirupathur,57,11,2,0,66,7615,11,111,0,7737,7544,127
25-03-2021,thiruvallur,559,89,131,1,516,45300,89,10,0,45399,44177,706
25-03-2021,thiruvannamalai,37,14,10,0,41,19203,14,394,0,19611,19285,285
25-03-2021,thiruvarur,176,52,10,0,218,11633,52,38,0,11723,11393,112
25-03-2021,thoothukudi,63,13,3,0,73,16187,13,273,0,16473,16257,143
25-03-2021,tirunelveli,109,14,14,0,109,15510,14,421,0,15945,15621,215
25-03-2021,tiruppur,269,33,37,0,265,18964,33,11,0,19008,18519,224
25-03-2021,trichy,133,34,17,0,150,15242,34,42,0,15318,14984,184
25-03-2021,vellore,108,25,12,1,120,20840,18,461,7,21326,20852,354
25-03-2021,villupuram,53,18,5,0,66,15194,18,174,0,15386,15207,113
25-03-2021,virudhunagar,30,9,10,0,29,16678,9,104,0,16791,16530,232
25-03-2021,airport surveillance (international),9,0,2,0,7,0,0,969,0,969,961,1
25-03-2021,airport surveillance (domestic),4,0,1,0,3,0,0,1048,0,1048,1044,1
25-03-2021,railway surveillance,0,0,0,0,0,0,0,428,0,428,428,0
26-03-2021,ariyalur,31,7,2,0,36,4773,7,20,0,4800,4715,49
26-03-2021,chengalpattu,1096,205,103,1,1197,54979,205,5,0,55189,53184,808
26-03-2021,chennai,4074,739,394,3,4416,243900,739,47,0,244686,236048,4222
26-03-2021,coimbatore,936,173,96,0,1013,57667,173,51,0,57891,56189,689
26-03-2021,cuddalore,135,25,8,0,152,25250,25,202,0,25477,25036,289
26-03-2021,dharmapuri,56,9,0,0,65,6523,9,214,0,6746,6626,55
26-03-2021,dindigul,113,19,17,0,115,11674,19,77,0,11770,11455,200
26-03-2021,erode,155,20,26,0,149,15076,20,94,0,15190,14891,150
26-03-2021,kallakurichi,7,6,0,0,13,10522,6,404,0,10932,10811,108
26-03-2021,kancheepuram,333,76,45,1,363,30132,76,3,0,30211,29393,455
26-03-2021,kanyakumari,126,28,14,0,140,17253,27,115,1,17396,16994,262
26-03-2021,karur,51,7,7,0,51,5552,7,46,0,5605,5503,51
26-03-2021,krishnagiri,98,18,5,1,110,8163,18,174,0,8355,8126,119
26-03-2021,madurai,226,18,24,1,219,21446,18,162,0,21626,20944,463
26-03-2021,nagapattinam,136,32,10,0,158,8781,32,89,0,8902,8607,137
26-03-2021,namakkal,107,18,13,0,112,11895,18,106,0,12019,11796,111
26-03-2021,nilgiris,104,16,10,0,110,8544,16,22,0,8582,8422,50
26-03-2021,perambalur,7,0,1,0,6,2300,0,2,0,2302,2275,21
26-03-2021,pudukottai,49,15,11,0,53,11744,15,33,0,11792,11581,158
26-03-2021,ramanathapuram,22,7,1,0,28,6387,7,133,0,6527,6362,137
26-03-2021,ranipet,70,18,0,0,88,16311,18,49,0,16378,16100,190
26-03-2021,salem,245,37,20,0,262,32785,37,420,0,33242,32512,468
26-03-2021,sivagangai,65,12,4,0,73,6841,12,68,0,6921,6721,127
26-03-2021,tenkasi,65,6,3,1,67,8604,5,56,1,8666,8438,161
26-03-2021,thanjavur,466,111,76,0,501,19086,111,22,0,19219,18452,266
26-03-2021,theni,49,4,5,0,48,17209,4,45,0,17258,17003,207
26-03-2021,thirupathur,66,10,3,0,73,7626,10,111,0,7747,7547,127
26-03-2021,thiruvallur,518,107,107,0,518,45390,107,10,0,45507,44284,705
26-03-2021,thiruvannamalai,42,13,7,0,48,19218,13,394,0,19625,19292,285
26-03-2021,thiruvarur,218,43,19,1,241,11685,43,38,0,11766,11412,113
26-03-2021,thoothukudi,74,17,13,0,78,16201,17,273,0,16491,16270,143
26-03-2021,tirunelveli,110,18,13,0,115,15525,18,421,0,15964,15634,215
26-03-2021,tiruppur,267,36,30,0,273,18999,36,11,0,19046,18549,224
26-03-2021,trichy,148,37,18,0,167,15274,35,42,2,15353,15002,184
26-03-2021,vellore,118,33,7,0,144,20856,27,468,6,21357,20859,354
26-03-2021,villupuram,65,17,13,0,69,15211,17,174,0,15402,15220,113
26-03-2021,virudhunagar,29,11,6,0,34,16687,11,104,0,16802,16536,232
26-03-2021,airport surveillance (international),7,1,0,0,8,0,0,969,1,970,961,1
26-03-2021,airport surveillance (domestic),3,2,0,0,5,0,0,1048,2,1050,1044,1
26-03-2021,railway surveillance,0,0,0,0,0,0,0,428,0,428,428,0
27-03-2021,ariyalur,37,6,3,0,40,4781,6,20,0,4807,4718,49
27-03-2021,chengalpattu,1191,186,122,1,1254,55178,186,5,0,55369,53306,809
27-03-2021,chennai,4438,775,424,4,4785,244661,775,47,0,245483,236472,4226
27-03-2021,coimbatore,1014,185,107,0,1092,57841,185,51,0,58077,56296,689
27-03-2021,cuddalore,154,43,12,0,185,25277,43,202,0,25522,25048,289
27-03-2021,dharmapuri,65,6,14,0,57,6532,6,214,0,6752,6640,55
27-03-2021,dindigul,114,20,11,0,123,11692,20,77,0,11789,11466,200
27-03-2021,erode,149,32,21,0,160,15096,32,94,0,15222,14912,150
27-03-2021,kallakurichi,12,5,0,0,17,10527,5,404,0,10936,10811,108
27-03-2021,kancheepuram,358,82,42,0,398,30203,82,3,0,30288,29435,455
27-03-2021,kanyakumari,140,22,13,0,149,17280,22,116,0,17418,17007,262
27-03-2021,karur,51,9,9,0,51,5559,9,46,0,5614,5512,51
27-03-2021,krishnagiri,111,19,16,0,114,8182,19,174,0,8375,8142,119
27-03-2021,madurai,216,38,26,1,227,21461,38,162,0,21661,20970,464
27-03-2021,nagapattinam,156,51,22,0,185,8811,51,89,0,8951,8629,137
27-03-2021,namakkal,112,20,11,0,121,11913,20,106,0,12039,11807,111
27-03-2021,nilgiris,109,19,13,0,115,8559,19,22,0,8600,8435,50
27-03-2021,perambalur,6,1,0,0,7,2300,1,2,0,2303,2275,21
27-03-2021,pudukottai,53,16,10,2,57,11759,16,33,0,11808,11591,160
27-03-2021,ramanathapuram,27,6,2,0,31,6393,6,133,0,6532,6364,137
27-03-2021,ranipet,87,24,10,0,101,16328,24,49,0,16401,16110,190
27-03-2021,salem,263,55,41,0,277,32823,55,420,0,33298,32553,468
27-03-2021,sivagangai,71,21,8,0,84,6851,21,68,0,6940,6729,127
27-03-2021,tenkasi,67,8,1,0,74,8609,7,57,1,8674,8439,161
27-03-2021,thanjavur,497,66,67,0,496,19193,66,22,0,19281,18519,266
27-03-2021,theni,48,5,5,0,48,17213,5,45,0,17263,17008,207
27-03-2021,thirupathur,72,15,5,0,82,7635,13,111,2,7761,7552,127
27-03-2021,thiruvallur,510,110,94,1,525,45489,110,10,0,45609,44378,706
27-03-2021,thiruvannamalai,50,9,4,0,55,19233,9,394,0,19636,19296,285
27-03-2021,thiruvarur,242,38,18,0,262,11729,38,38,0,11805,11430,113
27-03-2021,thoothukudi,77,9,9,0,77,16217,9,273,0,16499,16279,143
27-03-2021,tirunelveli,116,26,14,0,128,15544,26,421,0,15991,15648,215
27-03-2021,tiruppur,273,59,38,0,294,19035,59,11,0,19105,18587,224
27-03-2021,trichy,171,45,26,0,190,15313,45,44,0,15402,15028,184
27-03-2021,vellore,144,19,11,0,152,20883,18,474,1,21376,20870,354
27-03-2021,villupuram,70,21,8,0,83,15229,21,174,0,15424,15228,113
27-03-2021,virudhunagar,34,17,4,0,47,16698,17,104,0,16819,16540,232
27-03-2021,airport surveillance (international),8,1,0,0,9,0,0,970,1,971,961,1
27-03-2021,airport surveillance (domestic),5,0,0,0,5,0,0,1050,0,1050,1044,1
27-03-2021,railway surveillance,0,0,0,0,0,0,0,428,0,428,428,0
28-03-2021,ariyalur,35,7,3,0,39,4782,7,20,0,4809,4721,49
28-03-2021,chengalpattu,1276,188,129,0,1335,55386,188,5,0,55579,53435,809
28-03-2021,chennai,4808,833,439,4,5198,245459,833,47,0,246339,236911,4230
28-03-2021,coimbatore,1093,180,101,0,1172,58027,180,51,0,58258,56397,689
28-03-2021,cuddalore,184,40,15,0,209,25319,40,202,0,25561,25063,289
28-03-2021,dharmapuri,56,9,10,0,55,6537,9,214,0,6760,6650,55
28-03-2021,dindigul,122,21,14,0,129,11711,21,77,0,11809,11480,200
28-03-2021,erode,159,31,18,0,172,15127,31,94,0,15252,14930,150
28-03-2021,kallakurichi,17,2,2,0,17,10532,2,404,0,10938,10813,108
28-03-2021,kancheepuram,384,84,48,0,420,30271,84,3,0,30358,29483,455
28-03-2021,kanyakumari,149,16,15,1,149,17302,16,116,0,17434,17022,263
28-03-2021,karur,51,7,11,0,47,5568,7,46,0,5621,5523,51
28-03-2021,krishnagiri,113,22,19,0,116,8200,22,174,0,8396,8161,119
28-03-2021,madurai,225,32,23,0,234,21497,32,162,0,21691,20993,464
28-03-2021,nagapattinam,186,53,20,0,219,8863,53,89,0,9005,8649,137
28-03-2021,namakkal,112,24,8,0,128,11924,24,106,0,12054,11815,111
28-03-2021,nilgiris,115,21,10,0,126,8578,21,22,0,8621,8445,50
28-03-2021,perambalur,6,1,0,0,7,2300,1,2,0,2303,2275,21
28-03-2021,pudukottai,58,11,8,0,61,11776,11,33,0,11820,11599,160
28-03-2021,ramanathapuram,30,8,3,0,35,6398,8,133,0,6539,6367,137
28-03-2021,ranipet,99,20,9,0,110,16350,20,49,0,16419,16119,190
28-03-2021,salem,280,47,43,0,284,32881,47,420,0,33348,32596,468
28-03-2021,sivagangai,81,13,7,0,87,6869,13,68,0,6950,6736,127
28-03-2021,tenkasi,73,10,4,0,79,8615,10,58,0,8683,8443,161
28-03-2021,thanjavur,495,108,61,1,541,19258,108,22,0,19388,18580,267
28-03-2021,theni,48,8,3,0,53,17218,8,45,0,17271,17011,207
28-03-2021,thirupathur,82,17,4,1,94,7648,15,113,2,7778,7556,128
28-03-2021,thiruvallur,517,117,96,2,536,45591,117,10,0,45718,44474,708
28-03-2021,thiruvannamalai,55,11,3,0,63,19242,11,394,0,19647,19299,285
28-03-2021,thiruvarur,261,51,27,1,284,11766,51,38,0,11855,11457,114
28-03-2021,thoothukudi,76,15,7,0,84,16225,15,273,0,16513,16286,143
28-03-2021,tirunelveli,129,21,12,0,138,15571,21,421,0,16013,15660,215
28-03-2021,tiruppur,295,61,42,1,313,19095,61,11,0,19167,18629,225
28-03-2021,trichy,190,49,28,0,211,15358,48,44,1,15451,15056,184
28-03-2021,vellore,152,23,13,0,162,20901,14,475,9,21399,20883,354
28-03-2021,villupuram,83,20,10,0,93,15250,20,174,0,15444,15238,113
28-03-2021,virudhunagar,48,12,5,0,55,16716,12,104,0,16832,16545,232
28-03-2021,airport surveillance (international),9,0,0,0,9,0,0,971,0,971,961,1
28-03-2021,airport surveillance (domestic),5,1,0,0,6,0,0,1050,1,1051,1044,1
28-03-2021,railway surveillance,0,0,0,0,0,0,0,428,0,428,428,0
29-03-2021,ariyalur,40,2,1,0,41,4790,2,20,0,4812,4722,49
29-03-2021,chengalpattu,1350,202,133,4,1415,55589,202,5,0,55796,53568,813
29-03-2021,chennai,5192,815,464,2,5541,246286,815,47,0,247148,237375,4232
29-03-2021,coimbatore,1174,211,93,2,1290,58209,211,51,0,58471,56490,691
29-03-2021,cuddalore,209,57,30,1,235,25359,57,202,0,25618,25093,290
29-03-2021,dharmapuri,55,7,6,0,56,6546,7,214,0,6767,6656,55
29-03-2021,dindigul,129,24,10,0,143,11732,24,77,0,11833,11490,200
29-03-2021,erode,172,39,25,0,186,15158,39,94,0,15291,14955,150
29-03-2021,kallakurichi,17,5,3,0,19,10534,5,404,0,10943,10816,108
29-03-2021,kancheepuram,402,80,53,0,429,30337,80,3,0,30420,29536,455
29-03-2021,kanyakumari,149,19,14,0,154,17318,19,116,0,17453,17036,263
29-03-2021,karur,47,8,7,1,47,5575,8,46,0,5629,5530,52
29-03-2021,krishnagiri,116,25,15,0,126,8222,25,174,0,8421,8176,119
29-03-2021,madurai,233,39,19,1,252,21528,39,162,0,21729,21012,465
29-03-2021,nagapattinam,219,56,12,1,262,8916,56,89,0,9061,8661,138
29-03-2021,namakkal,128,21,11,0,138,11948,21,106,0,12075,11826,111
29-03-2021,nilgiris,126,14,11,0,129,8599,14,22,0,8635,8456,50
29-03-2021,perambalur,7,2,4,0,5,2301,2,2,0,2305,2279,21
29-03-2021,pudukottai,61,18,8,0,71,11787,18,33,0,11838,11607,160
29-03-2021,ramanathapuram,35,4,5,0,34,6406,3,133,1,6543,6372,137
29-03-2021,ranipet,112,23,12,0,123,16372,23,49,0,16444,16131,190
29-03-2021,salem,284,49,40,0,293,32928,49,420,0,33397,32636,468
29-03-2021,sivagangai,87,12,8,0,91,6882,12,68,0,6962,6744,127
29-03-2021,tenkasi,80,6,5,0,81,8626,6,58,0,8690,8448,161
29-03-2021,thanjavur,541,130,104,0,567,19366,130,22,0,19518,18684,267
29-03-2021,theni,53,9,7,0,55,17226,9,45,0,17280,17018,207
29-03-2021,thirupathur,94,11,10,0,95,7663,11,115,0,7789,7566,128
29-03-2021,thiruvallur,532,129,85,1,575,45704,129,10,0,45843,44559,709
29-03-2021,thiruvannamalai,64,13,8,0,69,19254,13,394,0,19661,19307,285
29-03-2021,thiruvarur,285,58,26,0,317,11818,58,38,0,11914,11483,114
29-03-2021,thoothukudi,87,14,5,0,96,16243,14,273,0,16530,16291,143
29-03-2021,tirunelveli,141,8,19,0,130,15595,8,421,0,16024,15679,215
29-03-2021,tiruppur,310,52,27,1,334,19153,52,11,0,19216,18656,226
29-03-2021,trichy,213,58,14,0,257,15408,58,45,0,15511,15070,184
29-03-2021,vellore,162,20,13,0,169,20915,14,484,6,21419,20896,354
29-03-2021,villupuram,93,27,16,0,104,15270,27,174,0,15471,15254,113
29-03-2021,virudhunagar,56,11,24,0,43,16729,11,104,0,16844,16569,232
29-03-2021,airport surveillance (international),9,1,3,0,7,0,0,971,1,972,964,1
29-03-2021,airport surveillance (domestic),6,0,2,0,4,0,0,1051,0,1051,1046,1
29-03-2021,railway surveillance,0,0,0,0,0,0,0,428,0,428,428,0
30-03-2021,ariyalur,39,2,2,0,39,4790,2,20,0,4812,4724,49
30-03-2021,chengalpattu,1450,242,124,2,1566,55826,242,5,0,56073,53692,815
30-03-2021,chennai,5550,874,525,4,5895,247110,874,47,0,248031,237900,4236
30-03-2021,coimbatore,1291,207,109,2,1387,58421,207,51,0,58679,56599,693
30-03-2021,cuddalore,237,35,19,0,253,25418,35,202,0,25655,25112,290
30-03-2021,dharmapuri,56,6,6,0,56,6553,6,214,0,6773,6662,55
30-03-2021,dindigul,144,22,17,1,148,11757,22,77,0,11856,11507,201
30-03-2021,erode,184,27,31,0,180,15195,27,94,0,15316,14986,150
30-03-2021,kallakurichi,19,3,1,0,21,10539,3,404,0,10946,10817,108
30-03-2021,kancheepuram,392,100,60,2,430,30380,100,3,0,30483,29596,457
30-03-2021,kanyakumari,154,54,18,0,190,17337,54,116,0,17507,17054,263
30-03-2021,karur,47,10,5,0,52,5583,10,46,0,5639,5535,52
30-03-2021,krishnagiri,126,20,17,0,129,8247,20,174,0,8441,8193,119
30-03-2021,madurai,253,48,15,0,286,21568,48,162,0,21778,21027,465
30-03-2021,nagapattinam,262,61,16,1,306,8972,61,89,0,9122,8677,139
30-03-2021,namakkal,137,19,14,0,142,11968,19,106,0,12093,11840,111
30-03-2021,nilgiris,129,13,12,0,130,8613,13,22,0,8648,8468,50
30-03-2021,perambalur,4,1,1,0,4,2302,1,2,0,2305,2280,21
30-03-2021,pudukottai,71,14,5,0,80,11805,14,33,0,11852,11612,160
30-03-2021,ramanathapuram,34,7,3,0,38,6409,7,134,0,6550,6375,137
30-03-2021,ranipet,121,11,10,0,122,16393,11,49,0,16453,16141,190
30-03-2021,salem,294,38,34,0,298,32978,38,420,0,33436,32670,468
30-03-2021,sivagangai,90,22,11,0,101,6893,22,68,0,6983,6755,127
30-03-2021,tenkasi,81,9,11,0,79,8632,9,58,0,8699,8459,161
30-03-2021,thanjavur,571,114,108,3,574,19500,114,22,0,19636,18792,270
30-03-2021,theni,55,11,13,0,53,17235,11,45,0,17291,17031,207
30-03-2021,thirupathur,95,10,16,0,89,7674,10,115,0,7799,7582,128
30-03-2021,thiruvallur,572,80,78,1,573,45830,80,10,0,45920,44637,710
30-03-2021,thiruvannamalai,70,12,10,0,72,19268,12,394,0,19674,19317,285
30-03-2021,thiruvarur,317,52,36,0,333,11876,52,38,0,11966,11519,114
30-03-2021,thoothukudi,94,10,7,0,97,16255,10,273,0,16538,16298,143
30-03-2021,tirunelveli,133,31,16,0,148,15606,31,421,0,16058,15695,215
30-03-2021,tiruppur,336,51,36,0,351,19207,51,11,0,19269,18692,226
30-03-2021,trichy,249,55,18,0,286,15458,55,45,0,15558,15088,184
30-03-2021,vellore,168,37,22,0,183,20928,29,490,8,21455,20918,354
30-03-2021,villupuram,104,14,17,0,101,15297,14,174,0,15485,15271,113
30-03-2021,virudhunagar,43,18,18,0,43,16740,18,104,0,16862,16587,232
30-03-2021,airport surveillance (international),7,2,2,0,7,0,0,972,2,974,966,1
30-03-2021,airport surveillance (domestic),4,0,0,0,4,0,0,1051,0,1051,1046,1
30-03-2021,railway surveillance,0,0,0,0,0,0,0,428,0,428,428,0
31-03-2021,ariyalur,39,2,5,0,36,4792,2,20,0,4814,4729,49
31-03-2021,chengalpattu,1573,250,130,3,1690,56075,250,5,0,56330,53822,818
31-03-2021,chennai,5860,969,567,7,6255,247949,969,47,0,248965,238467,4243
31-03-2021,coimbatore,1395,273,116,1,1551,58636,273,51,0,58960,56715,694
31-03-2021,cuddalore,258,46,20,1,283,25458,46,202,0,25706,25132,291
31-03-2021,dharmapuri,56,8,8,0,56,6559,8,214,0,6781,6670,55
31-03-2021,dindigul,147,25,19,1,152,11778,25,77,0,11880,11526,202
31-03-2021,erode,182,34,25,0,191,15224,34,94,0,15352,15011,150
31-03-2021,kallakurichi,21,5,1,0,25,10542,5,404,0,10951,10818,108
31-03-2021,kancheepuram,433,98,56,0,475,30483,98,3,0,30584,29652,457
31-03-2021,kanyakumari,190,30,22,0,198,17391,30,116,0,17537,17076,263
31-03-2021,karur,54,9,6,0,57,5595,9,46,0,5650,5541,52
31-03-2021,krishnagiri,129,27,11,0,145,8267,27,174,0,8468,8204,119
31-03-2021,madurai,278,44,21,0,301,21608,44,162,0,21814,21048,465
31-03-2021,nagapattinam,307,41,19,2,327,9034,41,89,0,9164,8696,141
31-03-2021,namakkal,140,20,13,0,147,11985,20,106,0,12111,11853,111
31-03-2021,nilgiris,129,19,16,0,132,8625,19,22,0,8666,8484,50
31-03-2021,perambalur,3,3,0,0,6,2302,3,2,0,2307,2280,21
31-03-2021,pudukottai,83,19,7,0,95,11822,19,33,0,11874,11619,160
31-03-2021,ramanathapuram,38,4,4,0,38,6416,4,134,0,6554,6379,137
31-03-2021,ranipet,123,21,8,0,136,16405,21,49,0,16475,16149,190
31-03-2021,salem,300,50,46,0,304,33018,50,420,0,33488,32716,468
31-03-2021,sivagangai,100,16,9,0,107,6914,16,68,0,6998,6764,127
31-03-2021,tenkasi,81,16,8,0,89,8643,16,58,0,8717,8467,161
31-03-2021,thanjavur,573,106,97,1,581,19613,106,22,0,19741,18889,271
31-03-2021,theni,52,9,8,0,53,17245,9,45,0,17299,17039,207
31-03-2021,thirupathur,89,7,12,0,84,7684,7,115,0,7806,7594,128
31-03-2021,thiruvallur,583,130,105,1,607,45920,130,10,0,46060,44742,711
31-03-2021,thiruvannamalai,73,17,12,0,78,19281,17,394,0,19692,19329,285
31-03-2021,thiruvarur,334,47,31,1,349,11929,47,38,0,12014,11550,115
31-03-2021,thoothukudi,97,16,6,0,107,16265,16,273,0,16554,16304,143
31-03-2021,tirunelveli,149,33,21,0,161,15638,33,421,0,16092,15716,215
31-03-2021,tiruppur,351,55,41,0,365,19258,55,11,0,19324,18733,226
31-03-2021,trichy,287,56,11,1,331,15514,56,45,0,15615,15099,185
31-03-2021,vellore,183,35,21,0,197,20957,29,498,6,21490,20939,354
31-03-2021,villupuram,101,22,17,0,106,15311,22,174,0,15507,15288,113
31-03-2021,virudhunagar,44,12,8,0,48,16759,12,104,0,16875,16595,232
31-03-2021,airport surveillance (international),7,0,0,0,7,0,0,974,0,974,966,1
31-03-2021,airport surveillance (domestic),4,5,0,0,9,0,0,1051,5,1056,1046,1
31-03-2021,railway surveillance,0,0,0,0,0,0,0,428,0,428,428,0
01-04-2021,ariyalur,36,6,6,0,36,4794,6,20,0,4820,4735,49
01-04-2021,chengalpattu,1704,258,143,2,1817,56339,258,5,0,56602,53965,820
01-04-2021,chennai,6207,1083,589,6,6695,248870,1083,47,0,250000,239056,4249
01-04-2021,coimbatore,1558,280,121,0,1717,58916,280,51,0,59247,56836,694
01-04-2021,cuddalore,284,39,30,1,292,25505,39,202,0,25746,25162,292
01-04-2021,dharmapuri,56,2,7,0,51,6567,2,214,0,6783,6677,55
01-04-2021,dindigul,152,26,14,0,164,11803,26,77,0,11906,11540,202
01-04-2021,erode,187,36,26,0,197,15254,36,94,0,15384,15037,150
01-04-2021,kallakurichi,25,10,11,0,24,10547,10,404,0,10961,10829,108
01-04-2021,kancheepuram,480,115,91,3,501,30586,115,3,0,30704,29743,460
01-04-2021,kanyakumari,198,31,13,0,216,17421,31,116,0,17568,17089,263
01-04-2021,karur,55,10,5,0,60,5602,10,46,0,5658,5546,52
01-04-2021,krishnagiri,148,28,13,0,163,8297,28,174,0,8499,8217,119
01-04-2021,madurai,298,48,27,1,318,21649,48,162,0,21859,21075,466
01-04-2021,nagapattinam,328,48,28,1,347,9076,48,89,0,9213,8724,142
01-04-2021,namakkal,146,21,13,0,154,12004,21,106,0,12131,11866,111
01-04-2021,nilgiris,132,20,14,0,138,8644,20,22,0,8686,8498,50
01-04-2021,perambalur,6,1,0,0,7,2305,1,2,0,2308,2280,21
01-04-2021,pudukottai,95,17,8,0,104,11841,17,33,0,11891,11627,160
01-04-2021,ramanathapuram,39,7,3,1,42,6421,7,134,0,6562,6382,138
01-04-2021,ranipet,136,15,7,0,144,16426,15,49,0,16490,16156,190
01-04-2021,salem,304,51,49,0,306,33068,51,420,0,33539,32765,468
01-04-2021,sivagangai,108,17,6,0,119,6931,17,68,0,7016,6770,127
01-04-2021,tenkasi,89,14,9,0,94,8659,14,58,0,8731,8476,161
01-04-2021,thanjavur,583,113,126,1,569,19721,113,22,0,19856,19015,272
01-04-2021,theni,53,13,10,0,56,17254,13,45,0,17312,17049,207
01-04-2021,thirupathur,84,15,13,0,86,7691,15,115,0,7821,7607,128
01-04-2021,thiruvallur,612,158,105,2,663,46055,158,10,0,46223,44847,713
01-04-2021,thiruvannamalai,82,10,13,0,79,19302,10,394,0,19706,19342,285
01-04-2021,thiruvarur,348,51,15,0,384,11975,51,38,0,12064,11565,115
01-04-2021,thoothukudi,107,17,6,0,118,16281,17,273,0,16571,16310,143
01-04-2021,tirunelveli,165,60,3,1,221,15675,60,421,0,16156,15719,216
01-04-2021,tiruppur,365,60,29,0,396,19313,60,11,0,19384,18762,226
01-04-2021,trichy,334,66,16,0,384,15573,66,45,0,15684,15115,185
01-04-2021,vellore,202,37,32,0,207,20991,34,504,3,21532,20971,354
01-04-2021,villupuram,109,23,21,0,111,15336,23,174,0,15533,15309,113
01-04-2021,virudhunagar,48,10,12,0,46,16771,10,104,0,16885,16607,232
01-04-2021,airport surveillance (international),7,0,0,0,7,0,0,974,0,974,966,1
01-04-2021,airport surveillance (domestic),9,1,0,0,10,0,0,1056,1,1057,1046,1
01-04-2021,railway surveillance,0,0,0,0,0,0,0,428,0,428,428,0
02-04-2021,ariyalur,34,11,7,0,38,4798,11,20,0,4829,4742,49
02-04-2021,chengalpattu,1826,280,158,0,1948,56606,280,5,0,56891,54123,820
02-04-2021,chennai,6648,1188,668,7,7161,249906,1188,47,0,251141,239724,4256
02-04-2021,coimbatore,1722,277,136,0,1863,59201,277,51,0,59529,56972,694
02-04-2021,cuddalore,295,56,32,0,319,25547,56,202,0,25805,25194,292
02-04-2021,dharmapuri,51,6,5,0,52,6569,6,214,0,6789,6682,55
02-04-2021,dindigul,163,50,18,0,195,11828,50,77,0,11955,11558,202
02-04-2021,erode,192,46,25,0,213,15285,46,94,0,15425,15062,150
02-04-2021,kallakurichi,25,11,7,0,29,10558,11,404,0,10973,10836,108
02-04-2021,kancheepuram,496,119,101,1,513,30696,119,3,0,30818,29844,461
02-04-2021,kanyakumari,217,40,23,1,233,17453,40,116,0,17609,17112,264
02-04-2021,karur,60,12,7,0,65,5612,12,46,0,5670,5553,52
02-04-2021,krishnagiri,162,48,16,0,194,8324,48,174,0,8546,8233,119
02-04-2021,madurai,318,105,33,0,390,21697,105,162,0,21964,21108,466
02-04-2021,nagapattinam,349,56,17,0,388,9126,56,89,0,9271,8741,142
02-04-2021,namakkal,152,20,14,0,158,12023,20,106,0,12149,11880,111
02-04-2021,nilgiris,138,22,16,0,144,8664,22,22,0,8708,8514,50
02-04-2021,perambalur,7,1,1,0,7,2306,1,2,0,2309,2281,21
02-04-2021,pudukottai,105,18,7,0,116,11859,18,33,0,11910,11634,160
02-04-2021,ramanathapuram,42,13,5,0,50,6428,13,134,0,6575,6387,138
02-04-2021,ranipet,145,26,9,0,162,16442,26,49,0,16517,16165,190
02-04-2021,salem,308,49,54,0,303,33121,49,420,0,33590,32819,468
02-04-2021,sivagangai,122,26,10,0,138,6951,25,68,1,7045,6780,127
02-04-2021,tenkasi,93,19,7,1,104,8672,19,58,0,8749,8483,162
02-04-2021,thanjavur,569,120,50,0,639,19834,120,22,0,19976,19065,272
02-04-2021,theni,56,10,6,0,60,17267,10,45,0,17322,17055,207
02-04-2021,thirupathur,87,24,9,0,102,7707,24,115,0,7846,7616,128
02-04-2021,thiruvallur,673,183,108,0,748,46223,183,10,0,46416,44955,713
02-04-2021,thiruvannamalai,86,13,15,1,83,19319,13,394,0,19726,19357,286
02-04-2021,thiruvarur,387,69,32,0,424,12029,69,38,0,12136,11597,115
02-04-2021,thoothukudi,118,21,4,0,135,16298,21,273,0,16592,16314,143
02-04-2021,tirunelveli,223,78,6,0,295,15737,78,421,0,16236,15725,216
02-04-2021,tiruppur,402,75,39,0,438,19379,75,11,0,19465,18801,226
02-04-2021,trichy,389,122,30,1,480,15644,122,45,0,15811,15145,186
02-04-2021,vellore,206,38,25,0,219,21024,32,507,6,21569,20996,354
02-04-2021,villupuram,114,25,5,0,134,15362,25,174,0,15561,15314,113
02-04-2021,virudhunagar,46,12,10,0,48,16781,12,104,0,16897,16617,232
02-04-2021,airport surveillance (international),7,1,0,0,8,0,0,974,1,975,966,1
02-04-2021,airport surveillance (domestic),10,0,0,0,10,0,0,1057,0,1057,1046,1
02-04-2021,railway surveillance,0,0,0,0,0,0,0,428,0,428,428,0
03-04-2021,ariyalur,38,9,6,0,41,4809,9,20,0,4838,4748,49
03-04-2021,chengalpattu,1948,285,167,2,2064,56886,285,5,0,57176,54290,822
03-04-2021,chennai,7161,1290,730,8,7713,251094,1290,47,0,252431,240454,4264
03-04-2021,coimbatore,1863,292,148,0,2007,59478,292,51,0,59821,57120,694
03-04-2021,cuddalore,319,75,43,0,351,25603,75,202,0,25880,25237,292
03-04-2021,dharmapuri,52,17,4,0,65,6575,17,214,0,6806,6686,55
03-04-2021,dindigul,195,18,26,0,187,11878,18,77,0,11973,11584,202
03-04-2021,erode,213,49,26,0,236,15331,49,94,0,15474,15088,150
03-04-2021,kallakurichi,29,9,2,0,36,10569,9,404,0,10982,10838,108
03-04-2021,kancheepuram,513,141,94,1,559,30815,141,3,0,30959,29938,462
03-04-2021,kanyakumari,233,35,27,0,241,17493,34,116,1,17644,17139,264
03-04-2021,karur,65,18,9,0,74,5624,18,46,0,5688,5562,52
03-04-2021,krishnagiri,194,47,12,0,229,8372,47,174,0,8593,8245,119
03-04-2021,madurai,390,66,26,1,429,21802,66,162,0,22030,21134,467
03-04-2021,nagapattinam,387,63,28,0,422,9182,63,89,0,9334,8769,143
03-04-2021,namakkal,158,27,16,0,169,12043,27,106,0,12176,11896,111
03-04-2021,nilgiris,144,19,14,0,149,8686,19,22,0,8727,8528,50
03-04-2021,perambalur,7,2,0,0,9,2307,2,2,0,2311,2281,21
03-04-2021,pudukottai,116,15,13,0,118,11877,15,33,0,11925,11647,160
03-04-2021,ramanathapuram,50,9,6,0,53,6441,9,134,0,6584,6393,138
03-04-2021,ranipet,162,24,7,0,179,16468,24,49,0,16541,16172,190
03-04-2021,salem,303,62,24,0,341,33170,62,420,0,33652,32843,468
03-04-2021,sivagangai,138,18,12,0,144,6976,18,69,0,7063,6792,127
03-04-2021,tenkasi,105,17,4,0,118,8691,17,58,0,8766,8487,161
03-04-2021,thanjavur,639,138,63,1,713,19954,138,22,0,20114,19128,273
03-04-2021,theni,60,12,3,0,69,17277,12,45,0,17334,17058,207
03-04-2021,thirupathur,102,23,11,0,114,7731,23,115,0,7869,7627,128
03-04-2021,thiruvallur,748,201,103,1,845,46406,201,10,0,46617,45058,714
03-04-2021,thiruvannamalai,83,37,12,0,108,19332,37,394,0,19763,19369,286
03-04-2021,thiruvarur,424,73,52,0,445,12098,73,38,0,12209,11649,115
03-04-2021,thoothukudi,135,22,8,0,149,16319,22,273,0,16614,16322,143
03-04-2021,tirunelveli,295,38,8,0,325,15815,38,421,0,16274,15733,216
03-04-2021,tiruppur,438,79,50,0,467,19454,79,11,0,19544,18851,226
03-04-2021,trichy,480,142,40,0,582,15766,140,45,2,15953,15185,186
03-04-2021,vellore,219,32,27,0,224,21056,19,513,13,21601,21023,354
03-04-2021,villupuram,134,26,8,0,152,15387,26,174,0,15587,15322,113
03-04-2021,virudhunagar,48,15,5,0,58,16793,15,104,0,16912,16622,232
03-04-2021,airport surveillance (international),8,0,0,0,8,0,0,975,0,975,966,1
03-04-2021,airport surveillance (domestic),10,1,0,0,11,0,0,1057,1,1058,1046,1
03-04-2021,railway surveillance,0,0,0,0,0,0,0,428,0,428,428,0
04-04-2021,ariyalur,41,7,5,0,43,4818,7,20,0,4845,4753,49
04-04-2021,chengalpattu,2100,297,209,5,2183,57207,297,5,0,57509,54499,827
04-04-2021,chennai,7698,1344,792,4,8246,252369,1344,47,0,253760,241246,4268
04-04-2021,coimbatore,2024,315,146,0,2193,59787,315,51,0,60153,57266,694
04-04-2021,cuddalore,351,79,31,0,399,25678,79,202,0,25959,25268,292
04-04-2021,dharmapuri,65,12,3,0,74,6592,12,214,0,6818,6689,55
04-04-2021,dindigul,189,41,29,0,201,11898,41,77,0,12016,11613,202
04-04-2021,erode,222,41,14,0,249,15366,41,94,0,15501,15102,150
04-04-2021,kallakurichi,38,7,1,0,44,10580,7,404,0,10991,10839,108
04-04-2021,kancheepuram,534,124,55,2,601,30931,124,3,0,31058,29993,464
04-04-2021,kanyakumari,242,32,27,1,246,17528,32,117,0,17677,17166,265
04-04-2021,karur,72,21,6,0,87,5640,21,46,0,5707,5568,52
04-04-2021,krishnagiri,230,43,23,0,250,8420,43,174,0,8637,8268,119
04-04-2021,madurai,427,58,7,0,478,21866,58,162,0,22086,21141,467
04-04-2021,nagapattinam,425,77,37,0,465,9248,77,89,0,9414,8806,143
04-04-2021,namakkal,171,33,17,0,187,12072,33,106,0,12211,11913,111
04-04-2021,nilgiris,141,23,16,0,148,8697,23,22,0,8742,8544,50
04-04-2021,perambalur,11,8,0,0,19,2311,8,2,0,2321,2281,21
04-04-2021,pudukottai,123,29,14,0,138,11897,29,33,0,11959,11661,160
04-04-2021,ramanathapuram,52,11,2,0,61,6449,11,134,0,6594,6395,138
04-04-2021,ranipet,175,26,2,0,199,16488,26,49,0,16563,16174,190
04-04-2021,salem,347,64,41,0,370,33238,59,420,5,33722,32884,468
04-04-2021,sivagangai,139,28,17,0,150,6989,28,69,0,7086,6809,127
04-04-2021,tenkasi,118,36,7,0,147,8708,36,58,0,8802,8494,161
04-04-2021,thanjavur,707,136,42,0,801,20086,136,22,0,20244,19170,273
04-04-2021,theni,72,16,5,0,83,17292,16,45,0,17353,17063,207
04-04-2021,thirupathur,116,8,13,0,111,7756,8,115,0,7879,7640,128
04-04-2021,thiruvallur,833,163,61,1,934,46595,163,10,0,46768,45119,715
04-04-2021,thiruvannamalai,117,29,10,0,136,19378,29,394,0,19801,19379,286
04-04-2021,thiruvarur,449,76,49,0,476,12175,76,38,0,12289,11698,115
04-04-2021,thoothukudi,148,15,18,0,145,16340,15,273,0,16628,16340,143
04-04-2021,tirunelveli,326,36,2,0,360,15854,36,421,0,16311,15735,216
04-04-2021,tiruppur,471,105,42,1,533,19537,105,11,0,19653,18893,227
04-04-2021,trichy,573,150,42,0,681,15897,150,47,0,16094,15227,186
04-04-2021,vellore,224,43,18,0,249,21075,30,526,13,21644,21041,354
04-04-2021,villupuram,154,20,2,0,172,15415,20,174,0,15609,15324,113
04-04-2021,virudhunagar,60,27,8,0,79,16810,27,104,0,16941,16630,232
04-04-2021,airport surveillance (international),8,1,0,0,9,0,0,975,1,976,966,1
04-04-2021,airport surveillance (domestic),11,0,0,0,11,0,0,1058,0,1058,1046,1
04-04-2021,railway surveillance,0,0,0,0,0,0,0,428,0,428,428,0
05-04-2021,ariyalur,44,7,3,0,48,4826,7,20,0,4853,4756,49
05-04-2021,chengalpattu,2223,310,210,1,2322,57544,310,5,0,57859,54709,828
05-04-2021,chennai,8225,1335,562,7,8991,253692,1335,47,0,255074,241808,4275
05-04-2021,coimbatore,2198,376,138,0,2436,60107,376,51,0,60534,57404,694
05-04-2021,cuddalore,398,72,50,0,420,25756,72,202,0,26030,25318,292
05-04-2021,dharmapuri,74,22,5,0,91,6604,22,214,0,6840,6694,55
05-04-2021,dindigul,199,59,22,0,236,11937,59,77,0,12073,11635,202
05-04-2021,erode,245,40,47,0,238,15403,40,94,0,15537,15149,150
05-04-2021,kallakurichi,44,24,1,0,67,10587,24,404,0,11015,10840,108
05-04-2021,kancheepuram,563,128,97,0,594,31017,128,3,0,31148,30090,464
05-04-2021,kanyakumari,246,41,18,0,269,17560,41,117,0,17718,17184,265
05-04-2021,karur,86,12,9,0,89,5660,12,46,0,5718,5577,52
05-04-2021,krishnagiri,250,49,22,0,277,8463,48,174,1,8686,8290,119
05-04-2021,madurai,477,88,20,1,544,21923,87,162,1,22173,21161,468
05-04-2021,nagapattinam,466,66,26,1,505,9326,66,89,0,9481,8832,144
05-04-2021,namakkal,187,40,20,0,207,12105,40,106,0,12251,11933,111
05-04-2021,nilgiris,149,23,19,0,153,8721,21,22,2,8766,8563,50
05-04-2021,perambalur,19,2,4,0,17,2319,2,2,0,2323,2285,21
05-04-2021,pudukottai,138,23,11,0,150,11926,23,33,0,11982,11672,160
05-04-2021,ramanathapuram,61,19,4,0,76,6460,19,134,0,6613,6399,138
05-04-2021,ranipet,200,36,0,0,236,16515,36,49,0,16600,16174,190
05-04-2021,salem,372,70,50,0,392,33299,70,425,0,33794,32934,468
05-04-2021,sivagangai,150,11,13,0,148,7017,11,69,0,7097,6822,127
05-04-2021,tenkasi,148,21,5,0,164,8745,21,58,0,8824,8499,161
05-04-2021,thanjavur,801,129,110,0,820,20222,129,22,0,20373,19280,273
05-04-2021,theni,83,19,12,0,90,17308,19,45,0,17372,17075,207
05-04-2021,thirupathur,111,11,16,0,106,7764,11,115,0,7890,7656,128
05-04-2021,thiruvallur,938,156,102,0,992,46762,156,10,0,46928,45221,715
05-04-2021,thiruvannamalai,139,35,12,0,162,19410,35,394,0,19839,19391,286
05-04-2021,thiruvarur,477,62,52,0,487,12252,62,38,0,12352,11750,115
05-04-2021,thoothukudi,147,32,12,0,167,16357,32,273,0,16662,16352,143
05-04-2021,tirunelveli,361,32,8,0,385,15891,32,421,0,16344,15743,216
05-04-2021,tiruppur,533,104,46,0,591,19642,104,11,0,19757,18939,227
05-04-2021,trichy,684,128,52,0,760,16050,128,47,0,16225,15279,186
05-04-2021,vellore,249,34,25,1,257,21105,32,539,2,21678,21066,355
05-04-2021,villupuram,173,45,18,0,200,15436,45,174,0,15655,15342,113
05-04-2021,virudhunagar,80,8,21,0,67,16838,8,104,0,16950,16651,232
05-04-2021,airport surveillance (international),9,3,0,0,12,0,0,976,3,979,966,1
05-04-2021,airport surveillance (domestic),11,0,0,0,11,0,0,1058,0,1058,1046,1
05-04-2021,railway surveillance,0,0,0,0,0,0,0,428,0,428,428,0
06-04-2021,ariyalur,47,3,9,0,41,4832,3,20,0,4855,4765,49
06-04-2021,chengalpattu,2385,304,203,5,2481,57917,304,5,0,58226,54912,833
06-04-2021,chennai,8973,1303,516,5,9755,255009,1303,47,0,256359,242324,4280
06-04-2021,coimbatore,2442,281,145,1,2577,60489,281,51,0,60821,57549,695
06-04-2021,cuddalore,422,45,26,0,441,25830,45,202,0,26077,25344,292
06-04-2021,dharmapuri,92,23,4,0,111,6627,23,214,0,6864,6698,55
06-04-2021,dindigul,237,52,24,0,265,11997,52,77,0,12126,11659,202
06-04-2021,erode,229,47,23,0,253,15434,47,94,0,15575,15172,150
06-04-2021,kallakurichi,68,10,1,0,77,10612,10,404,0,11026,10841,108
06-04-2021,kancheepuram,543,137,67,0,613,31094,137,3,0,31234,30157,464
06-04-2021,kanyakumari,270,39,21,0,288,17602,39,117,0,17758,17205,265
06-04-2021,karur,91,15,7,0,99,5674,15,46,0,5735,5584,52
06-04-2021,krishnagiri,276,35,21,0,290,8510,35,175,0,8720,8311,119
06-04-2021,madurai,541,120,12,0,649,22007,120,163,0,22290,21173,468
06-04-2021,nagapattinam,502,84,45,0,541,9389,84,89,0,9562,8877,144
06-04-2021,namakkal,200,42,23,0,219,12138,42,106,0,12286,11956,111
06-04-2021,nilgiris,152,26,21,0,157,8741,26,24,0,8791,8584,50
06-04-2021,perambalur,16,1,1,0,16,2320,1,2,0,2323,2286,21
06-04-2021,pudukottai,151,22,16,0,157,11950,22,33,0,12005,11688,160
06-04-2021,ramanathapuram,80,17,3,0,94,6483,17,134,0,6634,6402,138
06-04-2021,ranipet,240,19,0,0,259,16555,19,49,0,16623,16174,190
06-04-2021,salem,395,67,80,0,382,33372,67,425,0,33864,33014,468
06-04-2021,sivagangai,145,32,12,0,165,7025,32,69,0,7126,6834,127
06-04-2021,tenkasi,164,19,4,0,179,8766,19,58,0,8843,8503,161
06-04-2021,thanjavur,820,121,115,2,824,20351,121,22,0,20494,19395,275
06-04-2021,theni,90,25,5,0,110,17327,25,45,0,17397,17080,207
06-04-2021,thirupathur,108,22,14,0,116,7777,22,115,0,7914,7670,128
06-04-2021,thiruvallur,986,165,106,1,1044,46912,165,10,0,47087,45327,716
06-04-2021,thiruvannamalai,162,44,17,1,188,19445,44,394,0,19883,19408,287
06-04-2021,thiruvarur,489,65,58,0,496,12316,65,38,0,12419,11808,115
06-04-2021,thoothukudi,169,14,15,0,168,16391,14,273,0,16678,16367,143
06-04-2021,tirunelveli,384,93,50,0,427,15922,93,421,0,16436,15793,216
06-04-2021,tiruppur,596,98,43,0,651,19751,98,11,0,19860,18982,227
06-04-2021,trichy,765,117,51,0,831,16183,117,47,0,16347,15330,186
06-04-2021,vellore,254,97,28,0,323,21134,65,541,32,21772,21094,355
06-04-2021,villupuram,200,13,14,0,199,15481,13,174,0,15668,15356,113
06-04-2021,virudhunagar,70,27,9,0,88,16849,27,104,0,16980,16660,232
06-04-2021,airport surveillance (international),12,1,0,0,13,0,0,979,1,980,966,1
06-04-2021,airport surveillance (domestic),11,0,0,0,11,0,0,1058,0,1058,1046,1
06-04-2021,railway surveillance,0,0,0,0,0,0,0,428,0,428,428,0
07-04-2021,ariyalur,41,17,1,0,57,4835,17,20,0,4872,4766,49
07-04-2021,chengalpattu,2507,390,216,2,2679,58247,390,5,0,58642,55128,835
07-04-2021,chennai,9788,1459,556,6,10685,256345,1459,47,0,257851,242880,4286
07-04-2021,coimbatore,2586,332,150,1,2767,60779,332,51,0,61162,57699,696
07-04-2021,cuddalore,441,70,34,0,477,25875,70,202,0,26147,25378,292
07-04-2021,dharmapuri,113,33,9,0,137,6652,33,214,0,6899,6707,55
07-04-2021,dindigul,262,94,18,0,338,12046,94,77,0,12217,11677,202
07-04-2021,erode,252,60,17,0,295,15480,60,94,0,15634,15189,150
07-04-2021,kallakurichi,77,24,2,0,99,10622,24,404,0,11050,10843,108
07-04-2021,kancheepuram,570,96,64,0,602,31188,96,3,0,31287,30221,464
07-04-2021,kanyakumari,288,18,16,0,290,17641,18,117,0,17776,17221,265
07-04-2021,karur,97,19,11,0,105,5687,19,46,0,5752,5595,52
07-04-2021,krishnagiri,290,49,23,0,316,8545,48,175,1,8769,8334,119
07-04-2021,madurai,640,83,15,1,707,22118,82,163,1,22364,21188,469
07-04-2021,nagapattinam,544,59,54,1,548,9476,59,89,0,9624,8931,145
07-04-2021,namakkal,218,32,22,0,228,12179,32,106,0,12317,11978,111
07-04-2021,nilgiris,152,30,14,0,168,8762,28,24,2,8816,8598,50
07-04-2021,perambalur,16,3,0,0,19,2321,3,2,0,2326,2286,21
07-04-2021,pudukottai,158,25,8,0,175,11973,25,33,0,12031,11696,160
07-04-2021,ramanathapuram,95,18,3,0,110,6501,18,134,0,6653,6405,138
07-04-2021,ranipet,253,41,32,0,262,16568,41,49,0,16658,16206,190
07-04-2021,salem,387,90,57,1,419,33444,90,425,0,33959,33071,469
07-04-2021,sivagangai,164,11,21,0,154,7056,11,69,0,7136,6855,127
07-04-2021,tenkasi,179,25,6,0,198,8785,25,58,0,8868,8509,161
07-04-2021,thanjavur,819,108,103,1,823,20467,108,22,0,20597,19498,276
07-04-2021,theni,106,15,11,0,110,17348,15,45,0,17408,17091,207
07-04-2021,thirupathur,116,25,9,0,132,7799,25,115,0,7939,7679,128
07-04-2021,thiruvallur,1052,208,91,0,1169,47085,208,10,0,47303,45418,716
07-04-2021,thiruvannamalai,189,38,9,1,217,19490,38,394,0,19922,19417,288
07-04-2021,thiruvarur,496,53,53,0,496,12381,53,38,0,12472,11861,115
07-04-2021,thoothukudi,168,43,14,0,197,16405,43,273,0,16721,16381,143
07-04-2021,tirunelveli,427,41,23,1,444,16015,41,421,0,16477,15816,217
07-04-2021,tiruppur,651,141,56,1,735,19849,141,11,0,20001,19038,228
07-04-2021,trichy,823,91,58,1,855,16292,90,47,1,16430,15388,187
07-04-2021,vellore,321,68,31,0,358,21197,60,573,8,21838,21125,355
07-04-2021,villupuram,200,52,14,0,238,15495,52,174,0,15721,15370,113
07-04-2021,virudhunagar,88,24,3,0,109,16876,24,104,0,17004,16663,232
07-04-2021,airport surveillance (international),13,1,0,0,14,0,0,980,1,981,966,1
07-04-2021,airport surveillance (domestic),11,0,0,0,11,0,0,1058,0,1058,1046,1
07-04-2021,railway surveillance,0,0,0,0,0,0,0,428,0,428,428,0
08-04-2021,ariyalur,54,11,9,0,56,4849,11,20,0,4880,4775,49
08-04-2021,chengalpattu,2687,398,237,3,2845,58645,398,5,0,59048,55365,838
08-04-2021,chennai,10634,1520,515,6,11633,257753,1520,47,0,259320,243395,4292
08-04-2021,coimbatore,2775,427,141,2,3059,61119,427,51,0,61597,57840,698
08-04-2021,cuddalore,477,45,44,0,478,25945,45,202,0,26192,25422,292
08-04-2021,dharmapuri,136,21,9,0,148,6684,21,214,0,6919,6716,55
08-04-2021,dindigul,334,52,18,0,368,12136,52,77,0,12265,11695,202
08-04-2021,erode,296,45,11,0,330,15541,45,94,0,15680,15200,150
08-04-2021,kallakurichi,99,6,3,0,102,10646,6,404,0,11056,10846,108
08-04-2021,kancheepuram,610,107,50,0,667,31292,107,3,0,31402,30271,464
08-04-2021,kanyakumari,289,62,19,0,332,17658,62,117,0,17837,17240,265
08-04-2021,karur,106,16,12,0,110,5707,16,46,0,5769,5607,52
08-04-2021,krishnagiri,317,60,26,0,351,8594,60,176,0,8830,8360,119
08-04-2021,madurai,703,115,29,0,789,22196,114,164,1,22475,21217,469
08-04-2021,nagapattinam,549,118,55,0,612,9536,118,89,0,9743,8986,145
08-04-2021,namakkal,231,17,16,0,232,12214,17,106,0,12337,11994,111
08-04-2021,nilgiris,166,26,12,0,180,8788,26,26,0,8840,8610,50
08-04-2021,perambalur,19,4,2,0,21,2324,4,2,0,2330,2288,21
08-04-2021,pudukottai,175,21,18,0,178,11998,21,33,0,12052,11714,160
08-04-2021,ramanathapuram,112,10,4,0,118,6521,10,134,0,6665,6409,138
08-04-2021,ranipet,259,29,46,0,242,16606,29,49,0,16684,16252,190
08-04-2021,salem,420,103,65,0,458,33535,103,425,0,34063,33136,469
08-04-2021,sivagangai,156,43,15,0,184,7069,42,69,1,7181,6870,127
08-04-2021,tenkasi,195,24,11,0,208,8807,24,58,0,8889,8520,161
08-04-2021,thanjavur,824,125,114,3,832,20576,125,22,0,20723,19612,279
08-04-2021,theni,112,31,8,0,135,17365,31,45,0,17441,17099,207
08-04-2021,thirupathur,132,20,13,0,139,7824,20,115,0,7959,7692,128
08-04-2021,thiruvallur,1176,199,96,3,1276,47300,199,10,0,47509,45514,719
08-04-2021,thiruvannamalai,225,42,13,0,254,19536,42,394,0,19972,19430,288
08-04-2021,thiruvarur,497,70,48,1,518,12435,70,38,0,12543,11909,116
08-04-2021,thoothukudi,197,47,16,0,228,16448,47,273,0,16768,16397,143
08-04-2021,tirunelveli,447,75,16,0,506,16059,75,421,0,16555,15832,217
08-04-2021,tiruppur,735,154,55,0,834,19990,154,11,0,20155,19093,228
08-04-2021,trichy,862,131,54,1,938,16389,131,48,0,16568,15442,188
08-04-2021,vellore,361,71,32,0,400,21260,57,581,14,21912,21157,355
08-04-2021,villupuram,238,18,26,0,230,15547,18,174,0,15739,15396,113
08-04-2021,virudhunagar,113,13,11,0,115,16904,13,104,0,17021,16674,232
08-04-2021,airport surveillance (international),14,0,0,0,14,0,0,981,0,981,966,1
08-04-2021,airport surveillance (domestic),11,0,0,0,11,0,0,1058,0,1058,1046,1
08-04-2021,railway surveillance,0,0,0,0,0,0,0,428,0,428,428,0
09-04-2021,ariyalur,56,15,2,0,69,4860,15,20,0,4895,4777,49
09-04-2021,chengalpattu,2845,465,226,1,3083,59043,465,5,0,59513,55591,839
09-04-2021,chennai,11633,1752,514,10,12861,259273,1752,47,0,261072,243909,4302
09-04-2021,coimbatore,3059,473,142,1,3389,61546,473,51,0,62070,57982,699
09-04-2021,cuddalore,478,148,43,0,583,25990,148,202,0,26340,25465,292
09-04-2021,dharmapuri,148,58,6,0,200,6705,58,214,0,6977,6722,55
09-04-2021,dindigul,368,52,41,0,379,12188,52,77,0,12317,11736,202
09-04-2021,erode,330,70,27,0,373,15586,70,94,0,15750,15227,150
09-04-2021,kallakurichi,102,25,2,0,125,10652,25,404,0,11081,10848,108
09-04-2021,kancheepuram,667,153,25,1,794,31399,153,3,0,31555,30296,465
09-04-2021,kanyakumari,332,54,24,0,362,17720,54,117,0,17891,17264,265
09-04-2021,karur,110,22,12,0,120,5723,22,46,0,5791,5619,52
09-04-2021,krishnagiri,351,96,30,0,417,8654,92,176,4,8926,8390,119
09-04-2021,madurai,789,142,35,1,895,22310,141,165,1,22617,21252,470
09-04-2021,nagapattinam,612,124,32,1,703,9654,124,89,0,9867,9018,146
09-04-2021,namakkal,232,51,17,0,266,12231,51,106,0,12388,12011,111
09-04-2021,nilgiris,180,29,18,0,191,8814,29,26,0,8869,8628,50
09-04-2021,perambalur,21,5,2,0,24,2328,5,2,0,2335,2290,21
09-04-2021,pudukottai,178,44,17,0,205,12019,44,33,0,12096,11731,160
09-04-2021,ramanathapuram,118,28,6,0,140,6531,28,134,0,6693,6415,138
09-04-2021,ranipet,242,95,33,0,304,16635,95,49,0,16779,16285,190
09-04-2021,salem,458,126,22,0,562,33638,126,425,0,34189,33158,469
09-04-2021,sivagangai,184,58,3,0,239,7111,54,70,4,7239,6873,127
09-04-2021,tenkasi,208,41,24,0,225,8831,41,58,0,8930,8544,161
09-04-2021,thanjavur,832,144,100,2,874,20701,144,22,0,20867,19712,281
09-04-2021,theni,135,38,9,0,164,17396,38,45,0,17479,17108,207
09-04-2021,thirupathur,139,11,16,0,134,7844,11,115,0,7970,7708,128
09-04-2021,thiruvallur,1276,195,137,2,1332,47499,195,10,0,47704,45651,721
09-04-2021,thiruvannamalai,254,69,13,0,310,19578,69,394,0,20041,19443,288
09-04-2021,thiruvarur,518,86,45,0,559,12505,86,38,0,12629,11954,116
09-04-2021,thoothukudi,228,79,10,1,296,16495,79,273,0,16847,16407,144
09-04-2021,tirunelveli,506,114,8,0,612,16134,114,421,0,16669,15840,217
09-04-2021,tiruppur,834,148,70,0,912,20144,148,11,0,20303,19163,228
09-04-2021,trichy,938,213,66,2,1083,16520,213,48,0,16781,15508,190
09-04-2021,vellore,400,109,76,0,433,21317,91,595,18,22021,21233,355
09-04-2021,villupuram,230,81,26,0,285,15565,81,174,0,15820,15422,113
09-04-2021,virudhunagar,115,23,6,1,131,16917,23,104,0,17044,16680,233
09-04-2021,airport surveillance (international),14,4,0,0,18,0,0,981,4,985,966,1
09-04-2021,airport surveillance (domestic),11,1,5,0,7,0,0,1058,1,1059,1051,1
09-04-2021,railway surveillance,0,0,0,0,0,0,0,428,0,428,428,0
10-04-2021,ariyalur,68,25,3,0,90,4874,25,20,0,4919,4780,49
10-04-2021,chengalpattu,3075,615,272,2,3416,59502,615,5,0,60122,55863,843
10-04-2021,chennai,12943,1977,526,12,14382,261105,1977,47,0,263129,244435,4312
10-04-2021,coimbatore,3393,501,217,0,3677,62023,501,51,0,62575,58199,699
10-04-2021,cuddalore,578,127,39,0,666,26133,127,202,0,26462,25504,292
10-04-2021,dharmapuri,198,41,7,0,232,6761,41,214,0,7016,6729,55
10-04-2021,dindigul,372,57,19,1,409,12233,57,77,0,12367,11755,203
10-04-2021,erode,369,85,9,0,445,15652,85,94,0,15831,15236,150
10-04-2021,kallakurichi,119,21,4,0,136,10671,21,404,0,11096,10852,108
10-04-2021,kancheepuram,778,181,64,2,893,31536,181,3,0,31720,30360,467
10-04-2021,kanyakumari,363,96,25,0,434,17775,93,117,3,17988,17289,265
10-04-2021,karur,118,37,7,0,148,5743,37,46,0,5826,5626,52
10-04-2021,krishnagiri,416,97,34,0,479,8745,94,180,3,9022,8424,119
10-04-2021,madurai,897,194,42,0,1049,22453,194,166,0,22813,21294,470
10-04-2021,nagapattinam,702,145,48,2,797,9777,144,89,1,10011,9066,148
10-04-2021,namakkal,263,62,23,0,302,12279,62,106,0,12447,12034,111
10-04-2021,nilgiris,190,33,19,1,203,8842,33,26,0,8901,8647,51
10-04-2021,perambalur,23,7,0,0,30,2332,7,2,0,2341,2290,21
10-04-2021,pudukottai,205,25,22,0,208,12063,23,33,2,12121,11753,160
10-04-2021,ramanathapuram,141,26,5,0,162,6560,26,134,0,6720,6420,138
10-04-2021,ranipet,301,92,0,0,393,16727,92,49,0,16868,16285,190
10-04-2021,salem,565,136,18,1,682,33767,135,425,1,34328,33176,470
10-04-2021,sivagangai,234,44,13,0,265,7160,44,74,0,7278,6886,127
10-04-2021,tenkasi,222,53,7,0,268,8869,53,58,0,8980,8551,161
10-04-2021,thanjavur,872,116,78,0,910,20843,116,22,0,20981,19790,281
10-04-2021,theni,163,25,8,0,180,17433,25,45,0,17503,17116,207
10-04-2021,thirupathur,135,24,12,0,147,7856,24,115,0,7995,7720,128
10-04-2021,thiruvallur,1310,212,92,0,1430,47672,212,10,0,47894,45743,721
10-04-2021,thiruvannamalai,309,77,21,0,365,19646,77,394,0,20117,19464,288
10-04-2021,thiruvarur,555,92,66,0,581,12587,92,38,0,12717,12020,116
10-04-2021,thoothukudi,296,102,14,0,384,16574,102,273,0,16949,16421,144
10-04-2021,tirunelveli,610,117,33,0,694,16246,117,421,0,16784,15873,217
10-04-2021,tiruppur,912,154,64,1,1001,20292,154,11,0,20457,19227,229
10-04-2021,trichy,1085,187,87,0,1185,16735,187,48,0,16970,15595,190
10-04-2021,vellore,433,86,19,1,499,21408,70,613,16,22107,21252,356
10-04-2021,villupuram,289,65,26,0,328,15650,65,174,0,15889,15448,113
10-04-2021,virudhunagar,132,55,9,0,178,16941,55,104,0,17100,16689,233
10-04-2021,airport surveillance (international),18,0,0,0,18,0,0,985,0,985,966,1
10-04-2021,airport surveillance (domestic),7,0,0,0,7,0,0,1059,0,1059,1051,1
10-04-2021,railway surveillance,0,0,0,0,0,0,0,428,0,428,428,0
11-04-2021,ariyalur,84,20,5,0,99,4893,20,20,0,4933,4785,49
11-04-2021,chengalpattu,3455,631,307,1,3778,60156,631,5,0,60792,56170,844
11-04-2021,chennai,14255,2124,606,12,15761,262955,2124,47,0,265126,245041,4324
11-04-2021,coimbatore,3682,617,248,0,4051,62529,617,51,0,63197,58447,699
11-04-2021,cuddalore,666,97,33,0,730,26260,97,202,0,26559,25537,292
11-04-2021,dharmapuri,232,44,2,0,274,6802,44,214,0,7060,6731,55
11-04-2021,dindigul,409,81,13,0,477,12290,81,77,0,12448,11768,203
11-04-2021,erode,435,119,37,0,517,15727,119,94,0,15940,15273,150
11-04-2021,kallakurichi,138,44,2,0,180,10694,44,404,0,11142,10854,108
11-04-2021,kancheepuram,910,206,86,0,1030,31734,206,3,0,31943,30446,467
11-04-2021,kanyakumari,435,93,26,0,502,17869,92,120,1,18082,17315,265
11-04-2021,karur,152,38,9,0,181,5784,38,46,0,5868,5635,52
11-04-2021,krishnagiri,481,132,35,0,578,8841,131,183,1,9156,8459,119
11-04-2021,madurai,1049,173,45,1,1176,22647,173,166,0,22986,21339,471
11-04-2021,nagapattinam,801,159,65,0,895,9925,159,90,0,10174,9131,148
11-04-2021,namakkal,302,85,21,0,366,12341,85,106,0,12532,12055,111
11-04-2021,nilgiris,203,36,19,0,220,8875,36,26,0,8937,8666,51
11-04-2021,perambalur,31,4,5,1,29,2340,4,2,0,2346,2295,22
11-04-2021,pudukottai,211,40,13,0,238,12089,40,35,0,12164,11766,160
11-04-2021,ramanathapuram,162,21,5,0,178,6586,21,134,0,6741,6425,138
11-04-2021,ranipet,396,88,31,0,453,16822,88,49,0,16959,16316,190
11-04-2021,salem,686,128,20,1,793,33906,128,426,0,34460,33196,471
11-04-2021,sivagangai,262,63,25,1,299,7201,56,74,7,7338,6911,128
11-04-2021,tenkasi,272,28,5,1,294,8926,28,58,0,9012,8556,162
11-04-2021,thanjavur,909,178,58,0,1029,20958,178,22,0,21158,19848,281
11-04-2021,theni,180,45,8,0,217,17458,45,45,0,17548,17124,207
11-04-2021,thirupathur,148,31,15,0,164,7881,31,115,0,8027,7735,128
11-04-2021,thiruvallur,1440,296,155,2,1579,47894,296,10,0,48200,45898,723
11-04-2021,thiruvannamalai,368,74,21,0,421,19726,74,394,0,20194,19485,288
11-04-2021,thiruvarur,582,100,75,0,607,12680,100,38,0,12818,12095,116
11-04-2021,thoothukudi,385,149,11,0,523,16677,149,273,0,17099,16432,144
11-04-2021,tirunelveli,706,144,109,0,741,16375,144,421,0,16940,15982,217
11-04-2021,tiruppur,1006,177,77,0,1106,20451,177,11,0,20639,19304,229
11-04-2021,trichy,1195,154,70,0,1279,16932,154,48,0,17134,15665,190
11-04-2021,vellore,503,90,20,1,572,21482,69,629,21,22201,21272,357
11-04-2021,villupuram,331,60,26,0,365,15718,60,174,0,15952,15474,113
11-04-2021,virudhunagar,186,44,6,1,223,17004,44,104,0,17152,16695,234
11-04-2021,airport surveillance (international),18,5,0,0,23,0,0,985,5,990,966,1
11-04-2021,airport surveillance (domestic),7,0,0,0,7,0,0,1059,0,1059,1051,1
11-04-2021,railway surveillance,0,0,0,0,0,0,0,428,0,428,428,0
12-04-2021,ariyalur,99,22,2,0,119,4913,22,20,0,4955,4787,49
12-04-2021,chengalpattu,3784,611,308,2,4085,60793,611,5,0,61409,56478,846
12-04-2021,chennai,15711,2105,710,8,17098,265029,2105,47,0,267181,245751,4332
12-04-2021,coimbatore,4058,604,283,1,4378,63153,604,51,0,63808,58730,700
12-04-2021,cuddalore,740,157,51,0,846,26367,157,202,0,26726,25588,292
12-04-2021,dharmapuri,272,98,7,0,363,6844,98,214,0,7156,6738,55
12-04-2021,dindigul,477,78,7,0,548,12371,78,77,0,12526,11775,203
12-04-2021,erode,509,117,19,0,607,15838,117,94,0,16049,15292,150
12-04-2021,kallakurichi,187,35,19,0,203,10745,35,404,0,11184,10873,108
12-04-2021,kancheepuram,1040,277,54,0,1263,31950,277,3,0,32230,30500,467
12-04-2021,kanyakumari,503,56,80,0,479,17962,56,121,0,18139,17395,265
12-04-2021,karur,181,44,11,0,214,5822,44,46,0,5912,5646,52
12-04-2021,krishnagiri,578,119,24,0,673,8972,117,184,2,9275,8483,119
12-04-2021,madurai,1179,219,53,0,1345,22823,219,166,0,23208,21392,471
12-04-2021,nagapattinam,897,125,59,2,961,10086,125,90,0,10301,9190,150
12-04-2021,namakkal,368,72,26,0,414,12428,72,106,0,12606,12081,111
12-04-2021,nilgiris,220,29,15,0,234,8911,29,26,0,8966,8681,51
12-04-2021,perambalur,28,4,0,0,32,2343,4,2,0,2349,2295,22
12-04-2021,pudukottai,238,45,4,0,279,12129,45,35,0,12209,11770,160
12-04-2021,ramanathapuram,179,17,31,0,165,6608,17,134,0,6759,6456,138
12-04-2021,ranipet,450,73,29,0,494,16907,73,49,0,17029,16345,190
12-04-2021,salem,796,158,16,0,938,34037,158,426,0,34621,33212,471
12-04-2021,sivagangai,299,72,18,0,353,7257,72,81,0,7410,6929,128
12-04-2021,tenkasi,295,74,21,0,348,8955,74,58,0,9087,8577,162
12-04-2021,thanjavur,1029,127,64,0,1092,21136,127,22,0,21285,19912,281
12-04-2021,theni,217,30,11,0,236,17503,30,45,0,17578,17135,207
12-04-2021,thirupathur,165,30,9,0,186,7913,30,115,0,8058,7744,128
12-04-2021,thiruvallur,1594,333,104,2,1821,48205,333,10,0,48548,46002,725
12-04-2021,thiruvannamalai,423,111,27,0,507,19802,111,394,0,20307,19512,288
12-04-2021,thiruvarur,607,98,8,0,697,12780,98,38,0,12916,12103,116
12-04-2021,thoothukudi,524,138,18,0,644,16827,138,273,0,17238,16450,144
12-04-2021,tirunelveli,743,81,40,0,784,16521,81,421,0,17023,16022,217
12-04-2021,tiruppur,1110,160,36,1,1233,20632,160,11,0,20803,19340,230
12-04-2021,trichy,1281,184,103,2,1360,17088,184,48,0,17320,15768,192
12-04-2021,vellore,569,73,22,1,619,21548,70,650,3,22271,21294,358
12-04-2021,villupuram,351,61,19,0,393,15764,61,174,0,15999,15493,113
12-04-2021,virudhunagar,224,71,16,0,279,17049,71,104,0,17224,16711,234
12-04-2021,airport surveillance (international),23,3,9,0,17,0,0,990,3,993,975,1
12-04-2021,airport surveillance (domestic),7,0,6,0,1,0,0,1059,0,1059,1057,1
12-04-2021,railway surveillance,0,0,0,0,0,0,0,428,0,428,428,0
13-04-2021,ariyalur,119,9,7,0,121,4935,9,20,0,4964,4794,49
13-04-2021,chengalpattu,4185,771,310,3,4643,61504,771,5,0,62280,56788,849
13-04-2021,chennai,17049,2482,853,5,18673,267085,2482,47,0,269614,246604,4337
13-04-2021,coimbatore,4385,504,369,0,4520,63764,504,51,0,64319,59099,700
13-04-2021,cuddalore,845,73,31,2,885,26523,73,202,0,26798,25619,294
13-04-2021,dharmapuri,364,40,17,0,387,6943,40,214,0,7197,6755,55
13-04-2021,dindigul,545,95,46,0,594,12446,95,77,0,12618,11821,203
13-04-2021,erode,606,88,69,1,624,15954,88,94,0,16136,15361,151
13-04-2021,kallakurichi,204,26,13,0,217,10781,26,404,0,11211,10886,108
13-04-2021,kancheepuram,1179,204,26,1,1356,32143,204,3,0,32350,30526,468
13-04-2021,kanyakumari,482,124,52,1,553,18021,124,121,0,18266,17447,266
13-04-2021,karur,214,38,7,0,245,5866,38,46,0,5950,5653,52
13-04-2021,krishnagiri,670,58,64,0,664,9086,57,186,1,9330,8547,119
13-04-2021,madurai,1334,254,91,1,1496,23031,254,166,0,23451,21483,472
13-04-2021,nagapattinam,960,123,67,0,1016,10210,123,90,0,10423,9257,150
13-04-2021,namakkal,416,59,25,0,450,12502,59,106,0,12667,12106,111
13-04-2021,nilgiris,234,21,22,0,233,8940,21,26,0,8987,8703,51
13-04-2021,perambalur,33,3,3,0,33,2348,3,2,0,2353,2298,22
13-04-2021,pudukottai,279,41,22,0,298,12174,41,35,0,12250,11792,160
13-04-2021,ramanathapuram,167,40,18,0,189,6627,40,134,0,6801,6474,138
13-04-2021,ranipet,492,59,54,0,497,16978,59,49,0,17086,16399,190
13-04-2021,salem,942,138,45,0,1035,34199,137,426,1,34763,33257,471
13-04-2021,sivagangai,347,31,25,0,353,7323,31,81,0,7435,6954,128
13-04-2021,tenkasi,347,113,11,0,449,9028,113,58,0,9199,8588,162
13-04-2021,thanjavur,1092,214,188,1,1117,21263,214,22,0,21499,20100,282
13-04-2021,theni,237,36,14,0,259,17534,36,45,0,17615,17149,207
13-04-2021,thirupathur,189,32,11,0,210,7946,32,115,0,8093,7755,128
13-04-2021,thiruvallur,1839,285,149,1,1974,48556,285,10,0,48851,46151,726
13-04-2021,thiruvannamalai,512,49,28,0,533,19918,45,394,4,20361,19540,288
13-04-2021,thiruvarur,693,106,140,0,659,12874,106,38,0,13018,12243,116
13-04-2021,thoothukudi,650,82,20,0,712,16971,82,273,0,17326,16470,144
13-04-2021,tirunelveli,783,220,38,2,963,16601,220,421,0,17242,16060,219
13-04-2021,tiruppur,1233,165,80,0,1318,20792,165,11,0,20968,19420,230
13-04-2021,trichy,1367,199,151,0,1415,17279,199,48,0,17526,15919,192
13-04-2021,vellore,624,107,112,0,619,21623,89,653,18,22383,21406,358
13-04-2021,villupuram,393,26,46,0,373,15825,26,174,0,16025,15539,113
13-04-2021,virudhunagar,280,67,65,0,282,17121,67,104,0,17292,16776,234
13-04-2021,airport surveillance (international),17,1,0,0,18,0,0,993,1,994,975,1
13-04-2021,airport surveillance (domestic),1,1,0,0,2,0,0,1059,1,1060,1057,1
13-04-2021,railway surveillance,0,0,0,0,0,0,0,428,0,428,428,0
14-04-2021,ariyalur,123,22,13,0,132,4946,22,20,0,4988,4807,49
14-04-2021,chengalpattu,4684,772,364,3,5089,62316,772,5,0,63093,57152,852
14-04-2021,chennai,18613,2564,1026,7,20144,269507,2564,47,0,272118,247630,4344
14-04-2021,coimbatore,4528,540,521,3,4544,64276,540,51,0,64867,59620,703
14-04-2021,cuddalore,889,175,41,2,1021,26600,175,202,0,26977,25660,296
14-04-2021,dharmapuri,388,91,9,0,470,6984,91,214,0,7289,6764,55
14-04-2021,dindigul,590,112,12,0,690,12537,112,77,0,12726,11833,203
14-04-2021,erode,628,153,74,0,707,16046,153,94,0,16293,15435,151
14-04-2021,kallakurichi,218,32,10,0,240,10808,32,404,0,11244,10896,108
14-04-2021,kancheepuram,1367,124,53,1,1437,32358,123,3,1,32485,30579,469
14-04-2021,kanyakumari,553,88,54,1,586,18145,87,121,1,18354,17501,267
14-04-2021,karur,246,51,12,0,285,5905,51,46,0,6002,5665,52
14-04-2021,krishnagiri,664,156,47,0,773,9143,154,187,2,9486,8594,119
14-04-2021,madurai,1491,199,99,0,1591,23280,199,166,0,23645,21582,472
14-04-2021,nagapattinam,1017,157,70,1,1103,10334,157,90,0,10581,9327,151
14-04-2021,namakkal,442,81,25,0,498,12553,81,106,0,12740,12131,111
14-04-2021,nilgiris,234,38,24,0,248,8962,25,26,13,9026,8727,51
14-04-2021,perambalur,34,2,2,0,34,2352,2,2,0,2356,2300,22
14-04-2021,pudukottai,299,49,25,0,323,12216,49,35,0,12300,11817,160
14-04-2021,ramanathapuram,192,38,16,0,214,6670,37,134,1,6842,6490,138
14-04-2021,ranipet,500,88,0,0,588,17040,88,49,0,17177,16399,190
14-04-2021,salem,1038,175,95,2,1116,34339,175,427,0,34941,33352,473
14-04-2021,sivagangai,345,47,12,0,380,7346,47,81,0,7474,6966,128
14-04-2021,tenkasi,450,73,8,0,515,9142,73,58,0,9273,8596,162
14-04-2021,thanjavur,1119,158,128,0,1149,21479,158,22,0,21659,20228,282
14-04-2021,theni,258,47,30,0,275,17569,47,45,0,17661,17179,207
14-04-2021,thirupathur,214,79,10,0,283,7982,79,115,0,8176,7765,128
14-04-2021,thiruvallur,1963,383,171,2,2173,48830,383,10,0,49223,46322,728
14-04-2021,thiruvannamalai,534,78,37,0,575,19964,78,398,0,20440,19577,288
14-04-2021,thiruvarur,656,108,65,1,698,12977,108,38,0,13123,12308,117
14-04-2021,thoothukudi,712,244,20,0,936,17053,244,273,0,17570,16490,144
14-04-2021,tirunelveli,967,193,43,0,1117,16825,193,421,0,17439,16103,219
14-04-2021,tiruppur,1322,225,89,1,1457,20961,225,11,0,21197,19509,231
14-04-2021,trichy,1411,216,125,0,1502,17474,216,48,0,17738,16044,192
14-04-2021,vellore,617,113,62,1,667,21710,100,671,13,22494,21468,359
14-04-2021,villupuram,376,97,42,0,431,15854,97,174,0,16125,15581,113
14-04-2021,virudhunagar,283,48,30,0,301,17189,48,104,0,17341,16806,234
14-04-2021,airport surveillance (international),18,2,0,0,20,0,0,994,2,996,975,1
14-04-2021,airport surveillance (domestic),2,1,0,0,3,0,0,1060,1,1061,1057,1
14-04-2021,railway surveillance,0,0,0,0,0,0,0,428,0,428,428,0
15-04-2021,ariyalur,130,29,6,0,153,4966,29,20,0,5015,4813,49
15-04-2021,chengalpattu,5101,685,369,2,5415,63100,685,5,0,63790,57521,854
15-04-2021,chennai,20201,2558,1360,8,21391,272129,2558,47,0,274734,248990,4353
15-04-2021,coimbatore,4549,534,643,2,4438,64821,534,51,0,65406,60263,705
15-04-2021,cuddalore,1021,179,115,1,1084,26776,179,202,0,27157,25775,298
15-04-2021,dharmapuri,470,83,25,1,527,7075,83,214,0,7372,6789,56
15-04-2021,dindigul,682,120,56,0,746,12641,120,77,0,12838,11889,203
15-04-2021,erode,707,144,30,1,820,16199,144,94,0,16437,15465,152
15-04-2021,kallakurichi,235,41,10,0,266,10835,41,404,0,11280,10906,108
15-04-2021,kancheepuram,1426,203,133,4,1492,32470,203,4,0,32677,30712,473
15-04-2021,kanyakumari,586,96,19,0,663,18232,96,122,0,18450,17520,267
15-04-2021,karur,287,53,14,0,326,5958,53,46,0,6057,5679,52
15-04-2021,krishnagiri,774,162,22,0,914,9298,162,189,0,9649,8616,119
15-04-2021,madurai,1592,234,106,1,1719,23480,234,166,0,23880,21688,473
15-04-2021,nagapattinam,1105,134,83,3,1153,10493,134,90,0,10717,9410,154
15-04-2021,namakkal,494,96,56,0,534,12630,96,106,0,12832,12187,111
15-04-2021,nilgiris,248,39,21,0,266,8987,39,39,0,9065,8748,51
15-04-2021,perambalur,34,11,4,0,41,2354,11,2,0,2367,2304,22
15-04-2021,pudukottai,324,62,5,0,381,12266,62,35,0,12363,11822,160
15-04-2021,ramanathapuram,211,46,18,0,239,6704,46,135,0,6885,6508,138
15-04-2021,ranipet,583,101,38,0,646,17123,101,49,0,17273,16437,190
15-04-2021,salem,1116,195,66,2,1243,34513,194,427,1,35135,33418,474
15-04-2021,sivagangai,376,59,31,0,404,7389,50,81,9,7529,6997,128
15-04-2021,tenkasi,515,67,49,1,532,9215,67,58,0,9340,8645,163
15-04-2021,thanjavur,1142,166,109,0,1199,21629,166,22,0,21817,20337,281
15-04-2021,theni,277,56,14,0,319,17618,56,45,0,17719,17193,207
15-04-2021,thirupathur,288,63,17,0,334,8066,63,115,0,8244,7782,128
15-04-2021,thiruvallur,2148,473,279,0,2342,49188,473,10,0,49671,46601,728
15-04-2021,thiruvannamalai,576,90,18,0,648,20043,90,398,0,20531,19595,288
15-04-2021,thiruvarur,695,125,51,0,769,13082,125,38,0,13245,12359,117
15-04-2021,thoothukudi,936,169,12,0,1093,17297,169,273,0,17739,16502,144
15-04-2021,tirunelveli,1114,171,102,2,1181,17015,171,421,0,17607,16205,221
15-04-2021,tiruppur,1454,233,114,0,1573,21183,233,11,0,21427,19623,231
15-04-2021,trichy,1504,241,117,0,1628,17692,240,48,1,17981,16161,192
15-04-2021,vellore,656,141,32,0,765,21799,115,684,26,22624,21500,359
15-04-2021,villupuram,434,45,17,1,461,15954,45,174,0,16173,15598,114
15-04-2021,virudhunagar,301,79,15,0,365,17237,79,104,0,17420,16821,234
15-04-2021,airport surveillance (international),20,0,0,0,20,0,0,996,0,996,975,1
15-04-2021,airport surveillance (domestic),3,4,0,0,7,0,0,1061,4,1065,1057,1
15-04-2021,railway surveillance,0,0,0,0,0,0,0,428,0,428,428,0
16-04-2021,ariyalur,152,22,11,0,163,4994,22,20,0,5036,4824,49
16-04-2021,chengalpattu,5447,795,390,2,5850,63817,795,5,0,64617,57911,856
16-04-2021,chennai,21321,2636,1526,11,22420,274617,2636,47,0,277300,250516,4364
16-04-2021,coimbatore,4442,583,622,1,4402,65359,583,51,0,65993,60885,706
16-04-2021,cuddalore,1079,102,120,1,1060,26950,101,202,1,27254,25895,299
16-04-2021,dharmapuri,527,88,25,1,589,7158,88,214,0,7460,6814,57
16-04-2021,dindigul,747,92,63,0,776,12762,92,77,0,12931,11952,203
16-04-2021,erode,823,132,63,0,892,16346,132,94,0,16572,15528,152
16-04-2021,kallakurichi,267,56,14,0,309,10877,56,404,0,11337,10920,108
16-04-2021,kancheepuram,1502,303,137,2,1666,32683,303,4,0,32990,30849,475
16-04-2021,kanyakumari,667,122,59,1,729,18332,122,122,0,18576,17579,268
16-04-2021,karur,320,40,18,0,342,6005,40,46,0,6091,5697,52
16-04-2021,krishnagiri,918,167,46,1,1038,9464,162,189,5,9820,8662,120
16-04-2021,madurai,1723,167,116,1,1773,23718,166,166,1,24051,21804,474
16-04-2021,nagapattinam,1153,130,92,2,1189,10627,130,90,0,10847,9502,156
16-04-2021,namakkal,534,109,49,0,594,12726,109,106,0,12941,12236,111
16-04-2021,nilgiris,266,48,28,0,286,9026,48,39,0,9113,8776,51
16-04-2021,perambalur,44,14,5,0,53,2368,14,2,0,2384,2309,22
16-04-2021,pudukottai,381,47,23,0,405,12328,47,35,0,12410,11845,160
16-04-2021,ramanathapuram,245,22,12,0,255,6756,22,135,0,6913,6520,138
16-04-2021,ranipet,643,179,44,0,778,17221,179,49,0,17449,16481,190
16-04-2021,salem,1244,214,141,3,1314,34708,214,428,0,35350,33559,477
16-04-2021,sivagangai,400,45,32,1,412,7435,45,90,0,7570,7029,129
16-04-2021,tenkasi,530,74,61,0,543,9280,74,58,0,9412,8706,163
16-04-2021,thanjavur,1202,151,269,0,1084,21798,151,22,0,21971,20606,281
16-04-2021,theni,320,51,20,1,350,17675,51,45,0,17771,17213,208
16-04-2021,thirupathur,337,68,24,0,381,8132,66,115,2,8315,7806,128
16-04-2021,thiruvallur,2341,453,293,3,2498,49660,453,10,0,50123,46894,731
16-04-2021,thiruvannamalai,653,125,48,0,730,20138,125,398,0,20661,19643,288
16-04-2021,thiruvarur,768,121,71,0,818,13206,121,38,0,13365,12430,117
16-04-2021,thoothukudi,1098,277,21,0,1354,17471,277,273,0,18021,16523,144
16-04-2021,tirunelveli,1182,214,112,0,1284,17187,214,421,0,17822,16317,221
16-04-2021,tiruppur,1566,227,98,0,1695,21409,227,11,0,21647,19721,231
16-04-2021,trichy,1637,273,92,0,1818,17941,273,49,0,18263,16253,192
16-04-2021,vellore,760,167,142,1,784,21909,147,710,20,22786,21642,360
16-04-2021,villupuram,463,54,19,0,498,16001,54,174,0,16229,15617,114
16-04-2021,virudhunagar,368,80,14,1,433,17319,80,104,0,17503,16835,235
16-04-2021,airport surveillance (international),20,1,0,0,21,0,0,996,1,997,975,1
16-04-2021,airport surveillance (domestic),7,0,0,0,7,0,0,1065,0,1065,1057,1
16-04-2021,railway surveillance,0,0,0,0,0,0,0,428,0,428,428,0
17-04-2021,ariyalur,163,34,16,0,181,5016,34,20,0,5070,4840,49
17-04-2021,chengalpattu,5850,807,391,3,6263,64612,807,5,0,65424,58302,859
17-04-2021,chennai,22420,2884,1657,22,23625,277253,2884,47,0,280184,252173,4386
17-04-2021,coimbatore,4402,652,615,1,4438,65942,652,51,0,66645,61500,707
17-04-2021,cuddalore,1060,190,69,1,1180,27051,190,203,0,27444,25964,300
17-04-2021,dharmapuri,589,94,32,0,651,7246,94,214,0,7554,6846,57
17-04-2021,dindigul,776,121,73,0,824,12854,121,77,0,13052,12025,203
17-04-2021,erode,892,143,80,0,955,16478,143,94,0,16715,15608,152
17-04-2021,kallakurichi,309,32,9,0,332,10933,32,404,0,11369,10929,108
17-04-2021,kancheepuram,1666,248,155,1,1758,32986,248,4,0,33238,31004,476
17-04-2021,kanyakumari,729,191,64,2,854,18454,189,122,2,18767,17643,270
17-04-2021,karur,342,75,16,0,401,6045,75,46,0,6166,5713,52
17-04-2021,krishnagiri,1038,194,63,0,1169,9626,193,194,1,10014,8725,120
17-04-2021,madurai,1773,235,138,2,1868,23884,235,167,0,24286,21942,476
17-04-2021,nagapattinam,1189,78,102,0,1165,10757,78,90,0,10925,9604,156
17-04-2021,namakkal,594,126,52,0,668,12835,126,106,0,13067,12288,111
17-04-2021,nilgiris,286,47,25,0,308,9074,47,39,0,9160,8801,51
17-04-2021,perambalur,53,11,5,0,59,2382,11,2,0,2395,2314,22
17-04-2021,pudukottai,405,61,25,0,441,12375,61,35,0,12471,11870,160
17-04-2021,ramanathapuram,255,68,13,0,310,6778,68,135,0,6981,6533,138
17-04-2021,ranipet,778,193,48,0,923,17400,193,49,0,17642,16529,190
17-04-2021,salem,1314,289,149,2,1452,34922,289,428,0,35639,33708,479
17-04-2021,sivagangai,412,63,40,0,435,7480,62,90,1,7633,7069,129
17-04-2021,tenkasi,543,97,73,0,567,9354,97,58,0,9509,8779,163
17-04-2021,thanjavur,1084,121,188,1,1016,21949,121,22,0,22092,20794,282
17-04-2021,theni,350,86,23,0,413,17726,86,45,0,17857,17236,208
17-04-2021,thirupathur,381,81,25,0,437,8198,81,117,0,8396,7831,128
17-04-2021,thiruvallur,2498,389,312,0,2575,50113,389,10,0,50512,47206,731
17-04-2021,thiruvannamalai,730,122,59,0,793,20263,122,398,0,20783,19702,288
17-04-2021,thiruvarur,818,114,85,0,847,13327,114,38,0,13479,12515,117
17-04-2021,thoothukudi,1354,261,32,0,1583,17748,261,273,0,18282,16555,144
17-04-2021,tirunelveli,1284,246,123,0,1407,17401,246,421,0,18068,16440,221
17-04-2021,tiruppur,1695,275,104,0,1866,21636,275,11,0,21922,19825,231
17-04-2021,trichy,1818,323,125,3,2013,18214,323,49,0,18586,16378,195
17-04-2021,vellore,784,175,149,1,809,22056,149,730,26,22961,21791,361
17-04-2021,villupuram,498,106,83,0,521,16055,106,174,0,16335,15700,114
17-04-2021,virudhunagar,433,112,45,0,500,17399,112,104,0,17615,16880,235
17-04-2021,airport surveillance (international),21,0,0,0,21,0,0,997,0,997,975,1
17-04-2021,airport surveillance (domestic),7,0,0,0,7,0,0,1065,0,1065,1057,1
17-04-2021,railway surveillance,0,0,0,0,0,0,0,428,0,428,428,0
18-04-2021,ariyalur,183,31,20,0,194,5052,31,20,0,5103,4860,49
18-04-2021,chengalpattu,6324,954,394,6,6878,65481,954,5,0,66440,58696,866
18-04-2021,chennai,23575,3304,1852,16,25011,280085,3304,47,0,283436,254025,4400
18-04-2021,coimbatore,4460,727,608,0,4579,66616,727,51,0,67394,62108,707
18-04-2021,cuddalore,1177,183,88,2,1270,27238,183,203,0,27624,26052,302
18-04-2021,dharmapuri,645,115,74,0,686,7334,115,214,0,7663,6920,57
18-04-2021,dindigul,824,195,88,1,930,12975,195,77,0,13247,12113,204
18-04-2021,erode,936,226,71,0,1091,16602,226,94,0,16922,15679,152
18-04-2021,kallakurichi,337,61,47,0,351,10970,61,404,0,11435,10976,108
18-04-2021,kancheepuram,1732,332,175,4,1885,33208,332,4,0,33544,31179,480
18-04-2021,kanyakumari,857,153,177,2,831,18646,153,124,0,18923,17820,272
18-04-2021,karur,406,80,23,0,463,6125,80,46,0,6251,5736,52
18-04-2021,krishnagiri,1175,227,62,0,1340,9825,227,195,0,10247,8787,120
18-04-2021,madurai,1866,276,130,2,2010,24117,275,167,1,24560,22072,478
18-04-2021,nagapattinam,1174,219,121,2,1270,10844,219,90,0,11153,9725,158
18-04-2021,namakkal,671,147,60,0,758,12964,147,106,0,13217,12348,111
18-04-2021,nilgiris,308,43,29,0,322,9121,43,39,0,9203,8830,51
18-04-2021,perambalur,57,5,12,0,50,2391,5,2,0,2398,2326,22
18-04-2021,pudukottai,445,57,24,0,478,12440,57,35,0,12532,11894,160
18-04-2021,ramanathapuram,309,58,31,0,336,6845,58,135,0,7038,6564,138
18-04-2021,ranipet,919,114,94,0,939,17589,114,49,0,17752,16623,190
18-04-2021,salem,1457,275,186,0,1546,35216,275,428,0,35919,33894,479
18-04-2021,sivagangai,428,54,34,0,448,7535,51,91,3,7680,7103,129
18-04-2021,tenkasi,567,125,14,1,677,9451,125,58,0,9634,8793,164
18-04-2021,thanjavur,1010,175,228,1,956,22064,175,22,0,22261,21022,283
18-04-2021,theni,417,92,48,0,461,17816,92,45,0,17953,17284,208
18-04-2021,thirupathur,439,59,29,0,469,8281,59,117,0,8457,7860,128
18-04-2021,thiruvallur,2583,503,316,2,2768,50511,503,10,0,51024,47522,734
18-04-2021,thiruvannamalai,801,153,49,0,905,20393,153,398,0,20944,19751,288
18-04-2021,thiruvarur,850,119,92,0,877,13444,119,38,0,13601,12607,117
18-04-2021,thoothukudi,1569,252,90,1,1730,17995,252,273,0,18520,16645,145
18-04-2021,tirunelveli,1411,309,91,1,1628,17651,309,421,0,18381,16531,222
18-04-2021,tiruppur,1854,307,131,0,2030,21899,307,11,0,22217,19956,231
18-04-2021,trichy,2000,311,227,1,2083,18524,309,49,2,18884,16605,196
18-04-2021,vellore,809,229,79,0,959,22205,207,756,22,23190,21870,361
18-04-2021,villupuram,530,129,68,0,591,16170,129,174,0,16473,15768,114
18-04-2021,virudhunagar,502,123,59,0,566,17513,123,104,0,17740,16939,235
18-04-2021,airport surveillance (international),21,0,4,0,17,0,0,997,0,997,979,1
18-04-2021,airport surveillance (domestic),7,1,0,0,8,0,0,1065,1,1066,1057,1
18-04-2021,railway surveillance,0,0,0,0,0,0,0,428,0,428,428,0
19-04-2021,ariyalur,190,26,23,0,193,5079,26,20,0,5125,4883,49
19-04-2021,chengalpattu,6948,970,725,6,7187,66505,970,5,0,67480,59421,872
19-04-2021,chennai,24797,3347,1935,15,26194,283175,3347,47,0,286569,255960,4415
19-04-2021,coimbatore,4587,735,618,1,4703,67351,735,51,0,68137,62726,708
19-04-2021,cuddalore,1274,200,47,3,1424,27425,200,203,0,27828,26099,305
19-04-2021,dharmapuri,687,146,87,0,746,7450,146,214,0,7810,7007,57
19-04-2021,dindigul,931,160,147,0,944,13171,160,77,0,13408,12260,204
19-04-2021,erode,1084,248,106,0,1226,16821,248,94,0,17163,15785,152
19-04-2021,kallakurichi,349,121,23,0,447,11029,121,404,0,11554,10999,108
19-04-2021,kancheepuram,1901,240,100,3,2038,33556,240,4,0,33800,31279,483
19-04-2021,kanyakumari,829,157,52,2,932,18797,157,124,0,19078,17872,274
19-04-2021,karur,463,76,38,0,501,6205,76,46,0,6327,5774,52
19-04-2021,krishnagiri,1343,287,130,0,1500,10055,282,195,5,10537,8917,120
19-04-2021,madurai,2014,328,107,2,2233,24395,328,168,0,24891,22179,479
19-04-2021,nagapattinam,1273,125,144,0,1254,11066,125,90,0,11281,9869,158
19-04-2021,namakkal,761,124,81,0,804,13114,124,106,0,13344,12429,111
19-04-2021,nilgiris,322,30,33,0,319,9164,28,39,2,9233,8863,51
19-04-2021,perambalur,53,8,9,0,52,2399,7,2,1,2409,2335,22
19-04-2021,pudukottai,480,84,42,0,522,12499,84,35,0,12618,11936,160
19-04-2021,ramanathapuram,343,39,23,0,359,6910,39,135,0,7084,6587,138
19-04-2021,ranipet,946,169,92,0,1023,17710,169,49,0,17928,16715,190
19-04-2021,salem,1551,359,164,2,1744,35496,359,428,0,36283,34058,481
19-04-2021,sivagangai,454,33,42,0,445,7592,33,94,0,7719,7145,129
19-04-2021,tenkasi,680,162,13,1,828,9579,162,58,0,9799,8806,165
19-04-2021,thanjavur,958,217,210,2,963,22241,217,22,0,22480,21232,285
19-04-2021,theni,460,81,39,0,502,17907,81,45,0,18033,17323,208
19-04-2021,thirupathur,470,105,37,1,537,8341,105,117,0,8563,7897,129
19-04-2021,thiruvallur,2812,535,313,1,3033,51058,535,10,0,51603,47835,735
19-04-2021,thiruvannamalai,912,170,73,2,1007,20553,170,398,0,21121,19824,290
19-04-2021,thiruvarur,878,90,98,0,870,13564,90,38,0,13692,12705,117
19-04-2021,thoothukudi,1745,288,80,0,1953,18262,288,273,0,18823,16725,145
19-04-2021,tirunelveli,1611,286,19,2,1876,17943,286,421,0,18650,16550,224
19-04-2021,tiruppur,2033,296,147,0,2182,22209,296,11,0,22516,20103,231
19-04-2021,trichy,2098,303,188,1,2212,18848,302,51,1,19202,16793,197
19-04-2021,vellore,958,167,71,0,1054,22411,154,778,13,23356,21941,361
19-04-2021,villupuram,599,110,53,0,656,16307,110,174,0,16591,15821,114
19-04-2021,virudhunagar,572,116,63,0,625,17643,116,104,0,17863,17002,236
19-04-2021,airport surveillance (international),17,2,0,0,19,0,0,997,2,999,979,1
19-04-2021,airport surveillance (domestic),8,1,0,0,9,0,0,1066,1,1067,1057,1
19-04-2021,railway surveillance,0,0,0,0,0,0,0,428,0,428,428,0
20-04-2021,ariyalur,193,20,20,0,193,5105,20,20,0,5145,4903,49
20-04-2021,chengalpattu,7204,1029,656,3,7574,67492,1029,5,0,68526,60077,875
20-04-2021,chennai,26278,3711,1967,17,28005,286606,3711,47,0,290364,257927,4432
20-04-2021,coimbatore,4715,686,559,0,4842,68098,686,51,0,68835,63285,708
20-04-2021,cuddalore,1425,156,207,3,1371,27626,156,203,0,27985,26306,308
20-04-2021,dharmapuri,745,179,97,1,826,7595,179,214,0,7988,7104,58
20-04-2021,dindigul,935,147,61,1,1020,13322,147,77,0,13546,12321,205
20-04-2021,erode,1213,226,75,0,1364,17056,226,94,0,17376,15860,152
20-04-2021,kallakurichi,446,27,22,0,451,11149,27,404,0,11580,11021,108
20-04-2021,kancheepuram,2018,295,128,3,2182,33776,295,4,0,34075,31407,486
20-04-2021,kanyakumari,931,205,34,2,1100,18953,205,124,0,19282,17906,276
20-04-2021,karur,503,66,41,0,528,6283,66,46,0,6395,5815,52
20-04-2021,krishnagiri,1497,185,133,0,1549,10334,184,200,1,10719,9050,120
20-04-2021,madurai,2238,366,233,2,2369,24728,366,168,0,25262,22412,481
20-04-2021,nagapattinam,1252,114,146,2,1218,11189,114,90,0,11393,10015,160
20-04-2021,namakkal,806,190,73,1,922,13240,190,106,0,13536,12502,112
20-04-2021,nilgiris,318,42,36,0,324,9191,42,41,0,9274,8899,51
20-04-2021,perambalur,53,3,5,0,51,2407,3,3,0,2413,2340,22
20-04-2021,pudukottai,524,88,68,0,544,12585,88,35,0,12708,12004,160
20-04-2021,ramanathapuram,361,41,25,0,377,6951,41,135,0,7127,6612,138
20-04-2021,ranipet,1025,109,83,0,1051,17881,109,49,0,18039,16798,190
20-04-2021,salem,1745,383,108,1,2019,35856,382,428,1,36667,34166,482
20-04-2021,sivagangai,423,64,56,0,431,7603,61,94,3,7761,7201,129
20-04-2021,tenkasi,827,105,29,0,903,9740,105,58,0,9903,8835,165
20-04-2021,thanjavur,961,190,160,2,989,22456,190,22,0,22668,21392,287
20-04-2021,theni,502,163,48,0,617,17988,163,45,0,18196,17371,208
20-04-2021,thirupathur,540,84,35,0,589,8449,83,117,1,8650,7932,129
20-04-2021,thiruvallur,3002,508,86,5,3419,51562,508,10,0,52080,47921,740
20-04-2021,thiruvannamalai,1008,102,138,1,971,20724,102,398,0,21224,19962,291
20-04-2021,thiruvarur,874,120,94,0,900,13658,120,38,0,13816,12799,117
20-04-2021,thoothukudi,1954,170,117,0,2007,18551,170,273,0,18994,16842,145
20-04-2021,tirunelveli,1875,269,189,1,1954,18228,269,421,0,18918,16739,225
20-04-2021,tiruppur,2179,216,159,1,2235,22502,216,11,0,22729,20262,232
20-04-2021,trichy,2186,312,161,0,2337,19124,309,52,3,19488,16954,197
20-04-2021,vellore,1055,213,104,1,1163,22566,168,791,45,23570,22045,362
20-04-2021,villupuram,652,55,66,0,641,16413,55,174,0,16642,15887,114
20-04-2021,virudhunagar,625,146,19,1,751,17759,146,104,0,18009,17021,237
20-04-2021,airport surveillance (international),19,1,11,0,9,0,0,999,1,1000,990,1
20-04-2021,airport surveillance (domestic),9,0,1,0,8,0,0,1067,0,1067,1058,1
20-04-2021,railway surveillance,0,0,0,0,0,0,0,428,0,428,428,0
21-04-2021,ariyalur,189,43,20,2,210,5121,43,20,0,5184,4923,51
21-04-2021,chengalpattu,7565,947,712,5,7795,68512,947,5,0,69464,60789,880
21-04-2021,chennai,27964,3750,2440,18,29256,290276,3750,47,0,294073,260367,4450
21-04-2021,coimbatore,4855,715,457,1,5112,68797,715,51,0,69563,63742,709
21-04-2021,cuddalore,1377,147,163,3,1358,27788,147,203,0,28138,26469,311
21-04-2021,dharmapuri,826,83,43,0,866,7774,83,214,0,8071,7147,58
21-04-2021,dindigul,1010,185,88,0,1107,13459,185,77,0,13721,12409,205
21-04-2021,erode,1355,284,87,0,1552,17273,284,94,0,17651,15947,152
21-04-2021,kallakurichi,448,38,41,0,445,11173,38,404,0,11615,11062,108
21-04-2021,kancheepuram,2174,263,346,6,2085,34063,263,4,0,34330,31753,492
21-04-2021,kanyakumari,1101,171,89,4,1179,19159,171,124,0,19454,17995,280
21-04-2021,karur,533,85,43,0,575,6354,85,46,0,6485,5858,52
21-04-2021,krishnagiri,1549,259,115,1,1692,10518,258,201,1,10978,9165,121
21-04-2021,madurai,2368,462,282,1,2547,25093,462,168,0,25723,22694,482
21-04-2021,nagapattinam,1222,95,137,1,1179,11307,95,90,0,11492,10152,161
21-04-2021,namakkal,923,200,59,0,1064,13431,200,106,0,13737,12561,112
21-04-2021,nilgiris,324,65,29,0,360,9233,65,41,0,9339,8928,51
21-04-2021,perambalur,51,10,0,0,61,2410,10,3,0,2423,2340,22
21-04-2021,pudukottai,545,62,45,0,562,12674,62,35,0,12771,12049,160
21-04-2021,ramanathapuram,378,59,24,0,413,6993,59,135,0,7187,6636,138
21-04-2021,ranipet,1048,203,73,0,1178,17987,203,49,0,18239,16871,190
21-04-2021,salem,2023,401,146,2,2276,36242,401,429,0,37072,34312,484
21-04-2021,sivagangai,430,61,69,0,422,7663,61,97,0,7821,7270,129
21-04-2021,tenkasi,906,115,22,1,998,9848,115,58,0,10021,8857,166
21-04-2021,thanjavur,981,179,102,0,1058,22638,179,22,0,22839,21494,287
21-04-2021,theni,617,148,39,1,725,18151,148,45,0,18344,17410,209
21-04-2021,thirupathur,593,95,30,0,658,8536,95,118,0,8749,7962,129
21-04-2021,thiruvallur,3453,529,249,0,3733,52104,529,10,0,52643,48170,740
21-04-2021,thiruvannamalai,979,135,152,0,962,20834,135,398,0,21367,20114,291
21-04-2021,thiruvarur,901,99,105,0,895,13779,99,38,0,13916,12904,117
21-04-2021,thoothukudi,2012,275,197,0,2090,18726,275,273,0,19274,17039,145
21-04-2021,tirunelveli,1937,426,75,1,2287,18480,420,421,6,19327,16814,226
21-04-2021,tiruppur,2241,238,244,1,2234,22724,238,11,0,22973,20506,233
21-04-2021,trichy,2344,357,187,2,2512,19440,356,55,1,19852,17141,199
21-04-2021,vellore,1167,286,107,3,1343,22738,225,836,61,23860,22152,365
21-04-2021,villupuram,643,109,27,0,725,16470,109,174,0,16753,15914,114
21-04-2021,virudhunagar,755,101,27,0,829,17909,101,104,0,18114,17048,237
21-04-2021,airport surveillance (international),9,0,0,0,9,0,0,1000,0,1000,990,1
21-04-2021,airport surveillance (domestic),8,1,0,0,9,0,0,1067,1,1068,1058,1
21-04-2021,railway surveillance,0,0,0,0,0,0,0,428,0,428,428,0
22-04-2021,ariyalur,211,47,20,0,238,5165,47,20,0,5232,4943,51
22-04-2021,chengalpattu,7862,906,813,5,7950,69526,906,5,0,70437,61602,885
22-04-2021,chennai,29208,3789,2572,24,30401,293978,3789,47,0,297814,262939,4474
22-04-2021,coimbatore,5122,689,460,1,5350,69522,689,51,0,70262,64202,710
22-04-2021,cuddalore,1350,178,77,1,1450,27927,178,203,0,28308,26546,312
22-04-2021,dharmapuri,863,86,89,3,857,7854,86,214,0,8154,7236,61
22-04-2021,dindigul,1102,212,128,1,1185,13639,212,77,0,13928,12537,206
22-04-2021,erode,1550,225,86,0,1689,17555,225,94,0,17874,16033,152
22-04-2021,kallakurichi,445,78,35,0,488,11211,78,404,0,11693,11097,108
22-04-2021,kancheepuram,2057,392,328,0,2121,34298,392,4,0,34694,32081,492
22-04-2021,kanyakumari,1179,220,66,2,1331,19330,220,124,0,19674,18061,282
22-04-2021,karur,579,84,39,0,624,6443,84,46,0,6573,5897,52
22-04-2021,krishnagiri,1693,318,89,1,1921,10777,318,202,0,11297,9254,122
22-04-2021,madurai,2554,495,266,5,2778,25562,494,168,1,26225,22960,487
22-04-2021,nagapattinam,1176,201,97,2,1278,11399,201,90,0,11690,10249,163
22-04-2021,namakkal,1065,223,77,0,1211,13632,223,106,0,13961,12638,112
22-04-2021,nilgiris,360,48,21,0,387,9298,48,41,0,9387,8949,51
22-04-2021,perambalur,61,17,3,1,74,2420,17,3,0,2440,2343,23
22-04-2021,pudukottai,565,77,43,0,599,12739,77,35,0,12851,12092,160
22-04-2021,ramanathapuram,413,87,32,0,468,7052,87,135,0,7274,6668,138
22-04-2021,ranipet,1174,179,115,0,1238,18186,179,49,0,18414,16986,190
22-04-2021,salem,2282,411,160,1,2532,36649,411,429,0,37489,34472,485
22-04-2021,sivagangai,414,53,39,0,428,7716,53,97,0,7866,7309,129
22-04-2021,tenkasi,996,281,74,1,1202,9961,281,58,0,10300,8931,167
22-04-2021,thanjavur,1057,283,67,1,1272,22816,283,22,0,23121,21561,288
22-04-2021,theni,715,160,35,0,840,18289,160,45,0,18494,17445,209
22-04-2021,thirupathur,661,139,37,1,762,8634,139,118,0,8891,7999,130
22-04-2021,thiruvallur,3738,510,352,4,3892,52638,510,10,0,53158,48522,744
22-04-2021,thiruvannamalai,970,201,122,1,1048,20977,201,398,0,21576,20236,292
22-04-2021,thiruvarur,897,102,105,0,894,13880,102,38,0,14020,13009,117
22-04-2021,thoothukudi,2095,354,198,1,2250,19006,354,273,0,19633,17237,146
22-04-2021,tirunelveli,2290,449,199,1,2539,18903,449,427,0,19779,17013,227
22-04-2021,tiruppur,2228,224,265,1,2186,22956,224,11,0,23191,20771,234
22-04-2021,trichy,2518,359,193,0,2684,19802,359,56,0,20217,17334,199
22-04-2021,vellore,1331,303,116,1,1517,22951,268,897,35,24151,22268,366
22-04-2021,villupuram,733,146,86,0,793,16587,146,174,0,16907,16000,114
22-04-2021,virudhunagar,829,126,22,0,933,18010,126,104,0,18240,17070,237
22-04-2021,airport surveillance (international),9,0,0,0,9,0,0,1000,0,1000,990,1
22-04-2021,airport surveillance (domestic),9,0,0,0,9,0,0,1068,0,1068,1058,1
22-04-2021,railway surveillance,0,0,0,0,0,0,0,428,0,428,428,0
23-04-2021,ariyalur,240,46,13,0,273,5214,46,20,0,5280,4956,51
23-04-2021,chengalpattu,8002,985,791,10,8186,70484,985,5,0,71474,62393,895
23-04-2021,chennai,30285,3842,2920,37,31170,297652,3842,47,0,301541,265859,4512
23-04-2021,coimbatore,5360,889,419,0,5830,70221,889,51,0,71161,64621,710
23-04-2021,cuddalore,1449,209,190,2,1466,28104,209,203,0,28516,26736,314
23-04-2021,dharmapuri,856,121,84,1,892,7939,121,214,0,8274,7320,62
23-04-2021,dindigul,1197,227,111,1,1312,13863,227,77,0,14167,12648,207
23-04-2021,erode,1681,331,93,1,1918,17772,331,94,0,18197,16126,153
23-04-2021,kallakurichi,487,72,25,0,534,11288,72,404,0,11764,11122,108
23-04-2021,kancheepuram,2091,395,182,4,2300,34660,395,4,0,35059,32263,496
23-04-2021,kanyakumari,1318,218,81,4,1451,19537,218,124,0,19879,18142,286
23-04-2021,karur,623,105,52,0,676,6526,105,46,0,6677,5949,52
23-04-2021,krishnagiri,1923,370,130,1,2162,11097,370,202,0,11669,9384,123
23-04-2021,madurai,2780,502,220,0,3062,26057,502,169,0,26728,23180,486
23-04-2021,nagapattinam,1285,170,156,0,1299,11607,170,90,0,11867,10405,163
23-04-2021,namakkal,1213,195,95,0,1313,13857,195,106,0,14158,12733,112
23-04-2021,nilgiris,385,54,39,0,400,9344,54,41,0,9439,8988,51
23-04-2021,perambalur,73,10,3,0,80,2436,10,3,0,2449,2346,23
23-04-2021,pudukottai,601,104,51,0,654,12818,104,35,0,12957,12143,160
23-04-2021,ramanathapuram,470,94,52,2,510,7141,94,135,0,7370,6720,140
23-04-2021,ranipet,1238,228,81,0,1385,18365,228,49,0,18642,17067,190
23-04-2021,salem,2545,478,135,2,2886,37073,478,429,0,37980,34607,487
23-04-2021,sivagangai,431,76,36,0,471,7772,76,97,0,7945,7345,129
23-04-2021,tenkasi,1207,173,120,2,1258,10247,173,58,0,10478,9051,169
23-04-2021,thanjavur,1273,333,82,2,1522,23100,333,22,0,23455,21643,290
23-04-2021,theni,841,184,31,0,994,18451,184,45,0,18680,17476,210
23-04-2021,thirupathur,762,148,57,1,852,8773,148,118,0,9039,8056,131
23-04-2021,thiruvallur,3940,807,477,4,4266,53195,807,10,0,54012,48999,747
23-04-2021,thiruvannamalai,1053,176,52,0,1177,21183,176,398,0,21757,20288,292
23-04-2021,thiruvarur,891,128,126,0,893,13979,128,38,0,14145,13135,117
23-04-2021,thoothukudi,2282,371,189,0,2464,19392,371,273,0,20036,17426,146
23-04-2021,tirunelveli,2509,517,181,0,2845,19322,517,427,0,20266,17194,227
23-04-2021,tiruppur,2178,295,303,0,2170,23172,295,11,0,23478,21074,234
23-04-2021,trichy,2688,320,215,1,2792,20165,320,56,0,20541,17549,200
23-04-2021,vellore,1520,297,94,2,1721,23222,253,932,44,24451,22362,368
23-04-2021,villupuram,795,160,56,1,898,16735,160,174,0,17069,16056,115
23-04-2021,virudhunagar,938,146,134,0,950,18141,146,104,0,18391,17204,237
23-04-2021,airport surveillance (international),9,0,1,0,8,0,0,1000,0,1000,991,1
23-04-2021,airport surveillance (domestic),9,0,1,0,8,0,0,1068,0,1068,1059,1
23-04-2021,railway surveillance,0,0,0,0,0,0,0,428,0,428,428,0
24-04-2021,ariyalur,271,33,33,0,271,5258,33,20,0,5311,4989,51
24-04-2021,chengalpattu,8255,1163,703,7,8708,71538,1163,5,0,72706,63096,902
24-04-2021,chennai,31112,4086,3667,25,31506,301437,4086,47,0,305570,269526,4538
24-04-2021,coimbatore,5839,1004,403,3,6437,71119,1004,51,0,72174,65024,713
24-04-2021,cuddalore,1466,205,178,0,1493,28313,205,203,0,28721,26914,314
24-04-2021,dharmapuri,898,182,84,1,995,8066,182,214,0,8462,7404,63
24-04-2021,dindigul,1306,269,100,1,1474,14084,269,77,0,14430,12748,208
24-04-2021,erode,1916,392,188,0,2120,18101,392,94,0,18587,16314,153
24-04-2021,kallakurichi,534,77,75,0,536,11360,77,404,0,11841,11197,108
24-04-2021,kancheepuram,2289,454,100,4,2639,35042,454,4,0,35500,32363,498
24-04-2021,kanyakumari,1453,224,188,3,1486,19757,224,124,0,20105,18330,289
24-04-2021,karur,677,119,52,1,743,6632,119,46,0,6797,6001,53
24-04-2021,krishnagiri,2164,319,164,0,2319,11469,317,202,2,11990,9548,123
24-04-2021,madurai,3070,596,236,5,3425,26567,596,169,0,27332,23416,491
24-04-2021,nagapattinam,1305,113,175,1,1242,11784,113,90,0,11987,10580,165
24-04-2021,namakkal,1318,216,113,1,1420,14057,216,106,0,14379,12846,113
24-04-2021,nilgiris,402,84,41,0,445,9400,84,41,0,9525,9029,51
24-04-2021,perambalur,80,19,13,0,86,2446,19,3,0,2468,2359,23
24-04-2021,pudukottai,655,93,65,0,683,12923,93,35,0,13051,12208,160
24-04-2021,ramanathapuram,511,105,51,0,565,7236,105,135,0,7476,6771,140
24-04-2021,ranipet,1388,248,50,2,1584,18596,248,49,0,18893,17117,192
24-04-2021,salem,2890,490,199,2,3179,37555,489,429,1,38474,34806,489
24-04-2021,sivagangai,454,91,56,1,488,7831,91,97,0,8019,7401,130
24-04-2021,tenkasi,1271,160,170,2,1259,10433,160,58,0,10651,9221,171
24-04-2021,thanjavur,1522,310,70,0,1762,23433,310,22,0,23765,21713,290
24-04-2021,theni,994,137,64,1,1066,18635,137,45,0,18817,17540,211
24-04-2021,thirupathur,848,110,72,3,883,8917,110,118,0,9145,8128,134
24-04-2021,thiruvallur,4251,793,475,7,4562,53987,793,10,0,54790,49474,754
24-04-2021,thiruvannamalai,1192,377,94,1,1474,21374,377,398,0,22149,20382,293
24-04-2021,thiruvarur,890,163,125,0,928,14104,163,38,0,14305,13260,117
24-04-2021,thoothukudi,2484,388,238,1,2633,19783,388,273,0,20444,17664,147
24-04-2021,tirunelveli,2804,525,230,2,3097,19798,525,427,0,20750,17424,229
24-04-2021,tiruppur,2174,316,197,0,2293,23471,316,11,0,23798,21271,234
24-04-2021,trichy,2772,302,243,2,2829,20465,302,56,0,20823,17792,202
24-04-2021,vellore,1720,305,65,3,1957,23474,266,976,39,24755,22427,371
24-04-2021,villupuram,901,205,63,1,1042,16898,205,174,0,17277,16119,116
24-04-2021,virudhunagar,956,168,95,0,1029,18293,168,104,0,18565,17299,237
24-04-2021,airport surveillance (international),8,0,2,0,6,0,0,1000,0,1000,993,1
24-04-2021,airport surveillance (domestic),8,1,5,0,4,0,0,1068,1,1069,1064,1
24-04-2021,railway surveillance,0,0,0,0,0,0,0,428,0,428,428,0
25-04-2021,ariyalur,268,49,30,0,287,5288,49,20,0,5357,5019,51
25-04-2021,chengalpattu,8621,1242,1028,9,8826,72614,1242,5,0,73861,64124,911
25-04-2021,chennai,31630,4206,4271,30,31535,305646,4206,47,0,309899,273797,4567
25-04-2021,coimbatore,6444,1038,724,1,6757,72130,1038,51,0,73219,65748,714
25-04-2021,cuddalore,1486,218,190,1,1513,28511,218,203,0,28932,27104,315
25-04-2021,dharmapuri,995,106,93,0,1008,8248,106,214,0,8568,7497,63
25-04-2021,dindigul,1469,228,121,0,1576,14348,228,77,0,14653,12869,208
25-04-2021,erode,2120,313,212,1,2220,18493,313,94,0,18900,16526,154
25-04-2021,kallakurichi,536,129,57,0,608,11437,129,404,0,11970,11254,108
25-04-2021,kancheepuram,2639,558,292,1,2904,35496,558,4,0,36058,32655,499
25-04-2021,kanyakumari,1486,301,206,0,1581,19981,301,124,0,20406,18536,289
25-04-2021,karur,740,116,45,0,811,6748,116,46,0,6910,6046,53
25-04-2021,krishnagiri,2320,270,171,2,2417,11787,270,204,0,12261,9719,125
25-04-2021,madurai,3426,603,304,5,3720,27164,603,169,0,27936,23720,496
25-04-2021,nagapattinam,1239,187,131,1,1294,11894,187,90,0,12171,10711,166
25-04-2021,namakkal,1421,208,127,1,1501,14274,208,106,0,14588,12973,114
25-04-2021,nilgiris,445,79,46,0,478,9484,79,41,0,9604,9075,51
25-04-2021,perambalur,87,15,12,0,90,2466,15,3,0,2484,2371,23
25-04-2021,pudukottai,683,116,75,0,724,13016,116,35,0,13167,12283,160
25-04-2021,ramanathapuram,564,120,76,1,607,7340,120,135,0,7595,6847,141
25-04-2021,ranipet,1586,285,175,2,1694,18846,285,49,0,19180,17292,194
25-04-2021,salem,3179,511,288,1,3401,38044,509,430,2,38985,35094,490
25-04-2021,sivagangai,483,75,65,0,493,7917,75,97,0,8089,7466,130
25-04-2021,tenkasi,1259,261,112,1,1407,10593,261,58,0,10912,9333,172
25-04-2021,thanjavur,1762,303,119,2,1944,23743,303,22,0,24068,21832,292
25-04-2021,theni,1062,184,85,0,1161,18768,184,45,0,18997,17625,211
25-04-2021,thirupathur,882,100,97,1,884,9026,100,118,0,9244,8225,135
25-04-2021,thiruvallur,4532,885,433,6,4978,54751,885,10,0,55646,49907,761
25-04-2021,thiruvannamalai,1473,370,134,2,1707,21750,370,398,0,22518,20516,295
25-04-2021,thiruvarur,932,146,101,1,976,14271,146,38,0,14455,13361,118
25-04-2021,thoothukudi,2636,432,254,2,2812,20174,432,273,0,20879,17918,149
25-04-2021,tirunelveli,3097,549,175,0,3471,20323,549,427,0,21299,17599,229
25-04-2021,tiruppur,2293,376,265,0,2404,23787,376,11,0,24174,21536,234
25-04-2021,trichy,2831,343,276,4,2894,20769,343,56,0,21168,18068,206
25-04-2021,vellore,1961,341,109,3,2190,23744,310,1015,31,25100,22536,374
25-04-2021,villupuram,1042,203,101,2,1142,17103,203,174,0,17480,16220,118
25-04-2021,virudhunagar,1029,193,64,2,1156,18461,193,104,0,18758,17363,239
25-04-2021,airport surveillance (international),6,0,1,0,5,0,0,1000,0,1000,994,1
25-04-2021,airport surveillance (domestic),4,0,0,0,4,0,0,1069,0,1069,1064,1
25-04-2021,railway surveillance,0,0,0,0,0,0,0,428,0,428,428,0
26-04-2021,ariyalur,286,43,27,0,302,5336,43,20,0,5399,5046,51
26-04-2021,chengalpattu,8855,1142,1145,4,8848,73885,1142,5,0,75032,65269,915
26-04-2021,chennai,31460,4250,4533,35,31142,309777,4250,47,0,314074,278330,4602
26-04-2021,coimbatore,6770,1056,1135,2,6689,73181,1056,51,0,74288,66883,716
26-04-2021,cuddalore,1513,241,180,1,1573,28729,241,203,0,29173,27284,316
26-04-2021,dharmapuri,1008,153,115,1,1045,8354,153,214,0,8721,7612,64
26-04-2021,dindigul,1573,199,187,0,1585,14573,199,77,0,14849,13056,208
26-04-2021,erode,2209,515,239,2,2483,18795,515,94,0,19404,16765,156
26-04-2021,kallakurichi,609,170,80,1,698,11567,170,404,0,12141,11334,109
26-04-2021,kancheepuram,2905,432,535,9,2793,36055,432,4,0,36491,33190,508
26-04-2021,kanyakumari,1581,268,160,2,1687,20282,268,124,0,20674,18696,291
26-04-2021,karur,814,114,153,1,774,6867,114,46,0,7027,6199,54
26-04-2021,krishnagiri,2418,483,327,0,2574,12058,476,204,7,12745,10046,125
26-04-2021,madurai,3720,524,311,4,3929,27767,523,169,1,28460,24031,500
26-04-2021,nagapattinam,1300,177,270,1,1206,12087,175,90,2,12354,10981,167
26-04-2021,namakkal,1501,264,150,0,1615,14482,264,106,0,14852,13123,114
26-04-2021,nilgiris,478,57,47,0,488,9563,57,41,0,9661,9122,51
26-04-2021,perambalur,90,24,13,1,100,2481,24,3,0,2508,2384,24
26-04-2021,pudukottai,725,123,93,0,755,13133,123,35,0,13291,12376,160
26-04-2021,ramanathapuram,610,150,73,0,687,7463,150,135,0,7748,6920,141
26-04-2021,ranipet,1692,232,251,0,1673,19129,232,49,0,19410,17543,194
26-04-2021,salem,3402,428,381,5,3444,38554,428,432,0,39414,35475,495
26-04-2021,sivagangai,489,106,75,0,520,7988,102,97,4,8191,7541,130
26-04-2021,tenkasi,1405,246,149,2,1500,10852,246,58,0,11156,9482,174
26-04-2021,thanjavur,1944,300,172,4,2068,24046,300,22,0,24368,22004,296
26-04-2021,theni,1162,162,132,0,1192,18953,162,45,0,19160,17757,211
26-04-2021,thirupathur,885,153,112,1,925,9127,153,118,0,9398,8337,136
26-04-2021,thiruvallur,4974,838,546,4,5262,55632,838,10,0,56480,50453,765
26-04-2021,thiruvannamalai,1720,325,188,2,1855,22133,325,398,0,22856,20704,297
26-04-2021,thiruvarur,980,75,131,2,922,14421,75,38,0,14534,13492,120
26-04-2021,thoothukudi,2820,503,409,2,2912,20614,503,273,0,21390,18327,151
26-04-2021,tirunelveli,3474,436,255,1,3654,20875,436,427,0,21738,17854,230
26-04-2021,tiruppur,2407,385,277,0,2515,24166,385,11,0,24562,21813,234
26-04-2021,trichy,2891,398,324,3,2962,21109,396,56,2,21563,18392,209
26-04-2021,vellore,2199,288,220,3,2264,24063,286,1046,2,25397,22756,377
26-04-2021,villupuram,1145,197,133,1,1208,17309,197,174,0,17680,16353,119
26-04-2021,virudhunagar,1157,227,91,0,1293,18655,227,104,0,18986,17454,239
26-04-2021,airport surveillance (international),5,0,3,0,2,0,0,1000,0,1000,997,1
26-04-2021,airport surveillance (domestic),4,0,3,0,1,0,0,1069,0,1069,1067,1
26-04-2021,railway surveillance,0,0,0,0,0,0,0,428,0,428,428,0
27-04-2021,ariyalur,308,22,31,1,298,5385,22,20,0,5427,5077,52
27-04-2021,chengalpattu,8910,1181,1475,8,8608,75089,1181,5,0,76275,66744,923
27-04-2021,chennai,31042,4640,4519,27,31136,313927,4640,47,0,318614,282849,4629
27-04-2021,coimbatore,6698,996,745,1,6948,74246,996,51,0,75293,67628,717
27-04-2021,cuddalore,1568,195,310,3,1450,28965,195,203,0,29363,27594,319
27-04-2021,dharmapuri,1044,179,145,0,1078,8506,179,214,0,8899,7757,64
27-04-2021,dindigul,1586,180,150,0,1616,14773,180,77,0,15030,13206,208
27-04-2021,erode,2476,414,233,1,2656,19303,414,94,0,19811,16998,157
27-04-2021,kallakurichi,700,84,135,0,649,11739,84,404,0,12227,11469,109
27-04-2021,kancheepuram,2791,301,275,7,2810,36485,301,4,0,36790,33465,515
27-04-2021,kanyakumari,1686,322,156,3,1849,20549,322,124,0,20995,18852,294
27-04-2021,karur,773,95,81,1,786,6980,95,46,0,7121,6280,55
27-04-2021,krishnagiri,2577,426,382,1,2620,12537,425,211,1,13174,10428,126
27-04-2021,madurai,3935,539,399,2,4073,28296,538,170,1,29005,24430,502
27-04-2021,nagapattinam,1199,358,162,0,1395,12255,358,92,0,12705,11143,167
27-04-2021,namakkal,1620,238,128,0,1730,14751,238,106,0,15095,13251,114
27-04-2021,nilgiris,488,43,72,0,459,9620,43,41,0,9704,9194,51
27-04-2021,perambalur,100,32,8,0,124,2505,32,3,0,2540,2392,24
27-04-2021,pudukottai,762,65,85,0,742,13263,65,35,0,13363,12461,160
27-04-2021,ramanathapuram,680,74,46,1,707,7606,74,135,0,7815,6966,142
27-04-2021,ranipet,1673,272,230,0,1715,19363,272,49,0,19684,17773,196
27-04-2021,salem,3447,456,362,5,3536,38985,455,432,1,39873,35837,500
27-04-2021,sivagangai,513,80,28,0,565,8083,80,101,0,8264,7569,130
27-04-2021,tenkasi,1497,128,156,0,1469,11095,128,58,0,11281,9638,174
27-04-2021,thanjavur,2067,211,213,2,2063,24345,211,22,0,24578,22217,298
27-04-2021,theni,1189,214,81,1,1321,19112,214,45,0,19371,17838,212
27-04-2021,thirupathur,910,174,110,0,974,9267,174,118,0,9559,8447,138
27-04-2021,thiruvallur,5254,717,558,6,5407,56462,717,10,0,57189,51011,771
27-04-2021,thiruvannamalai,1865,296,172,1,1988,22469,296,398,0,23163,20876,299
27-04-2021,thiruvarur,926,128,91,0,963,14500,128,38,0,14666,13583,120
27-04-2021,thoothukudi,2921,230,361,0,2790,21126,230,273,0,21629,18688,151
27-04-2021,tirunelveli,3664,680,506,2,3836,21321,680,427,0,22428,18360,232
27-04-2021,tiruppur,2518,546,468,1,2595,24554,546,11,0,25111,22281,235
27-04-2021,trichy,2959,468,566,1,2860,21502,468,58,0,22028,18958,210
27-04-2021,vellore,2284,395,275,1,2403,24364,341,1048,54,25807,23031,373
27-04-2021,villupuram,1214,201,121,1,1293,17512,201,174,0,17887,16474,120
27-04-2021,virudhunagar,1298,248,208,0,1338,18887,248,104,0,19239,17662,239
27-04-2021,airport surveillance (international),2,0,0,0,2,0,0,1000,0,1000,997,1
27-04-2021,airport surveillance (domestic),1,2,0,0,3,0,0,1069,2,1071,1067,1
27-04-2021,railway surveillance,0,0,0,0,0,0,0,428,0,428,428,0
28-04-2021,ariyalur,294,62,28,0,328,5403,62,20,0,5485,5105,52
28-04-2021,chengalpattu,8597,1219,1438,8,8370,76259,1219,5,0,77483,68182,931
28-04-2021,chennai,31210,4764,4647,32,31295,318641,4764,47,0,323452,287496,4661
28-04-2021,coimbatore,6951,963,991,2,6921,75245,963,51,0,76259,68619,719
28-04-2021,cuddalore,1455,218,212,2,1459,29165,218,203,0,29586,27806,321
28-04-2021,dharmapuri,1078,196,208,0,1066,8685,196,214,0,9095,7965,64
28-04-2021,dindigul,1607,233,228,0,1612,14944,233,77,0,15254,13434,208
28-04-2021,erode,2641,457,297,2,2799,19702,457,94,0,20253,17295,159
28-04-2021,kallakurichi,654,43,43,0,654,11828,43,404,0,12275,11512,109
28-04-2021,kancheepuram,2795,443,321,6,2911,36771,443,4,0,37218,33786,521
28-04-2021,kanyakumari,1849,242,256,3,1832,20871,242,124,0,21237,19108,297
28-04-2021,karur,789,125,73,1,840,7078,125,46,0,7249,6353,56
28-04-2021,krishnagiri,2621,454,279,1,2795,12963,454,212,0,13629,10707,127
28-04-2021,madurai,4070,492,522,2,4038,28831,492,171,0,29494,24952,504
28-04-2021,nagapattinam,1385,294,154,0,1525,12603,294,92,0,12989,11297,167
28-04-2021,namakkal,1734,255,290,4,1695,14993,254,106,1,15354,13541,118
28-04-2021,nilgiris,459,39,67,0,431,9663,39,41,0,9743,9261,51
28-04-2021,perambalur,124,18,9,0,133,2537,18,3,0,2558,2401,24
28-04-2021,pudukottai,742,98,119,2,719,13328,98,35,0,13461,12580,162
28-04-2021,ramanathapuram,707,145,71,1,780,7680,145,135,0,7960,7037,143
28-04-2021,ranipet,1704,311,238,1,1776,19624,311,49,0,19984,18011,197
28-04-2021,salem,3539,489,490,5,3533,39443,488,433,1,40365,36327,505
28-04-2021,sivagangai,564,77,78,0,563,8162,77,101,0,8340,7647,130
28-04-2021,tenkasi,1473,179,157,0,1495,11227,179,58,0,11464,9795,174
28-04-2021,thanjavur,2062,287,261,1,2087,24555,287,22,0,24864,22478,299
28-04-2021,theni,1321,252,164,0,1409,19326,252,45,0,19623,18002,212
28-04-2021,thirupathur,974,107,115,1,965,9441,107,118,0,9666,8562,139
28-04-2021,thiruvallur,5375,751,724,8,5394,57147,751,10,0,57908,51735,779
28-04-2021,thiruvannamalai,1999,197,153,1,2042,22776,197,398,0,23371,21029,300
28-04-2021,thiruvarur,965,154,154,0,965,14630,154,38,0,14822,13737,120
28-04-2021,thoothukudi,2795,594,309,1,3079,21361,594,273,0,22228,18997,152
28-04-2021,tirunelveli,3824,714,472,1,4065,21989,714,427,0,23130,18832,233
28-04-2021,tiruppur,2603,493,406,1,2689,25108,493,11,0,25612,22687,236
28-04-2021,trichy,2863,480,505,1,2837,21973,480,58,0,22511,19463,211
28-04-2021,vellore,2399,366,315,9,2441,24701,337,1102,29,26169,23346,382
28-04-2021,villupuram,1290,298,112,1,1475,17710,298,174,0,18182,16586,121
28-04-2021,virudhunagar,1338,154,208,1,1283,19135,154,104,0,19393,17870,240
28-04-2021,airport surveillance (international),2,0,0,0,2,0,0,1000,0,1000,997,1
28-04-2021,airport surveillance (domestic),3,2,0,0,5,0,0,1071,2,1073,1067,1
28-04-2021,railway surveillance,0,0,0,0,0,0,0,428,0,428,428,0
29-04-2021,ariyalur,328,44,38,0,334,5465,44,20,0,5529,5143,52
29-04-2021,chengalpattu,8480,1164,1495,7,8142,77588,1164,5,0,78757,69677,938
29-04-2021,chennai,30918,5445,5015,40,31308,323028,5445,47,0,328520,292511,4701
29-04-2021,coimbatore,6934,1008,1019,1,6922,76221,1008,51,0,77280,69638,720
29-04-2021,cuddalore,1469,249,136,4,1578,29393,249,203,0,29845,27942,325
29-04-2021,dharmapuri,1067,154,101,1,1119,8882,154,214,0,9250,8066,65
29-04-2021,dindigul,1618,245,221,0,1642,15183,245,77,0,15505,13655,208
29-04-2021,erode,2802,473,308,1,2966,20162,473,94,0,20729,17603,160
29-04-2021,kallakurichi,660,214,48,0,826,11877,214,404,0,12495,11560,109
29-04-2021,kancheepuram,2919,352,356,11,2904,37222,352,4,0,37578,34142,532
29-04-2021,kanyakumari,1829,211,273,5,1762,21110,211,124,0,21445,19381,302
29-04-2021,karur,841,138,85,0,894,7204,137,46,1,7388,6438,56
29-04-2021,krishnagiri,2799,371,268,0,2902,13421,371,212,0,14004,10975,127
29-04-2021,madurai,4057,604,568,8,4085,29342,604,171,0,30117,25520,512
29-04-2021,nagapattinam,1525,265,152,0,1638,12897,265,92,0,13254,11449,167
29-04-2021,namakkal,1688,298,296,2,1688,15240,298,107,0,15645,13837,120
29-04-2021,nilgiris,431,49,70,0,410,9702,49,41,0,9792,9331,51
29-04-2021,perambalur,133,30,10,0,153,2555,30,3,0,2588,2411,24
29-04-2021,pudukottai,725,102,94,1,732,13432,102,35,0,13569,12674,163
29-04-2021,ramanathapuram,785,205,83,0,907,7830,205,135,0,8170,7120,143
29-04-2021,ranipet,1781,334,214,0,1901,19940,334,49,0,20323,18225,197
29-04-2021,salem,3540,513,530,5,3518,39938,513,434,0,40885,36857,510
29-04-2021,sivagangai,558,106,64,0,600,8234,106,101,0,8441,7711,130
29-04-2021,tenkasi,1497,229,207,0,1519,11408,229,58,0,11695,10002,174
29-04-2021,thanjavur,2093,315,284,3,2121,24848,315,22,0,25185,22762,302
29-04-2021,theni,1410,281,195,0,1496,19579,281,45,0,19905,18197,212
29-04-2021,thirupathur,967,176,161,0,982,9550,176,118,0,9844,8723,139
29-04-2021,thiruvallur,5495,792,770,7,5510,57999,792,10,0,58801,52505,786
29-04-2021,thiruvannamalai,2047,225,217,1,2054,22978,225,398,0,23601,21246,301
29-04-2021,thiruvarur,987,175,143,2,1017,14806,175,38,0,15019,13880,122
29-04-2021,thoothukudi,3080,576,367,1,3288,21956,576,273,0,22805,19364,153
29-04-2021,tirunelveli,4073,849,482,1,4439,22711,849,427,0,23987,19314,234
29-04-2021,tiruppur,2690,366,183,2,2871,25602,366,11,0,25979,22870,238
29-04-2021,trichy,2845,403,455,1,2792,22461,402,58,1,22922,19918,212
29-04-2021,vellore,2454,351,337,2,2466,25051,314,1131,37,26533,23683,384
29-04-2021,villupuram,1485,359,132,1,1711,18018,359,174,0,18551,16718,122
29-04-2021,virudhunagar,1291,226,165,0,1352,19297,226,104,0,19627,18035,240
29-04-2021,airport surveillance (international),2,0,0,0,2,0,0,1000,0,1000,997,1
29-04-2021,airport surveillance (domestic),5,0,0,0,5,0,0,1073,0,1073,1067,1
29-04-2021,railway surveillance,0,0,0,0,0,0,0,428,0,428,428,0
30-04-2021,ariyalur,338,73,48,1,362,5513,73,20,0,5606,5191,53
30-04-2021,chengalpattu,8208,1215,1331,5,8087,78818,1215,5,0,80038,71008,943
30-04-2021,chennai,31119,5473,5327,42,31222,328284,5473,47,0,333804,297838,4744
30-04-2021,coimbatore,6939,1113,1107,2,6943,77246,1113,51,0,78410,70745,722
30-04-2021,cuddalore,1588,292,228,2,1650,29652,292,203,0,30147,28170,327
30-04-2021,dharmapuri,1119,242,138,0,1223,9036,242,214,0,9492,8204,65
30-04-2021,dindigul,1643,294,272,2,1663,15429,294,77,0,15800,13927,210
30-04-2021,erode,2957,519,277,1,3198,20626,519,94,0,21239,17880,161
30-04-2021,kallakurichi,825,77,47,1,854,12090,77,404,0,12571,11607,110
30-04-2021,kancheepuram,2946,445,380,3,3008,37616,445,4,0,38065,34522,535
30-04-2021,kanyakumari,1770,162,276,0,1656,21329,162,124,0,21615,19657,302
30-04-2021,karur,895,176,84,1,986,7342,176,47,0,7565,6522,57
30-04-2021,krishnagiri,2905,510,269,1,3145,13795,508,212,2,14517,11244,128
30-04-2021,madurai,4096,691,575,5,4207,29957,691,171,0,30819,26095,517
30-04-2021,nagapattinam,1641,161,161,1,1640,13165,161,92,0,13418,11610,168
30-04-2021,namakkal,1697,327,228,2,1794,15547,327,107,0,15981,14065,122
30-04-2021,nilgiris,407,58,47,0,418,9748,58,41,0,9847,9378,51
30-04-2021,perambalur,158,34,14,0,178,2590,34,3,0,2627,2425,24
30-04-2021,pudukottai,733,148,70,0,811,13535,148,35,0,13718,12744,163
30-04-2021,ramanathapuram,910,244,86,3,1065,8038,244,135,0,8417,7206,146
30-04-2021,ranipet,1910,339,182,12,2055,20283,339,49,0,20671,18407,209
30-04-2021,salem,3525,547,559,10,3503,40458,547,434,0,41439,37416,520
30-04-2021,sivagangai,596,130,39,2,685,8336,130,101,0,8567,7750,132
30-04-2021,tenkasi,1534,121,230,1,1424,11652,121,58,0,11831,10232,175
30-04-2021,thanjavur,2120,352,301,3,2168,25162,352,22,0,25536,23063,305
30-04-2021,theni,1498,296,187,1,1606,19862,296,45,0,20203,18384,213
30-04-2021,thirupathur,973,206,167,1,1010,9717,206,118,0,10041,8890,141
30-04-2021,thiruvallur,5506,905,840,7,5564,58787,905,10,0,59702,53345,793
30-04-2021,thiruvannamalai,2061,211,277,1,1994,23210,211,398,0,23819,21523,302
30-04-2021,thiruvarur,1007,177,152,0,1032,14971,177,38,0,15186,14032,122
30-04-2021,thoothukudi,3310,579,342,0,3547,22554,579,273,0,23406,19706,153
30-04-2021,tirunelveli,4405,644,422,0,4627,23526,644,427,0,24597,19736,234
30-04-2021,tiruppur,2878,423,268,1,3032,25975,423,11,0,26409,23138,239
30-04-2021,trichy,2786,450,422,0,2815,22857,450,59,0,23366,20340,211
30-04-2021,vellore,2466,384,339,0,2512,25365,359,1168,25,26917,24022,383
30-04-2021,villupuram,1718,377,205,1,1889,18384,377,174,0,18935,16923,123
30-04-2021,virudhunagar,1362,297,110,1,1548,19533,297,104,0,19934,18145,241
30-04-2021,airport surveillance (international),2,0,0,0,2,0,0,1000,0,1000,997,1
30-04-2021,airport surveillance (domestic),5,0,0,0,5,0,0,1073,0,1073,1067,1
30-04-2021,railway surveillance,0,0,0,0,0,0,0,428,0,428,428,0
01-05-2021,ariyalur,353,38,47,0,344,5577,38,20,0,5635,5238,53
01-05-2021,chengalpattu,8081,1445,1345,11,8170,80027,1445,5,0,81477,72353,954
01-05-2021,chennai,31386,5829,5693,47,31475,333921,5829,47,0,339797,303531,4791
01-05-2021,coimbatore,6945,1257,913,1,7288,78361,1257,51,0,79669,71658,723
01-05-2021,cuddalore,1647,330,269,2,1706,29941,330,203,0,30474,28439,329
01-05-2021,dharmapuri,1224,175,165,0,1234,9279,175,214,0,9668,8369,65
01-05-2021,dindigul,1660,220,298,4,1578,15720,220,77,0,16017,14225,214
01-05-2021,erode,3198,378,357,5,3214,21145,378,94,0,21617,18237,166
01-05-2021,kallakurichi,855,122,72,1,904,12168,122,404,0,12694,11679,111
01-05-2021,kancheepuram,2970,332,473,6,2823,38023,332,4,0,38359,34995,541
01-05-2021,kanyakumari,1656,276,233,4,1695,21491,276,124,0,21891,19890,306
01-05-2021,karur,987,175,164,1,997,7519,175,47,0,7741,6686,58
01-05-2021,krishnagiri,3149,423,422,1,3149,14307,420,214,3,14944,11666,129
01-05-2021,madurai,4196,711,662,0,4245,30637,711,171,0,31519,26757,517
01-05-2021,nagapattinam,1644,233,184,0,1693,13330,233,92,0,13655,11794,168
01-05-2021,namakkal,1796,258,219,0,1835,15876,258,107,0,16241,14284,122
01-05-2021,nilgiris,418,63,63,0,418,9806,63,41,0,9910,9441,51
01-05-2021,perambalur,180,43,18,0,205,2626,43,3,0,2672,2443,24
01-05-2021,pudukottai,811,164,114,0,861,13683,164,35,0,13882,12858,163
01-05-2021,ramanathapuram,1065,205,95,0,1175,8282,205,135,0,8622,7301,146
01-05-2021,ranipet,2087,217,231,2,2071,20655,217,49,0,20921,18638,212
01-05-2021,salem,3509,521,594,14,3422,41011,520,434,1,41966,38010,534
01-05-2021,sivagangai,680,115,67,1,727,8461,114,101,1,8677,7817,133
01-05-2021,tenkasi,1422,245,236,3,1428,11771,245,58,0,12074,10468,178
01-05-2021,thanjavur,2162,492,331,1,2322,25508,492,22,0,26022,23394,306
01-05-2021,theni,1600,363,202,2,1759,20152,363,45,0,20560,18586,215
01-05-2021,thirupathur,1022,151,128,7,1038,9935,151,118,0,10204,9018,148
01-05-2021,thiruvallur,5454,779,834,14,5385,59582,779,10,0,60371,54179,807
01-05-2021,thiruvannamalai,2012,187,384,2,1813,23439,187,398,0,24024,21907,304
01-05-2021,thiruvarur,1030,224,168,1,1085,15146,224,38,0,15408,14200,123
01-05-2021,thoothukudi,3548,638,384,2,3800,23134,638,273,0,24045,20090,155
01-05-2021,tirunelveli,4634,812,473,6,4967,24177,812,427,0,25416,20209,240
01-05-2021,tiruppur,3035,438,305,0,3168,26401,438,11,0,26850,23443,239
01-05-2021,trichy,2818,528,280,5,3061,23310,528,59,0,23897,20620,216
01-05-2021,vellore,2448,442,398,4,2488,25659,417,1193,25,27294,24420,386
01-05-2021,villupuram,1890,354,214,0,2030,18762,354,174,0,19290,17137,123
01-05-2021,virudhunagar,1549,405,129,0,1825,19831,405,104,0,20340,18274,241
01-05-2021,airport surveillance (international),2,0,0,0,2,0,0,1000,0,1000,997,1
01-05-2021,airport surveillance (domestic),5,0,0,0,5,0,0,1073,0,1073,1067,1
01-05-2021,railway surveillance,0,0,0,0,0,0,0,428,0,428,428,0
02-05-2021,ariyalur,345,60,57,0,348,5616,60,20,0,5696,5295,53
02-05-2021,chengalpattu,8150,1582,850,16,8866,81452,1582,5,0,83039,73203,970
02-05-2021,chennai,31566,6078,5702,29,31913,339841,6078,47,0,345966,309233,4820
02-05-2021,coimbatore,7296,1441,1051,3,7683,79626,1441,51,0,81118,72709,726
02-05-2021,cuddalore,1706,370,256,0,1820,30271,370,203,0,30844,28695,329
02-05-2021,dharmapuri,1231,173,149,2,1253,9451,173,214,0,9838,8518,67
02-05-2021,dindigul,1572,270,244,0,1598,15934,270,77,0,16281,14469,214
02-05-2021,erode,3213,549,438,1,3323,21522,549,94,0,22165,18675,167
02-05-2021,kallakurichi,896,84,109,1,870,12282,84,404,0,12770,11788,112
02-05-2021,kancheepuram,2791,495,548,13,2725,38323,495,4,0,38822,35543,554
02-05-2021,kanyakumari,1697,317,254,6,1754,21769,317,124,0,22210,20144,312
02-05-2021,karur,998,241,173,1,1065,7695,241,47,0,7983,6859,59
02-05-2021,krishnagiri,3150,503,440,2,3211,14728,503,217,0,15448,12106,131
02-05-2021,madurai,4244,880,635,7,4482,31347,880,171,0,32398,27392,524
02-05-2021,nagapattinam,1697,160,205,2,1650,13567,160,92,0,13819,11999,170
02-05-2021,namakkal,1836,307,208,2,1933,16135,307,107,0,16549,14492,124
02-05-2021,nilgiris,418,86,88,0,416,9869,86,41,0,9996,9529,51
02-05-2021,perambalur,206,29,19,3,213,2670,29,3,0,2702,2462,27
02-05-2021,pudukottai,856,170,129,0,897,13842,170,35,0,14047,12987,163
02-05-2021,ramanathapuram,1174,178,121,0,1231,8486,178,135,0,8799,7422,146
02-05-2021,ranipet,2068,417,251,5,2229,20869,417,49,0,21335,18889,217
02-05-2021,salem,3429,582,528,12,3471,41538,582,435,0,42555,38538,546
02-05-2021,sivagangai,723,128,86,1,764,8571,127,102,1,8801,7903,134
02-05-2021,tenkasi,1443,172,261,6,1348,12031,172,58,0,12261,10729,184
02-05-2021,thanjavur,2320,265,363,1,2221,25998,265,22,0,26285,23757,307
02-05-2021,theni,1751,399,208,2,1940,20507,399,45,0,20951,18794,217
02-05-2021,thirupathur,1039,166,105,3,1097,10087,166,118,0,10371,9123,151
02-05-2021,thiruvallur,5350,1049,857,8,5534,60326,1049,10,0,61385,55036,815
02-05-2021,thiruvannamalai,1817,182,382,2,1615,23630,182,398,0,24210,22289,306
02-05-2021,thiruvarur,1078,175,147,0,1106,15363,175,38,0,15576,14347,123
02-05-2021,thoothukudi,3820,663,455,1,4027,23792,663,273,0,24728,20545,156
02-05-2021,tirunelveli,4923,630,594,3,4956,24945,630,427,0,26002,20803,243
02-05-2021,tiruppur,3166,382,412,2,3134,26837,382,11,0,27230,23855,241
02-05-2021,trichy,3064,505,368,8,3193,23841,505,59,0,24405,20988,224
02-05-2021,vellore,2494,502,363,9,2624,26082,478,1218,24,27802,24783,395
02-05-2021,villupuram,2039,343,233,0,2149,19125,343,174,0,19642,17370,123
02-05-2021,virudhunagar,1832,234,286,2,1778,20243,234,104,0,20581,18560,243
02-05-2021,airport surveillance (international),2,1,0,0,3,0,0,1000,1,1001,997,1
02-05-2021,airport surveillance (domestic),5,0,1,0,4,0,0,1073,0,1073,1068,1
02-05-2021,railway surveillance,0,0,0,0,0,0,0,428,0,428,428,0
03-05-2021,ariyalur,343,45,59,0,329,5671,45,20,0,5736,5354,53
03-05-2021,chengalpattu,8847,1618,1202,6,9257,83015,1618,5,0,84638,74405,976
03-05-2021,chennai,32057,6150,5384,38,32785,346063,6150,47,0,352260,314617,4858
03-05-2021,coimbatore,7688,1566,1063,3,8188,81072,1566,51,0,82689,73772,729
03-05-2021,cuddalore,1820,381,240,0,1961,30641,381,203,0,31225,28935,329
03-05-2021,dharmapuri,1253,171,151,0,1273,9624,171,214,0,10009,8669,67
03-05-2021,dindigul,1575,223,194,1,1603,16181,223,77,0,16481,14663,215
03-05-2021,erode,3324,652,556,1,3419,22071,652,94,0,22817,19231,167
03-05-2021,kallakurichi,871,127,272,1,725,12367,127,404,0,12898,12060,113
03-05-2021,kancheepuram,2683,835,482,10,3026,38776,835,4,0,39615,36025,564
03-05-2021,kanyakumari,1754,388,305,5,1832,22086,388,124,0,22598,20449,317
03-05-2021,karur,1070,229,118,0,1181,7941,229,47,0,8217,6977,59
03-05-2021,krishnagiri,3210,445,536,1,3118,15230,444,217,1,15892,12642,132
03-05-2021,madurai,4490,477,507,16,4444,32235,477,171,0,32883,27899,540
03-05-2021,nagapattinam,1654,232,213,4,1669,13731,232,92,0,14055,12212,174
03-05-2021,namakkal,1926,361,271,1,2015,16435,361,107,0,16903,14763,125
03-05-2021,nilgiris,416,105,94,0,427,9955,105,41,0,10101,9623,51
03-05-2021,perambalur,213,39,29,1,222,2699,39,3,0,2741,2491,28
03-05-2021,pudukottai,893,113,152,0,854,14008,113,35,0,14156,13139,163
03-05-2021,ramanathapuram,1231,197,201,0,1227,8664,197,135,0,8996,7623,146
03-05-2021,ranipet,2238,382,255,1,2364,21296,382,49,0,21727,19144,219
03-05-2021,salem,3476,607,442,3,3638,42125,607,435,0,43167,38980,549
03-05-2021,sivagangai,765,126,155,2,734,8699,122,103,4,8928,8058,136
03-05-2021,tenkasi,1346,133,271,0,1208,12201,133,58,0,12392,11000,184
03-05-2021,thanjavur,2224,321,352,2,2191,26266,321,22,0,26609,24109,309
03-05-2021,theni,1934,257,169,0,2022,20900,257,45,0,21202,18963,217
03-05-2021,thirupathur,1093,111,143,1,1060,10249,111,118,0,10478,9266,152
03-05-2021,thiruvallur,5446,1207,676,4,5973,61287,1207,10,0,62504,55712,819
03-05-2021,thiruvannamalai,1619,207,339,1,1486,23816,207,398,0,24421,22628,307
03-05-2021,thiruvarur,1098,206,80,2,1222,15530,206,38,0,15774,14427,125
03-05-2021,thoothukudi,4029,707,722,1,4013,24457,707,273,0,25437,21267,157
03-05-2021,tirunelveli,4956,403,713,5,4641,25575,403,427,0,26405,21516,248
03-05-2021,tiruppur,3142,477,519,0,3100,27228,477,11,0,27716,24374,242
03-05-2021,trichy,3200,653,401,4,3448,24353,653,59,0,25065,21389,228
03-05-2021,vellore,2621,263,307,4,2573,26556,252,1242,11,28061,25090,398
03-05-2021,villupuram,2149,396,209,2,2334,19468,396,174,0,20038,17579,125
03-05-2021,virudhunagar,1783,141,232,2,1690,20482,141,104,0,20727,18792,245
03-05-2021,airport surveillance (international),3,0,0,0,3,0,0,1001,0,1001,997,1
03-05-2021,airport surveillance (domestic),4,1,2,0,3,0,0,1073,1,1074,1070,1
03-05-2021,railway surveillance,0,0,0,0,0,0,0,428,0,428,428,0
04-05-2021,ariyalur,330,35,24,0,341,5717,35,20,0,5772,5378,53
04-05-2021,chengalpattu,9276,1608,1216,5,9663,84652,1608,5,0,86265,75621,981
04-05-2021,chennai,32870,6228,5840,36,33222,352298,6228,47,0,358573,320457,4894
04-05-2021,coimbatore,8196,1509,1105,4,8596,82646,1509,51,0,84206,74877,733
04-05-2021,cuddalore,1956,305,253,7,2001,31017,305,203,0,31525,29188,336
04-05-2021,dharmapuri,1269,263,181,0,1351,9791,261,214,2,10268,8850,67
04-05-2021,dindigul,1603,167,180,2,1588,16404,167,77,0,16648,14843,217
04-05-2021,erode,3406,585,571,1,3419,22709,585,94,0,23388,19802,167
04-05-2021,kallakurichi,717,146,137,0,726,12487,146,404,0,13037,12197,114
04-05-2021,kancheepuram,2980,594,541,8,3025,39565,594,4,0,40163,36566,572
04-05-2021,kanyakumari,1833,526,322,3,2034,22475,526,124,0,23125,20771,320
04-05-2021,karur,1185,264,96,3,1350,8174,264,47,0,8485,7073,62
04-05-2021,krishnagiri,3121,305,550,1,2875,15677,305,218,0,16200,13192,133
04-05-2021,madurai,4443,787,640,5,4585,32711,787,171,0,33669,28539,545
04-05-2021,nagapattinam,1666,392,353,2,1703,13960,392,92,0,14444,12565,176
04-05-2021,namakkal,2016,328,239,0,2105,16797,328,107,0,17232,15002,125
04-05-2021,nilgiris,427,116,43,0,500,10060,116,41,0,10217,9666,51
04-05-2021,perambalur,226,31,33,1,223,2742,31,3,0,2776,2524,29
04-05-2021,pudukottai,858,72,96,0,834,14125,72,35,0,14232,13235,163
04-05-2021,ramanathapuram,1230,90,177,0,1143,8864,90,135,0,9089,7800,146
04-05-2021,ranipet,2351,747,374,2,2722,21665,747,49,0,22461,19518,221
04-05-2021,salem,3647,624,455,15,3801,42741,624,435,0,43800,39435,564
04-05-2021,sivagangai,729,135,108,0,756,8816,135,107,0,9058,8166,136
04-05-2021,tenkasi,1204,129,227,0,1106,12331,129,58,0,12518,11227,185
04-05-2021,thanjavur,2187,454,315,3,2323,26583,454,22,0,27059,24424,312
04-05-2021,theni,2018,187,213,2,1990,21153,187,45,0,21385,19176,219
04-05-2021,thirupathur,1056,119,176,4,995,10356,119,118,0,10593,9442,156
04-05-2021,thiruvallur,5935,1152,927,12,6148,62456,1152,10,0,63618,56639,831
04-05-2021,thiruvannamalai,1491,224,301,3,1411,24028,224,398,0,24650,22929,310
04-05-2021,thiruvarur,1223,129,133,1,1218,15737,129,38,0,15904,14560,126
04-05-2021,thoothukudi,4014,358,381,2,3989,25165,358,273,0,25796,21648,159
04-05-2021,tirunelveli,4647,719,987,1,4378,25983,719,427,0,27129,22503,248
04-05-2021,tiruppur,3102,494,550,1,3045,27708,494,11,0,28213,24924,244
04-05-2021,trichy,3438,440,464,4,3410,24996,440,59,0,25495,21853,232
04-05-2021,vellore,2571,475,402,11,2633,26806,443,1253,32,28534,25492,409
04-05-2021,villupuram,2340,196,250,3,2283,19869,196,174,0,20239,17829,127
04-05-2021,virudhunagar,1691,295,252,2,1732,20624,295,104,0,21023,19044,247
04-05-2021,airport surveillance (international),3,0,0,0,3,0,0,1001,0,1001,997,1
04-05-2021,airport surveillance (domestic),3,0,0,0,3,0,0,1074,0,1074,1070,1
04-05-2021,railway surveillance,0,0,0,0,0,0,0,428,0,428,428,0
05-05-2021,ariyalur,351,112,56,0,407,5762,112,20,0,5894,5434,53
05-05-2021,chengalpattu,9835,1755,1228,16,10346,86432,1755,5,0,88192,76849,997
05-05-2021,chennai,32439,6291,5755,58,32917,357743,6291,47,0,364081,326212,4952
05-05-2021,coimbatore,8622,2029,1329,3,9319,84181,2029,51,0,86261,76206,736
05-05-2021,cuddalore,2011,296,269,4,2034,31332,296,203,0,31831,29457,340
05-05-2021,dharmapuri,1356,205,194,2,1365,10057,205,216,0,10478,9044,69
05-05-2021,dindigul,1590,280,231,1,1638,16573,280,77,0,16930,15074,218
05-05-2021,erode,3431,616,609,1,3437,23306,616,94,0,24016,20411,168
05-05-2021,kallakurichi,730,131,150,0,711,12637,131,404,0,13172,12347,114
05-05-2021,kancheepuram,3126,541,575,4,3088,40260,541,4,0,40805,37141,576
05-05-2021,kanyakumari,2047,524,338,8,2225,23014,524,124,0,23662,21109,328
05-05-2021,karur,1344,258,127,0,1475,8432,258,47,0,8737,7200,62
05-05-2021,krishnagiri,2890,310,576,5,2619,15997,310,218,0,16525,13768,138
05-05-2021,madurai,4633,914,693,8,4846,33546,914,171,0,34631,29232,553
05-05-2021,nagapattinam,1719,384,387,2,1714,14368,384,92,0,14844,12952,178
05-05-2021,namakkal,2115,367,296,1,2185,17135,367,107,0,17609,15298,126
05-05-2021,nilgiris,502,139,54,0,587,10178,139,41,0,10358,9720,51
05-05-2021,perambalur,227,114,39,0,302,2777,114,3,0,2894,2563,29
05-05-2021,pudukottai,844,150,108,1,885,14207,150,35,0,14392,13343,164
05-05-2021,ramanathapuram,1147,260,145,0,1262,8958,260,135,0,9353,7945,146
05-05-2021,ranipet,2722,205,391,8,2528,22412,205,49,0,22666,19909,229
05-05-2021,salem,3815,613,494,7,3927,43379,613,435,0,44427,39929,571
05-05-2021,sivagangai,761,138,90,0,809,8956,138,107,0,9201,8256,136
05-05-2021,tenkasi,1112,215,252,1,1074,12467,215,58,0,12740,11479,187
05-05-2021,thanjavur,2337,320,335,5,2317,27051,320,22,0,27393,24759,317
05-05-2021,theni,1993,388,253,4,2124,21343,388,45,0,21776,19429,223
05-05-2021,thirupathur,992,126,183,2,933,10472,126,118,0,10716,9625,158
05-05-2021,thiruvallur,6255,1385,994,5,6641,63715,1385,10,0,65110,57633,836
05-05-2021,thiruvannamalai,1444,168,320,1,1291,24285,168,398,0,24851,23249,311
05-05-2021,thiruvarur,1223,236,153,1,1305,15871,236,38,0,16145,14713,127
05-05-2021,thoothukudi,3995,741,444,1,4291,25530,741,273,0,26544,22092,161
05-05-2021,tirunelveli,4404,653,965,4,4088,26726,653,427,0,27806,23468,250
05-05-2021,tiruppur,3053,640,596,2,3095,28210,640,11,0,28861,25520,246
05-05-2021,trichy,3419,652,482,3,3586,25445,652,59,0,26156,22335,235
05-05-2021,vellore,2672,536,446,6,2756,27288,514,1285,22,29109,25938,415
05-05-2021,villupuram,2320,412,248,3,2481,20102,412,174,0,20688,18077,130
05-05-2021,virudhunagar,1748,204,255,0,1697,20935,204,104,0,21243,19299,247
05-05-2021,airport surveillance (international),3,2,0,0,5,0,0,1001,2,1003,997,1
05-05-2021,airport surveillance (domestic),3,0,2,0,1,0,0,1074,0,1074,1072,1
05-05-2021,railway surveillance,0,0,0,0,0,0,0,428,0,428,428,0
06-05-2021,ariyalur,408,88,67,0,429,5875,88,20,0,5983,5501,53
06-05-2021,chengalpattu,10379,2039,1228,16,11174,88220,2039,5,0,90264,78077,1013
06-05-2021,chennai,32754,6678,6047,69,33316,363871,6678,47,0,370596,332259,5021
06-05-2021,coimbatore,9332,2068,1551,4,9845,86223,2068,51,0,88342,77757,740
06-05-2021,cuddalore,2035,366,307,3,2091,31629,366,203,0,32198,29764,343
06-05-2021,dharmapuri,1355,230,206,1,1378,10252,230,216,0,10698,9250,70
06-05-2021,dindigul,1618,307,245,3,1677,16833,307,77,0,17217,15319,221
06-05-2021,erode,3430,590,599,0,3421,23915,590,94,0,24599,21010,168
06-05-2021,kallakurichi,707,175,141,1,740,12764,175,404,0,13343,12488,115
06-05-2021,kancheepuram,3115,836,539,13,3399,40828,836,4,0,41668,37680,589
06-05-2021,kanyakumari,2229,445,325,14,2335,23542,445,124,0,24111,21434,342
06-05-2021,karur,1481,229,139,4,1567,8696,229,47,0,8972,7339,66
06-05-2021,krishnagiri,2629,390,584,0,2435,16317,389,218,1,16925,14352,138
06-05-2021,madurai,4857,996,715,5,5133,34471,996,171,0,35638,29947,558
06-05-2021,nagapattinam,1719,333,311,2,1739,14757,333,92,0,15182,13263,180
06-05-2021,namakkal,2192,322,319,4,2191,17509,322,107,0,17938,15617,130
06-05-2021,nilgiris,588,113,61,0,640,10318,113,41,0,10472,9781,51
06-05-2021,perambalur,304,60,42,0,322,2893,60,3,0,2956,2605,29
06-05-2021,pudukottai,894,182,111,2,963,14366,182,35,0,14583,13454,166
06-05-2021,ramanathapuram,1264,180,157,0,1287,9220,180,135,0,9535,8102,146
06-05-2021,ranipet,2540,275,408,6,2401,22629,275,49,0,22953,20317,235
06-05-2021,salem,3942,614,673,4,3879,44007,614,435,0,45056,40602,575
06-05-2021,sivagangai,794,148,103,0,839,9079,148,107,0,9334,8359,136
06-05-2021,tenkasi,1080,280,176,4,1180,12688,280,58,0,13026,11655,191
06-05-2021,thanjavur,2315,165,358,6,2116,27369,165,22,0,27556,25117,323
06-05-2021,theni,2123,456,287,2,2290,21730,456,45,0,22231,19716,225
06-05-2021,thirupathur,931,176,171,1,935,10595,176,118,0,10889,9796,158
06-05-2021,thiruvallur,6615,1560,1205,12,6958,65074,1560,10,0,66644,58838,848
06-05-2021,thiruvannamalai,1302,304,311,2,1293,24464,304,398,0,25166,23560,313
06-05-2021,thiruvarur,1304,269,186,1,1386,16106,269,38,0,16413,14899,128
06-05-2021,thoothukudi,4296,796,699,0,4393,26276,796,273,0,27345,22791,161
06-05-2021,tirunelveli,4092,688,982,6,3792,27383,688,427,0,28498,24450,256
06-05-2021,tiruppur,3102,443,618,1,2926,28857,443,11,0,29311,26138,247
06-05-2021,trichy,3612,746,552,5,3801,26123,746,59,0,26928,22887,240
06-05-2021,vellore,2770,614,471,1,2912,27817,590,1307,24,29738,26409,417
06-05-2021,villupuram,2493,466,366,2,2591,20526,466,174,0,21166,18443,132
06-05-2021,virudhunagar,1704,269,286,1,1686,21146,269,104,0,21519,19585,248
06-05-2021,airport surveillance (international),5,1,0,0,6,0,0,1003,1,1004,997,1
06-05-2021,airport surveillance (domestic),1,1,0,0,2,0,0,1074,1,1075,1072,1
06-05-2021,railway surveillance,0,0,0,0,0,0,0,428,0,428,428,0
07-05-2021,ariyalur,427,114,75,0,466,5961,114,20,0,6095,5576,53
07-05-2021,chengalpattu,11232,2154,1243,9,12134,90317,2154,5,0,92476,79320,1022
07-05-2021,chennai,33024,6738,6634,60,33068,370257,6738,47,0,377042,338893,5081
07-05-2021,coimbatore,9856,2101,1491,6,10460,88302,2101,51,0,90454,79248,746
07-05-2021,cuddalore,2093,462,343,5,2207,31997,462,203,0,32662,30107,348
07-05-2021,dharmapuri,1380,243,238,1,1384,10484,243,216,0,10943,9488,71
07-05-2021,dindigul,1684,323,289,3,1715,17147,323,77,0,17547,15608,224
07-05-2021,erode,3423,639,444,3,3615,24507,639,94,0,25240,21454,171
07-05-2021,kallakurichi,742,202,114,1,829,12941,202,404,0,13547,12602,116
07-05-2021,kancheepuram,3393,857,337,9,3904,41658,857,4,0,42519,38017,598
07-05-2021,kanyakumari,2336,435,238,6,2527,23988,435,124,0,24547,21672,348
07-05-2021,karur,1549,265,178,1,1635,8907,265,47,0,9219,7517,67
07-05-2021,krishnagiri,2444,500,491,2,2451,16715,500,219,0,17434,14843,140
07-05-2021,madurai,5160,1051,794,14,5403,35494,1051,171,0,36716,30741,572
07-05-2021,nagapattinam,1748,365,263,3,1847,15099,365,92,0,15556,13526,183
07-05-2021,namakkal,2195,357,351,2,2199,17835,357,107,0,18299,15968,132
07-05-2021,nilgiris,640,161,68,0,733,10431,161,41,0,10633,9849,51
07-05-2021,perambalur,327,96,51,1,371,2958,96,3,0,3057,2656,30
07-05-2021,pudukottai,967,164,130,1,1000,14552,164,35,0,14751,13584,167
07-05-2021,ramanathapuram,1292,228,192,0,1328,9405,228,135,0,9768,8294,146
07-05-2021,ranipet,2394,459,429,5,2419,22897,459,49,0,23405,20746,240
07-05-2021,salem,3884,648,752,9,3771,44626,648,435,0,45709,41354,584
07-05-2021,sivagangai,833,113,126,0,820,9221,113,107,0,9441,8485,136
07-05-2021,tenkasi,1172,322,208,5,1281,12960,322,58,0,13340,11863,196
07-05-2021,thanjavur,2119,331,404,2,2044,27537,331,22,0,27890,25521,325
07-05-2021,theni,2277,495,339,5,2428,22173,495,45,0,22713,20055,230
07-05-2021,thirupathur,930,272,184,3,1015,10768,272,118,0,11158,9980,163
07-05-2021,thiruvallur,7051,1384,1246,15,7174,66727,1384,10,0,68121,60084,863
07-05-2021,thiruvannamalai,1315,415,222,4,1504,24790,415,398,0,25603,23782,317
07-05-2021,thiruvarur,1392,331,224,1,1498,16381,331,38,0,16750,15123,129
07-05-2021,thoothukudi,4393,855,860,0,4388,27072,855,273,0,28200,23651,161
07-05-2021,tirunelveli,3802,673,976,4,3495,28081,673,427,0,29181,25426,260
07-05-2021,tiruppur,2928,552,656,2,2822,29302,552,11,0,29865,26794,249
07-05-2021,trichy,3829,784,597,6,4010,26897,784,59,0,27740,23484,246
07-05-2021,vellore,2927,582,517,2,2990,28420,562,1331,20,30333,26926,417
07-05-2021,villupuram,2607,521,379,2,2747,21008,521,174,0,21703,18822,134
07-05-2021,virudhunagar,1695,273,298,5,1665,21424,273,104,0,21801,19883,253
07-05-2021,airport surveillance (international),6,0,0,0,6,0,0,1004,0,1004,997,1
07-05-2021,airport surveillance (domestic),2,0,0,0,2,0,0,1075,0,1075,1072,1
07-05-2021,railway surveillance,0,0,0,0,0,0,0,428,0,428,428,0
08-05-2021,ariyalur,468,105,90,0,483,6077,105,20,0,6202,5666,53
08-05-2021,chengalpattu,12164,2458,1470,10,13142,92501,2458,5,0,94964,80790,1032
08-05-2021,chennai,32824,6846,6740,72,32858,376751,6846,47,0,383644,345633,5153
08-05-2021,coimbatore,10468,2117,1656,4,10925,90411,2117,51,0,92579,80904,750
08-05-2021,cuddalore,2212,519,384,9,2338,32464,519,203,0,33186,30491,357
08-05-2021,dharmapuri,1382,305,277,3,1407,10725,305,216,0,11246,9765,74
08-05-2021,dindigul,1715,361,324,6,1746,17470,361,77,0,17908,15932,230
08-05-2021,erode,3612,779,551,1,3839,25143,779,94,0,26016,22005,172
08-05-2021,kallakurichi,833,117,86,2,862,13147,117,404,0,13668,12688,118
08-05-2021,kancheepuram,3918,906,495,14,4315,42529,906,4,0,43439,38512,612
08-05-2021,kanyakumari,2529,542,322,9,2740,24425,542,124,0,25091,21994,357
08-05-2021,karur,1627,292,202,4,1713,9164,292,47,0,9503,7719,71
08-05-2021,krishnagiri,2451,429,506,4,2370,17215,428,219,1,17863,15349,144
08-05-2021,madurai,5410,1217,825,7,5795,36552,1217,171,0,37940,31566,579
08-05-2021,nagapattinam,1848,392,160,2,2078,15465,392,92,0,15949,13686,185
08-05-2021,namakkal,2203,288,385,0,2106,18196,288,107,0,18591,16353,132
08-05-2021,nilgiris,733,148,85,0,796,10592,148,41,0,10781,9934,51
08-05-2021,perambalur,374,133,55,0,452,3057,133,3,0,3193,2711,30
08-05-2021,pudukottai,1012,208,145,1,1074,14728,208,35,0,14971,13729,168
08-05-2021,ramanathapuram,1328,251,211,0,1368,9633,251,135,0,10019,8505,146
08-05-2021,ranipet,2425,325,437,1,2312,23362,325,49,0,23736,21183,241
08-05-2021,salem,3777,550,774,10,3543,45280,550,435,0,46265,42128,594
08-05-2021,sivagangai,823,136,160,0,799,9337,136,107,0,9580,8645,136
08-05-2021,tenkasi,1281,120,214,5,1182,13282,120,58,0,13460,12077,201
08-05-2021,thanjavur,2047,857,423,7,2474,27871,857,22,0,28750,25944,332
08-05-2021,theni,2433,521,376,2,2576,22673,521,45,0,23239,20431,232
08-05-2021,thirupathur,1019,318,196,11,1130,11044,318,118,0,11480,10176,174
08-05-2021,thiruvallur,7245,1284,1228,17,7284,68182,1284,10,0,69476,61312,880
08-05-2021,thiruvannamalai,1513,346,202,1,1656,25214,346,398,0,25958,23984,318
08-05-2021,thiruvarur,1505,338,248,1,1594,16719,338,38,0,17095,15371,130
08-05-2021,thoothukudi,4393,853,887,5,4354,27932,853,273,0,29058,24538,166
08-05-2021,tirunelveli,3505,674,576,3,3600,28764,674,427,0,29865,26002,263
08-05-2021,tiruppur,2831,655,451,3,3032,29863,655,11,0,30529,27245,252
08-05-2021,trichy,4023,820,633,12,4198,27694,820,59,0,28573,24117,258
08-05-2021,vellore,2993,574,565,5,2997,28985,562,1351,12,30910,27491,422
08-05-2021,villupuram,2756,319,423,5,2647,21538,319,174,0,22031,19245,139
08-05-2021,virudhunagar,1667,294,348,5,1608,21699,294,104,0,22097,20231,258
08-05-2021,airport surveillance (international),6,0,0,0,6,0,0,1004,0,1004,997,1
08-05-2021,airport surveillance (domestic),2,0,0,0,2,0,0,1075,0,1075,1072,1
08-05-2021,railway surveillance,0,0,0,0,0,0,0,428,0,428,428,0
09-05-2021,ariyalur,485,112,86,1,510,6184,112,20,0,6316,5752,54
09-05-2021,chengalpattu,13294,2279,1629,20,13924,95111,2279,5,0,97395,82419,1052
09-05-2021,chennai,32673,7130,6884,56,32863,383412,7130,47,0,390589,352517,5209
09-05-2021,coimbatore,10936,2509,1705,9,11731,92539,2509,51,0,95099,82609,759
09-05-2021,cuddalore,2344,478,415,3,2404,32989,478,203,0,33670,30906,360
09-05-2021,dharmapuri,1407,353,279,0,1481,11030,353,216,0,11599,10044,74
09-05-2021,dindigul,1744,351,304,5,1786,17829,351,77,0,18257,16236,235
09-05-2021,erode,3833,691,557,1,3966,25916,691,94,0,26701,22562,173
09-05-2021,kallakurichi,866,280,98,0,1048,13268,280,404,0,13952,12786,118
09-05-2021,kancheepuram,4274,1089,488,19,4856,43394,1089,4,0,44487,39000,631
09-05-2021,kanyakumari,2746,515,331,1,2929,24973,515,124,0,25612,22325,358
09-05-2021,karur,1711,291,224,0,1778,9454,291,47,0,9792,7943,71
09-05-2021,krishnagiri,2375,485,510,3,2347,17648,485,220,0,18353,15859,147
09-05-2021,madurai,5805,1068,843,14,6016,37779,1068,171,0,39018,32409,593
09-05-2021,nagapattinam,2084,211,170,5,2120,15863,211,92,0,16166,13856,190
09-05-2021,namakkal,2110,216,388,4,1934,18488,216,107,0,18811,16741,136
09-05-2021,nilgiris,797,151,85,2,861,10741,151,41,0,10933,10019,53
09-05-2021,perambalur,452,141,36,0,557,3190,141,3,0,3334,2747,30
09-05-2021,pudukottai,1081,236,166,0,1151,14943,236,35,0,15214,13895,168
09-05-2021,ramanathapuram,1370,136,217,1,1288,9886,136,135,0,10157,8722,147
09-05-2021,ranipet,2325,391,464,6,2246,23700,391,49,0,24140,21647,247
09-05-2021,salem,3550,639,762,4,3423,45837,639,435,0,46911,42890,598
09-05-2021,sivagangai,788,138,161,0,765,9462,138,107,0,9707,8806,136
09-05-2021,tenkasi,1184,385,198,5,1366,13404,385,58,0,13847,12275,206
09-05-2021,thanjavur,2479,897,428,7,2941,28733,897,22,0,29652,26372,339
09-05-2021,theni,2579,450,378,1,2650,23197,450,45,0,23692,20809,233
09-05-2021,thirupathur,1135,284,182,9,1228,11367,284,118,0,11769,10358,183
09-05-2021,thiruvallur,7208,1768,1211,16,7749,69390,1768,10,0,71168,62523,896
09-05-2021,thiruvannamalai,1667,578,216,4,2025,25571,578,398,0,26547,24200,322
09-05-2021,thiruvarur,1598,302,271,3,1626,17061,302,38,0,17401,15642,133
09-05-2021,thoothukudi,4361,884,891,1,4353,28792,884,273,0,29949,25429,167
09-05-2021,tirunelveli,3614,668,555,6,3721,29452,668,427,0,30547,26557,269
09-05-2021,tiruppur,3039,641,461,1,3218,30525,641,11,0,31177,27706,253
09-05-2021,trichy,4207,813,625,10,4385,28523,813,59,0,29395,24742,268
09-05-2021,vellore,3001,588,540,15,3034,29551,560,1363,28,31502,28031,437
09-05-2021,villupuram,2657,383,427,2,2611,21867,383,174,0,22424,19672,141
09-05-2021,virudhunagar,1614,366,329,2,1649,21999,366,104,0,22469,20560,260
09-05-2021,airport surveillance (international),6,0,1,0,5,0,0,1004,0,1004,998,1
09-05-2021,airport surveillance (domestic),2,0,0,0,2,0,0,1075,0,1075,1072,1
09-05-2021,railway surveillance,0,0,0,0,0,0,0,428,0,428,428,0
10-05-2021,ariyalur,518,140,82,0,576,6304,140,20,0,6464,5834,54
10-05-2021,chengalpattu,14029,2181,3212,20,12978,97495,2181,5,0,99681,85631,1072
10-05-2021,chennai,32623,7149,4552,67,35153,390302,7149,47,0,397498,357069,5276
10-05-2021,coimbatore,11737,2781,1097,15,13406,95054,2781,51,0,97886,83706,774
10-05-2021,cuddalore,2410,523,388,2,2543,33473,523,203,0,34199,31294,362
10-05-2021,dharmapuri,1481,295,166,0,1610,11383,295,216,0,11894,10210,74
10-05-2021,dindigul,1778,340,229,1,1888,18172,340,77,0,18589,16465,236
10-05-2021,erode,3953,771,677,1,4046,26594,771,94,0,27459,23239,174
10-05-2021,kallakurichi,1047,159,169,0,1037,13547,159,404,0,14110,12955,118
10-05-2021,kancheepuram,4839,564,913,13,4477,44466,564,4,0,45034,39913,644
10-05-2021,kanyakumari,2934,710,588,20,3036,25493,710,124,0,26327,22913,378
10-05-2021,karur,1773,251,483,0,1541,9740,251,47,0,10038,8426,71
10-05-2021,krishnagiri,2349,895,256,4,2984,18135,895,220,0,19250,16115,151
10-05-2021,madurai,6014,1024,847,14,6177,38845,1024,171,0,40040,33256,607
10-05-2021,nagapattinam,2139,317,467,2,1987,16093,317,92,0,16502,14323,192
10-05-2021,namakkal,1957,352,408,1,1900,18727,352,107,0,19186,17149,137
10-05-2021,nilgiris,867,179,162,0,884,10898,179,41,0,11118,10181,53
10-05-2021,perambalur,561,180,32,1,708,3335,180,3,0,3518,2779,31
10-05-2021,pudukottai,1153,239,187,1,1204,15181,239,35,0,15455,14082,169
10-05-2021,ramanathapuram,1291,213,254,0,1250,10025,213,135,0,10373,8976,147
10-05-2021,ranipet,2254,434,660,1,2027,24099,434,49,0,24582,22307,248
10-05-2021,salem,3428,532,485,6,3469,46481,532,435,0,47448,43375,604
10-05-2021,sivagangai,770,196,110,1,855,9605,196,107,0,9908,8916,137
10-05-2021,tenkasi,1366,314,91,3,1586,13789,314,58,0,14161,12366,209
10-05-2021,thanjavur,2948,831,433,6,3340,29637,831,22,0,30490,26805,345
10-05-2021,theni,2638,491,384,3,2742,23635,491,45,0,24171,21193,236
10-05-2021,thirupathur,1217,353,109,6,1455,11640,353,118,0,12111,10467,189
10-05-2021,thiruvallur,7763,1008,581,8,8182,71172,1008,10,0,72190,63104,904
10-05-2021,thiruvannamalai,2053,662,238,6,2471,26177,662,398,0,27237,24438,328
10-05-2021,thiruvarur,1610,334,150,3,1791,17347,334,38,0,17719,15792,136
10-05-2021,thoothukudi,4369,777,237,1,4908,29692,775,273,2,30742,25666,168
10-05-2021,tirunelveli,3719,862,374,1,4206,30118,862,427,0,31407,26931,270
10-05-2021,tiruppur,3226,746,316,2,3654,31174,746,11,0,31931,28022,255
10-05-2021,trichy,4397,869,588,11,4667,29348,868,59,1,30276,25330,279
10-05-2021,vellore,3045,296,213,5,3123,30122,288,1391,8,31809,28244,442
10-05-2021,villupuram,2624,372,490,3,2503,22263,372,174,0,22809,20162,144
10-05-2021,virudhunagar,1660,638,275,4,2019,22376,638,104,0,23118,20835,264
10-05-2021,airport surveillance (international),5,0,0,0,5,0,0,1004,0,1004,998,1
10-05-2021,airport surveillance (domestic),2,0,1,0,1,0,0,1075,0,1075,1073,1
10-05-2021,railway surveillance,0,0,0,0,0,0,0,428,0,428,428,0
11-05-2021,ariyalur,579,106,61,0,624,6447,106,20,0,6573,5895,54
11-05-2021,chengalpattu,13004,2419,2366,19,13038,99702,2419,5,0,102126,87997,1091
11-05-2021,chennai,34922,7466,4583,92,37713,397220,7466,47,0,404733,361652,5368
11-05-2021,coimbatore,13416,2650,1723,19,14324,97845,2650,51,0,100546,85429,793
11-05-2021,cuddalore,2548,434,268,6,2708,34001,434,203,0,34638,31562,368
11-05-2021,dharmapuri,1610,193,140,1,1662,11678,193,216,0,12087,10350,75
11-05-2021,dindigul,1898,291,192,3,1994,18522,291,77,0,18890,16657,239
11-05-2021,erode,4047,925,547,4,4421,27365,925,94,0,28384,23786,177
11-05-2021,kallakurichi,1033,431,122,0,1342,13702,431,404,0,14537,13077,118
11-05-2021,kancheepuram,4497,664,456,9,4696,45050,664,4,0,45718,40369,653
11-05-2021,kanyakumari,3040,995,481,10,3544,26207,995,124,0,27326,23394,388
11-05-2021,karur,1541,166,242,6,1459,9991,166,47,0,10204,8668,77
11-05-2021,krishnagiri,2990,478,110,0,3358,19036,478,220,0,19734,16225,151
11-05-2021,madurai,6178,1024,628,13,6561,39870,1024,171,0,41065,33884,620
11-05-2021,nagapattinam,1991,454,373,11,2061,16415,454,92,0,16961,14696,204
11-05-2021,namakkal,1906,372,213,2,2063,19085,372,107,0,19564,17362,139
11-05-2021,nilgiris,885,170,140,3,912,11078,170,41,0,11289,10321,56
11-05-2021,perambalur,709,168,38,0,839,3516,168,3,0,3687,2817,31
11-05-2021,pudukottai,1213,176,154,0,1235,15429,176,35,0,15640,14236,169
11-05-2021,ramanathapuram,1253,222,161,0,1314,10241,222,135,0,10598,9137,147
11-05-2021,ranipet,2018,423,277,2,2162,24525,423,49,0,24997,22584,251
11-05-2021,salem,3475,475,457,18,3475,47019,475,435,0,47929,43832,622
11-05-2021,sivagangai,851,219,131,1,938,9797,219,107,0,10123,9047,138
11-05-2021,tenkasi,1591,232,152,4,1667,14110,232,58,0,14400,12518,215
11-05-2021,thanjavur,3342,452,334,10,3450,30469,452,22,0,30943,27139,354
11-05-2021,theni,2745,417,310,8,2844,24129,417,45,0,24591,21503,244
11-05-2021,thirupathur,1458,644,130,3,1969,11999,644,118,0,12761,10597,195
11-05-2021,thiruvallur,8231,1204,1309,17,8109,72229,1204,10,0,73443,64413,921
11-05-2021,thiruvannamalai,2493,732,180,1,3044,26861,732,398,0,27991,24618,329
11-05-2021,thiruvarur,1796,270,242,3,1821,17686,270,38,0,17994,16034,139
11-05-2021,thoothukudi,4914,628,633,3,4906,30473,628,275,0,31376,26299,171
11-05-2021,tirunelveli,4206,768,340,6,4628,30978,768,427,0,32173,27271,274
11-05-2021,tiruppur,3663,584,330,5,3912,31930,584,11,0,32525,28352,261
11-05-2021,trichy,4665,879,655,7,4882,30214,879,60,0,31153,25985,286
11-05-2021,vellore,3124,675,184,8,3607,30407,650,1399,25,32481,28428,446
11-05-2021,villupuram,2520,422,423,2,2517,22652,422,174,0,23248,20585,146
11-05-2021,virudhunagar,2031,444,97,2,2376,23026,444,104,0,23574,20932,266
11-05-2021,airport surveillance (international),5,0,0,0,5,0,0,1004,0,1004,998,1
11-05-2021,airport surveillance (domestic),1,0,0,0,1,0,0,1075,0,1075,1073,1
11-05-2021,railway surveillance,0,0,0,0,0,0,0,428,0,428,428,0
12-05-2021,ariyalur,620,149,63,0,706,6549,149,20,0,6718,5958,54
12-05-2021,chengalpattu,13054,2670,2406,28,13290,102137,2670,5,0,104812,90403,1119
12-05-2021,chennai,37920,7564,4782,89,40613,404894,7564,47,0,412505,366434,5458
12-05-2021,coimbatore,14326,2636,1766,18,15178,100497,2636,51,0,103184,87195,811
12-05-2021,cuddalore,2707,530,250,9,2978,34434,530,203,0,35167,31812,377
12-05-2021,dharmapuri,1659,200,180,0,1679,11868,200,216,0,12284,10530,75
12-05-2021,dindigul,1976,358,251,6,2077,18795,358,77,0,19230,16908,245
12-05-2021,erode,4422,961,566,2,4815,28291,961,94,0,29346,24352,179
12-05-2021,kallakurichi,1342,144,100,0,1386,14133,144,404,0,14681,13177,118
12-05-2021,kancheepuram,4621,767,693,13,4682,45639,767,4,0,46410,41062,666
12-05-2021,kanyakumari,3548,1076,477,4,4143,27206,1076,124,0,28406,23871,392
12-05-2021,karur,1454,246,215,3,1482,10152,246,47,0,10445,8883,80
12-05-2021,krishnagiri,3362,497,130,1,3728,19518,497,220,0,20235,16355,152
12-05-2021,madurai,6561,1172,650,7,7076,40894,1172,171,0,42237,34534,627
12-05-2021,nagapattinam,2057,322,329,4,2046,16865,322,92,0,17279,15025,208
12-05-2021,namakkal,2068,354,300,6,2116,19462,354,107,0,19923,17662,145
12-05-2021,nilgiris,912,186,113,2,983,11248,186,41,0,11475,10434,58
12-05-2021,perambalur,841,206,41,1,1005,3686,206,3,0,3895,2858,32
12-05-2021,pudukottai,1234,263,170,2,1325,15604,263,35,0,15902,14406,171
12-05-2021,ramanathapuram,1316,333,128,0,1521,10465,333,135,0,10933,9265,147
12-05-2021,ranipet,2182,173,252,4,2099,24968,173,49,0,25190,22836,255
12-05-2021,salem,3478,664,307,10,3825,47497,664,435,0,48596,44139,632
12-05-2021,sivagangai,933,197,78,1,1051,10011,197,107,0,10315,9125,139
12-05-2021,tenkasi,1677,324,162,3,1836,14352,324,58,0,14734,12680,218
12-05-2021,thanjavur,3460,646,160,7,3939,30931,646,22,0,31599,27299,361
12-05-2021,theni,2852,438,237,4,3049,24554,438,45,0,25037,21740,248
12-05-2021,thirupathur,1970,329,214,7,2078,12644,329,118,0,13091,10811,202
12-05-2021,thiruvallur,7982,1344,1491,21,7814,73306,1344,10,0,74660,65904,942
12-05-2021,thiruvannamalai,3056,600,324,7,3325,27605,600,398,0,28603,24942,336
12-05-2021,thiruvarur,1827,310,272,2,1863,17961,310,38,0,18309,16306,140
12-05-2021,thoothukudi,4922,748,717,2,4951,31117,748,275,0,32140,27016,173
12-05-2021,tirunelveli,4592,742,385,3,4946,31710,742,427,0,32879,27656,277
12-05-2021,tiruppur,3920,647,250,3,4314,32522,647,11,0,33180,28602,264
12-05-2021,trichy,4823,879,255,12,5435,31034,879,60,0,31973,26240,298
12-05-2021,vellore,3593,577,229,8,3933,31043,558,1424,19,33044,28657,454
12-05-2021,villupuram,2520,568,485,1,2602,23077,568,174,0,23819,21070,147
12-05-2021,virudhunagar,2388,535,80,3,2840,23482,535,104,0,24121,21012,269
12-05-2021,airport surveillance (international),5,0,0,0,5,0,0,1004,0,1004,998,1
12-05-2021,airport surveillance (domestic),1,0,0,0,1,0,0,1075,0,1075,1073,1
12-05-2021,railway surveillance,0,0,0,0,0,0,0,428,0,428,428,0
14-05-2021,ariyalur,848,207,17,1,1037,6878,207,20,0,7105,6013,55
14-05-2021,chengalpattu,14131,2225,2593,21,13742,107071,2225,5,0,109301,94386,1173
14-05-2021,chennai,42382,6538,4533,74,44313,419018,6538,47,0,425603,375669,5621
14-05-2021,coimbatore,16277,3197,1171,13,18290,105985,3197,51,0,109233,90106,837
14-05-2021,cuddalore,3416,645,273,3,3785,35636,645,203,0,36484,32315,384
14-05-2021,dharmapuri,1774,271,110,0,1935,12282,271,216,0,12769,10756,78
14-05-2021,dindigul,2181,429,365,2,2243,19556,429,77,0,20062,17565,254
14-05-2021,erode,5142,781,613,6,5304,30160,781,94,0,31035,25545,186
14-05-2021,kallakurichi,1473,179,81,0,1571,14428,179,404,0,15011,13322,118
14-05-2021,kancheepuram,4643,889,629,17,4886,47074,889,4,0,47967,42386,695
14-05-2021,kanyakumari,4774,1025,287,11,5501,29368,1025,124,0,30517,24595,421
14-05-2021,karur,1545,319,290,8,1566,10723,319,47,0,11089,9431,92
14-05-2021,krishnagiri,4142,712,319,4,4531,20636,712,220,0,21568,16881,156
14-05-2021,madurai,7606,1250,746,11,8099,43411,1250,171,0,44832,36086,647
14-05-2021,nagapattinam,2024,396,368,2,2050,17542,396,92,0,18030,15766,214
14-05-2021,namakkal,2238,560,339,4,2455,20280,560,107,0,20947,18339,153
14-05-2021,nilgiris,1119,306,85,0,1340,11658,306,41,0,12005,10606,59
14-05-2021,perambalur,1137,140,80,3,1194,4082,140,3,0,4225,2996,35
14-05-2021,pudukottai,1497,342,108,0,1731,16166,342,35,0,16543,14641,171
14-05-2021,ramanathapuram,1681,310,182,1,1808,11092,310,135,0,11537,9581,148
14-05-2021,ranipet,2317,596,165,4,2744,25580,596,49,0,26225,23214,267
14-05-2021,salem,4119,798,671,18,4228,48940,798,435,0,50173,45289,656
14-05-2021,sivagangai,1181,242,113,2,1308,10403,242,107,0,10752,9303,141
14-05-2021,tenkasi,2055,443,271,11,2216,15034,443,58,0,15535,13084,235
14-05-2021,thanjavur,4456,618,176,7,4891,32263,618,22,0,32903,27637,375
14-05-2021,theni,3340,447,228,4,3555,25483,447,45,0,25975,22164,256
14-05-2021,thirupathur,2238,328,310,1,2255,13368,328,118,0,13814,11345,214
14-05-2021,thiruvallur,8099,1410,1503,14,7992,76090,1410,10,0,77510,68540,978
14-05-2021,thiruvannamalai,3521,397,153,3,3762,28827,397,398,0,29622,25520,340
14-05-2021,thiruvarur,1896,324,346,1,1873,18644,324,38,0,19006,16987,146
14-05-2021,thoothukudi,4798,885,605,4,5074,32363,885,275,0,33523,28266,183
14-05-2021,tirunelveli,5383,831,346,3,5865,33242,831,427,0,34500,28351,284
14-05-2021,tiruppur,4758,771,343,7,5179,33879,771,11,0,34661,29210,272
14-05-2021,trichy,5804,1224,692,8,6328,32879,1224,60,0,34163,27519,316
14-05-2021,vellore,3821,555,591,10,3775,32238,548,1456,7,34249,30010,464
14-05-2021,villupuram,2652,679,247,5,3079,24229,679,174,0,25082,21850,153
14-05-2021,virudhunagar,3302,623,88,5,3832,24587,623,104,0,25314,21205,277
14-05-2021,airport surveillance (international),2,0,0,0,2,0,0,1004,0,1004,1001,1
14-05-2021,airport surveillance (domestic),0,0,0,0,0,0,0,1075,0,1075,1074,1
14-05-2021,railway surveillance,0,0,0,0,0,0,0,428,0,428,428,0
15-05-2021,ariyalur,1036,254,67,6,1217,7084,254,20,0,7358,6080,61
15-05-2021,chengalpattu,13722,2013,2000,24,13711,109277,2013,5,0,111295,96386,1198
15-05-2021,chennai,44414,6640,4605,82,46367,425657,6640,47,0,432344,380274,5703
15-05-2021,coimbatore,18291,3124,1222,20,20173,109183,3124,51,0,112358,91328,857
15-05-2021,cuddalore,3783,719,303,5,4194,36279,719,203,0,37201,32618,389
15-05-2021,dharmapuri,1932,289,133,3,2085,12550,289,216,0,13055,10889,81
15-05-2021,dindigul,2234,458,280,3,2409,19976,458,77,0,20511,17845,257
15-05-2021,erode,5307,827,635,2,5497,30944,827,94,0,31865,26180,188
15-05-2021,kallakurichi,1572,312,82,0,1802,14608,312,404,0,15324,13404,118
15-05-2021,kancheepuram,4858,1521,580,10,5789,47934,1521,4,0,49459,42966,704
15-05-2021,kanyakumari,5503,1237,279,18,6443,30395,1237,124,0,31756,24874,439
15-05-2021,karur,1573,347,300,3,1617,11049,347,47,0,11443,9731,95
15-05-2021,krishnagiri,4528,680,246,2,4960,21345,679,220,1,22245,17127,158
15-05-2021,madurai,8096,1231,619,17,8691,44658,1231,171,0,46060,36705,664
15-05-2021,nagapattinam,2053,566,242,7,2370,17941,566,92,0,18599,16008,221
15-05-2021,namakkal,2455,639,311,4,2779,20840,639,107,0,21586,18650,157
15-05-2021,nilgiris,1344,330,71,0,1603,11968,330,41,0,12339,10677,59
15-05-2021,perambalur,1196,178,102,1,1271,4224,178,3,0,4405,3098,36
15-05-2021,pudukottai,1730,359,142,0,1947,16507,359,35,0,16901,14783,171
15-05-2021,ramanathapuram,1808,399,160,0,2047,11402,399,135,0,11936,9741,148
15-05-2021,ranipet,2747,439,130,4,3052,26179,439,49,0,26667,23344,271
15-05-2021,salem,4229,829,737,12,4309,49739,829,435,0,51003,46026,668
15-05-2021,sivagangai,1302,249,130,1,1420,10639,249,107,0,10995,9433,142
15-05-2021,tenkasi,2216,424,183,1,2456,15477,424,58,0,15959,13267,236
15-05-2021,thanjavur,4894,665,863,11,4685,32884,665,22,0,33571,28500,386
15-05-2021,theni,3552,502,250,6,3798,25927,502,45,0,26474,22414,262
15-05-2021,thirupathur,2258,458,259,3,2454,13700,458,118,0,14276,11604,218
15-05-2021,thiruvallur,7953,1551,1752,22,7730,77461,1551,10,0,79022,70292,1000
15-05-2021,thiruvannamalai,3771,612,210,4,4169,29233,612,398,0,30243,25730,344
15-05-2021,thiruvarur,1874,340,289,2,1923,18969,340,38,0,19347,17276,148
15-05-2021,thoothukudi,5075,896,650,2,5319,33249,896,275,0,34420,28916,185
15-05-2021,tirunelveli,5863,661,390,2,6132,34071,661,427,0,35159,28741,286
15-05-2021,tiruppur,5181,1008,549,1,5639,34652,1008,11,0,35671,29759,273
15-05-2021,trichy,6300,1263,822,11,6730,34075,1263,60,0,35398,28341,327
15-05-2021,vellore,3772,549,577,10,3734,32782,543,1463,6,34794,30587,473
15-05-2021,villupuram,3081,519,333,1,3266,24910,519,174,0,25603,22183,154
15-05-2021,virudhunagar,3834,570,402,3,3999,25212,570,104,0,25886,21607,280
15-05-2021,airport surveillance (international),2,0,0,0,2,0,0,1004,0,1004,1001,1
15-05-2021,airport surveillance (domestic),0,0,0,0,0,0,0,1075,0,1075,1074,1
15-05-2021,railway surveillance,0,0,0,0,0,0,0,428,0,428,428,0
16-05-2021,ariyalur,1213,227,24,1,1415,7334,227,20,0,7581,6104,62
16-05-2021,chengalpattu,13794,2041,2015,32,13788,111373,2041,5,0,113419,98401,1230
16-05-2021,chennai,46166,6247,5023,60,47330,432097,6247,47,0,438391,385297,5764
16-05-2021,coimbatore,20181,3166,1151,15,22181,112315,3166,51,0,115532,92479,872
16-05-2021,cuddalore,4201,853,272,9,4773,37006,853,203,0,38062,32890,399
16-05-2021,dharmapuri,2081,339,190,4,2226,12835,339,216,0,13390,11079,85
16-05-2021,dindigul,2408,380,443,3,2342,20434,380,77,0,20891,18288,261
16-05-2021,erode,5500,1232,642,2,6088,31774,1232,94,0,33100,26822,190
16-05-2021,kallakurichi,1803,521,76,0,2248,14921,521,404,0,15846,13480,118
16-05-2021,kancheepuram,5813,1119,1159,9,5764,49478,1119,4,0,50601,44125,712
16-05-2021,kanyakumari,6451,1030,310,12,7159,31640,1030,124,0,32794,25184,451
16-05-2021,karur,1608,193,264,10,1527,11387,193,47,0,11627,9995,105
16-05-2021,krishnagiri,4967,684,112,0,5539,22031,683,221,1,22936,17239,158
16-05-2021,madurai,8700,1095,534,15,9246,45893,1095,171,0,47159,37239,674
16-05-2021,nagapattinam,2368,604,327,7,2638,18505,604,92,0,19201,16335,228
16-05-2021,namakkal,2789,370,445,6,2708,21489,370,107,0,21966,19095,163
16-05-2021,nilgiris,1603,377,70,0,1910,12298,377,41,0,12716,10747,59
16-05-2021,perambalur,1272,255,47,2,1478,4403,255,3,0,4661,3145,38
16-05-2021,pudukottai,1945,334,149,1,2129,16864,334,35,0,17233,14932,172
16-05-2021,ramanathapuram,2048,215,128,0,2135,11803,215,135,0,12153,9869,149
16-05-2021,ranipet,3069,227,314,6,2976,26635,227,49,0,26911,23658,277
16-05-2021,salem,4312,822,158,7,4969,50572,822,435,0,51829,46184,676
16-05-2021,sivagangai,1423,223,139,0,1507,10891,223,107,0,11221,9572,142
16-05-2021,tenkasi,2456,456,147,4,2761,15902,456,58,0,16416,13414,241
16-05-2021,thanjavur,4686,650,903,7,4426,33549,650,22,0,34221,29403,392
16-05-2021,theni,3808,672,402,5,4073,26440,672,45,0,27157,22816,268
16-05-2021,thirupathur,2452,501,275,4,2674,14159,501,118,0,14778,11879,225
16-05-2021,thiruvallur,7723,1835,1091,15,8452,79005,1835,10,0,80850,71383,1015
16-05-2021,thiruvannamalai,4193,435,417,4,4207,29869,435,398,0,30702,26147,348
16-05-2021,thiruvarur,1931,529,341,1,2118,19317,529,38,0,19884,17617,149
16-05-2021,thoothukudi,5320,914,846,4,5384,34146,914,275,0,35335,29762,189
16-05-2021,tirunelveli,6131,692,270,6,6547,34730,692,427,0,35849,29011,291
16-05-2021,tiruppur,5641,919,533,2,6025,35662,919,11,0,36592,30292,275
16-05-2021,trichy,6738,1569,815,10,7482,35346,1569,60,0,36975,29156,337
16-05-2021,vellore,3717,528,571,44,3630,33305,520,1469,8,35302,31158,514
16-05-2021,villupuram,3273,488,417,3,3341,25436,488,174,0,26098,22600,157
16-05-2021,virudhunagar,4003,439,297,1,4144,25787,439,104,0,26330,21904,282
16-05-2021,airport surveillance (international),2,0,0,0,2,0,0,1004,0,1004,1001,1
16-05-2021,airport surveillance (domestic),0,0,0,0,0,0,0,1075,0,1075,1074,1
16-05-2021,railway surveillance,0,0,0,0,0,0,0,428,0,428,428,0
17-05-2021,ariyalur,1418,191,140,0,1469,7564,191,20,0,7775,6244,62
17-05-2021,chengalpattu,13810,2154,1025,33,14906,113436,2154,5,0,115595,99426,1263
17-05-2021,chennai,47159,6150,5067,86,48156,438174,6150,47,0,444371,390364,5851
17-05-2021,coimbatore,22189,3264,1244,14,24195,115489,3264,51,0,118804,93723,886
17-05-2021,cuddalore,4776,765,563,1,4977,37862,765,203,0,38830,33453,400
17-05-2021,dharmapuri,2221,345,116,3,2447,13169,345,216,0,13730,11195,88
17-05-2021,dindigul,2340,367,220,8,2479,20812,367,77,0,21256,18508,269
17-05-2021,erode,6084,1093,416,8,6753,33002,1093,94,0,34189,27238,198
17-05-2021,kallakurichi,2252,375,276,0,2351,15446,375,404,0,16225,13756,118
17-05-2021,kancheepuram,5770,1241,880,12,6119,50603,1241,4,0,51848,45005,724
17-05-2021,kanyakumari,7161,1069,414,14,7802,32672,1069,124,0,33865,25598,465
17-05-2021,karur,1516,272,105,2,1681,11569,272,47,0,11888,10100,107
17-05-2021,krishnagiri,5544,714,266,1,5991,22719,714,222,0,23655,17505,159
17-05-2021,madurai,9241,1288,679,17,9833,46982,1288,171,0,48441,37918,690
17-05-2021,nagapattinam,2643,655,183,3,3112,19115,655,92,0,19862,16518,232
17-05-2021,namakkal,2715,427,258,3,2881,21866,427,107,0,22400,19353,166
17-05-2021,nilgiris,1910,371,154,1,2126,12675,371,41,0,13087,10901,60
17-05-2021,perambalur,1484,135,43,2,1574,4664,135,3,0,4802,3188,40
17-05-2021,pudukottai,2127,407,285,2,2247,17196,407,35,0,17638,15217,174
17-05-2021,ramanathapuram,2138,341,86,1,2392,12022,341,135,0,12498,9955,151
17-05-2021,ranipet,2984,415,483,5,2911,26872,415,49,0,27336,24141,284
17-05-2021,salem,4979,603,650,9,4923,51404,603,435,0,52442,46834,685
17-05-2021,sivagangai,1502,232,172,1,1561,11109,232,107,0,11448,9744,143
17-05-2021,tenkasi,2756,377,429,1,2703,16353,377,58,0,16788,13843,242
17-05-2021,thanjavur,4428,1019,830,11,4606,34200,1019,22,0,35241,30233,402
17-05-2021,theni,4071,696,208,6,4553,27110,696,45,0,27851,23024,274
17-05-2021,thirupathur,2671,654,187,2,3136,14656,654,118,0,15428,12066,226
17-05-2021,thiruvallur,8508,1829,500,20,9817,80896,1829,10,0,82735,71883,1035
17-05-2021,thiruvannamalai,4227,492,436,7,4276,30324,492,398,0,31214,26583,355
17-05-2021,thiruvarur,2121,551,165,6,2501,19849,551,38,0,20438,17782,155
17-05-2021,thoothukudi,5390,1024,941,5,5468,35066,1024,275,0,36365,30703,194
17-05-2021,tirunelveli,6557,342,365,6,6528,35432,342,427,0,36201,29376,297
17-05-2021,tiruppur,6033,880,629,5,6279,36589,880,11,0,37480,30921,280
17-05-2021,trichy,7488,1544,860,15,8157,36921,1544,60,0,38525,30016,352
17-05-2021,vellore,3633,222,525,9,3321,33826,219,1477,3,35525,31683,521
17-05-2021,villupuram,3346,349,336,12,3347,25929,349,174,0,26452,22936,169
17-05-2021,virudhunagar,4148,222,350,4,4016,26230,222,104,0,26556,22254,286
17-05-2021,airport surveillance (international),2,0,0,0,2,0,0,1004,0,1004,1001,1
17-05-2021,airport surveillance (domestic),0,0,0,0,0,0,0,1075,0,1075,1074,1
17-05-2021,railway surveillance,0,0,0,0,0,0,0,428,0,428,428,0
18-05-2021,ariyalur,1469,176,134,0,1511,7755,176,20,0,7951,6378,62
18-05-2021,chengalpattu,14910,2299,2001,37,15171,115594,2299,5,0,117898,101427,1300
18-05-2021,chennai,48033,6016,5509,85,48455,444204,6016,47,0,450267,395873,5939
18-05-2021,coimbatore,24204,3071,1305,19,25951,118762,3071,51,0,121884,95028,905
18-05-2021,cuddalore,4990,591,97,3,5481,38640,591,203,0,39434,33550,403
18-05-2021,dharmapuri,2447,295,453,2,2287,13514,295,216,0,14025,11648,90
18-05-2021,dindigul,2474,323,191,6,2600,21174,323,77,0,21574,18699,275
18-05-2021,erode,6756,1568,669,3,7652,34098,1568,94,0,35760,27907,201
18-05-2021,kallakurichi,2335,291,259,0,2367,15805,291,404,0,16500,14015,118
18-05-2021,kancheepuram,6163,761,300,19,6605,51888,761,4,0,52653,45305,743
18-05-2021,kanyakumari,7803,863,398,20,8248,33742,863,124,0,34729,25996,485
18-05-2021,karur,1682,313,5,9,1981,11842,313,47,0,12202,10105,116
18-05-2021,krishnagiri,5993,610,249,2,6352,23435,610,222,0,24267,17754,161
18-05-2021,madurai,9833,1011,712,15,10117,48270,1011,171,0,49452,38630,705
18-05-2021,nagapattinam,3103,652,265,9,3481,19761,652,92,0,20505,16783,241
18-05-2021,namakkal,2884,384,120,1,3147,22296,384,107,0,22787,19473,167
18-05-2021,nilgiris,2126,340,180,4,2282,13046,340,41,0,13427,11081,64
18-05-2021,perambalur,1574,243,139,2,1676,4799,243,3,0,5045,3327,42
18-05-2021,pudukottai,2237,234,227,2,2242,17593,234,35,0,17862,15444,176
18-05-2021,ramanathapuram,2393,192,1,0,2584,12364,192,135,0,12691,9956,151
18-05-2021,ranipet,2912,539,450,3,2998,27289,539,49,0,27877,24591,288
18-05-2021,salem,4930,650,650,16,4914,52014,650,435,0,53099,47484,701
18-05-2021,sivagangai,1556,184,222,2,1516,11336,184,107,0,11627,9966,145
18-05-2021,tenkasi,2700,346,242,2,2802,16727,346,58,0,17131,14085,244
18-05-2021,thanjavur,4623,475,455,9,4634,35236,475,22,0,35733,30688,411
18-05-2021,theni,4552,667,442,1,4776,27805,667,45,0,28517,23466,275
18-05-2021,thirupathur,3139,806,405,3,3537,15314,806,118,0,16238,12471,230
18-05-2021,thiruvallur,9834,1890,679,28,11017,82741,1890,10,0,84641,72562,1062
18-05-2021,thiruvannamalai,4286,456,462,4,4276,30826,456,398,0,31680,27045,359
18-05-2021,thiruvarur,2510,805,106,0,3209,20409,805,38,0,21252,17888,155
18-05-2021,thoothukudi,5476,1352,506,4,6318,36099,1352,275,0,37726,31209,199
18-05-2021,tirunelveli,6526,589,676,5,6434,35770,589,427,0,36786,30052,300
18-05-2021,tiruppur,6275,1561,741,3,7092,37465,1561,11,0,39037,31662,283
18-05-2021,trichy,8164,1271,877,16,8542,38472,1271,60,0,39803,30893,368
18-05-2021,vellore,3328,520,363,14,3471,34049,508,1480,12,36049,32046,532
18-05-2021,villupuram,3356,239,200,9,3386,26287,239,174,0,26700,23136,178
18-05-2021,virudhunagar,4018,476,672,7,3815,26454,476,104,0,27034,22926,293
18-05-2021,airport surveillance (international),2,0,0,0,2,0,0,1004,0,1004,1001,1
18-05-2021,airport surveillance (domestic),0,0,0,0,0,0,0,1075,0,1075,1074,1
18-05-2021,railway surveillance,0,0,0,0,0,0,0,428,0,428,428,0
19-05-2021,ariyalur,1511,259,144,2,1624,7931,259,20,0,8210,6522,64
19-05-2021,chengalpattu,15224,2275,2216,46,15237,117948,2275,5,0,120228,103643,1348
19-05-2021,chennai,48386,6297,6266,91,48326,450152,6297,47,0,456496,402139,6031
19-05-2021,coimbatore,25968,3250,2012,17,27189,121850,3250,51,0,125151,97040,922
19-05-2021,cuddalore,5489,848,308,13,6016,39239,848,203,0,40290,33858,416
19-05-2021,dharmapuri,2291,331,300,1,2321,13813,331,216,0,14360,11948,91
19-05-2021,dindigul,2611,385,363,2,2631,21508,385,77,0,21970,19062,277
19-05-2021,erode,7637,1362,804,9,8186,35651,1362,94,0,37107,28711,210
19-05-2021,kallakurichi,2371,361,191,0,2541,16100,361,404,0,16865,14206,118
19-05-2021,kancheepuram,6621,811,767,8,6657,52665,811,4,0,53480,46072,751
19-05-2021,kanyakumari,8249,884,507,23,8603,34606,884,124,0,35614,26503,508
19-05-2021,karur,1985,376,234,5,2122,12159,376,47,0,12582,10339,121
19-05-2021,krishnagiri,6359,712,329,4,6738,24052,712,222,0,24986,18083,165
19-05-2021,madurai,10119,1156,135,14,11126,49283,1156,171,0,50610,38765,719
19-05-2021,nagapattinam,3475,603,348,8,3722,20407,603,92,0,21102,17131,249
19-05-2021,namakkal,3150,410,362,3,3195,22683,410,107,0,23200,19835,170
19-05-2021,nilgiris,2283,320,170,1,2432,13386,320,41,0,13747,11251,64
19-05-2021,perambalur,1677,218,115,0,1780,5043,218,3,0,5264,3442,42
19-05-2021,pudukottai,2237,426,206,4,2453,17822,426,35,0,18283,15650,180
19-05-2021,ramanathapuram,2581,378,197,1,2761,12553,378,135,0,13066,10153,152
19-05-2021,ranipet,3005,333,202,7,3129,27835,333,49,0,28217,24793,295
19-05-2021,salem,4915,795,550,15,5145,52665,795,435,0,53895,48034,716
19-05-2021,sivagangai,1521,210,198,0,1533,11525,210,107,0,11842,10164,145
19-05-2021,tenkasi,2802,427,125,1,3103,17073,427,58,0,17558,14210,245
19-05-2021,thanjavur,4642,813,649,6,4800,35718,813,22,0,36553,31337,416
19-05-2021,theni,4769,808,386,1,5190,28465,808,45,0,29318,23852,276
19-05-2021,thirupathur,3514,544,303,7,3748,16099,544,118,0,16761,12774,239
19-05-2021,thiruvallur,10930,1778,1300,18,11390,84545,1778,10,0,86333,73862,1081
19-05-2021,thiruvannamalai,4288,590,280,4,4594,31294,590,398,0,32282,27325,363
19-05-2021,thiruvarur,3207,717,308,1,3615,21212,717,38,0,21967,18196,156
19-05-2021,thoothukudi,6320,928,764,1,6483,37453,928,275,0,38656,31973,200
19-05-2021,tirunelveli,6436,665,468,8,6625,36361,665,427,0,37453,30520,308
19-05-2021,tiruppur,7092,1573,575,2,8088,39026,1573,11,0,40610,32237,285
19-05-2021,trichy,8552,1459,396,13,9602,39753,1459,60,0,41272,31289,381
19-05-2021,vellore,3494,586,369,16,3695,34576,578,1492,8,36654,32415,544
19-05-2021,villupuram,3393,542,578,6,3351,26533,542,174,0,27249,23714,184
19-05-2021,virudhunagar,3823,445,438,7,3823,26938,445,104,0,27487,23364,300
19-05-2021,airport surveillance (international),2,0,0,0,2,0,0,1004,0,1004,1001,1
19-05-2021,airport surveillance (domestic),0,0,0,0,0,0,0,1075,0,1075,1074,1
19-05-2021,railway surveillance,0,0,0,0,0,0,0,428,0,428,428,0
20-05-2021,ariyalur,1623,267,132,0,1758,8189,267,20,0,8476,6654,64
20-05-2021,chengalpattu,15283,2092,2091,44,15240,120272,2092,5,0,122369,105734,1395
20-05-2021,chennai,48204,6073,6537,73,47667,456328,6073,47,0,462448,408676,6105
20-05-2021,coimbatore,27196,3335,2148,20,28363,125107,3335,51,0,128493,99188,942
20-05-2021,cuddalore,6020,854,284,5,6585,40091,854,203,0,41148,34142,421
20-05-2021,dharmapuri,2326,362,80,1,2607,14149,362,216,0,14727,12028,92
20-05-2021,dindigul,2625,389,393,19,2602,21887,389,77,0,22353,19455,296
20-05-2021,erode,8188,1505,783,6,8904,37015,1505,94,0,38614,29494,216
20-05-2021,kallakurichi,2542,398,97,1,2842,16462,398,404,0,17264,14303,119
20-05-2021,kancheepuram,6695,858,692,27,6834,53511,858,4,0,54373,46764,775
20-05-2021,kanyakumari,8604,1096,576,18,9106,35491,1096,124,0,36711,27079,526
20-05-2021,karur,2122,297,335,10,2074,12535,297,47,0,12879,10674,131
20-05-2021,krishnagiri,6737,729,458,5,7003,24763,727,222,2,25714,18541,170
20-05-2021,madurai,11128,1269,628,11,11758,50441,1269,171,0,51881,39393,730
20-05-2021,nagapattinam,3725,711,339,2,4095,21014,711,92,0,21817,17470,252
20-05-2021,namakkal,3195,381,354,2,3220,23093,381,107,0,23581,20189,172
20-05-2021,nilgiris,2432,325,185,2,2570,13706,325,41,0,14072,11436,66
20-05-2021,perambalur,1787,196,127,0,1856,5268,196,3,0,5467,3569,42
20-05-2021,pudukottai,2457,442,227,1,2671,18252,442,35,0,18729,15877,181
20-05-2021,ramanathapuram,2761,350,161,0,2950,12931,350,135,0,13416,10314,152
20-05-2021,ranipet,3142,719,465,15,3381,28181,719,49,0,28949,25258,310
20-05-2021,salem,5150,667,853,11,4953,53465,667,435,0,54567,48887,727
20-05-2021,sivagangai,1528,237,214,0,1551,11730,237,107,0,12074,10378,145
20-05-2021,tenkasi,3103,452,256,3,3296,17501,452,58,0,18011,14466,249
20-05-2021,thanjavur,4800,679,689,9,4781,36530,679,22,0,37231,32026,424
20-05-2021,theni,5186,689,554,7,5314,29269,689,45,0,30003,24406,283
20-05-2021,thirupathur,3746,565,296,7,4008,16645,565,118,0,17328,13070,250
20-05-2021,thiruvallur,11361,1791,1335,20,11797,86294,1791,10,0,88095,75197,1101
20-05-2021,thiruvannamalai,4602,674,306,5,4965,31892,674,398,0,32964,27631,368
20-05-2021,thiruvarur,3617,734,376,3,3972,21931,734,38,0,22703,18572,159
20-05-2021,thoothukudi,6481,1004,441,4,7040,38379,1004,275,0,39658,32414,204
20-05-2021,tirunelveli,6634,589,497,4,6722,37033,589,427,0,38049,31017,310
20-05-2021,tiruppur,8089,1581,627,5,9038,40600,1581,11,0,42192,32864,290
20-05-2021,trichy,9606,1375,501,13,10467,41216,1375,60,0,42651,31790,394
20-05-2021,vellore,3695,567,539,36,3687,35149,560,1500,7,37216,32954,575
20-05-2021,villupuram,3358,532,382,5,3503,27082,532,174,0,27788,24096,189
20-05-2021,virudhunagar,3826,795,410,3,4208,27387,795,104,0,28286,23774,304
20-05-2021,airport surveillance (international),2,0,0,0,2,0,0,1004,0,1004,1001,1
20-05-2021,airport surveillance (domestic),0,0,0,0,0,0,0,1075,0,1075,1074,1
20-05-2021,railway surveillance,0,0,0,0,0,0,0,428,0,428,428,0
21-05-2021,ariyalur,1758,283,135,0,1906,8456,283,20,0,8759,6789,64
21-05-2021,chengalpattu,15317,2226,2173,40,15330,122441,2226,5,0,124672,107907,1435
21-05-2021,chennai,47568,5913,4590,109,48782,462302,5913,47,0,468262,413266,6214
21-05-2021,coimbatore,28371,3243,2244,25,29345,128450,3243,51,0,131744,101432,967
21-05-2021,cuddalore,6591,864,363,8,7084,40951,864,203,0,42018,34505,429
21-05-2021,dharmapuri,2606,387,198,2,2793,14510,387,216,0,15113,12226,94
21-05-2021,dindigul,2595,431,295,15,2716,22270,431,77,0,22778,19750,312
21-05-2021,erode,8889,1656,812,11,9722,38504,1656,94,0,40254,30306,226
21-05-2021,kallakurichi,2844,299,89,1,3053,16862,299,404,0,17565,14392,120
21-05-2021,kancheepuram,6859,1145,867,12,7125,54394,1145,4,0,55543,47631,787
21-05-2021,kanyakumari,9108,1251,295,16,10048,36590,1251,124,0,37965,27374,543
21-05-2021,karur,2075,344,306,8,2105,12833,344,47,0,13224,10980,139
21-05-2021,krishnagiri,7005,739,297,3,7444,25492,737,224,2,26455,18838,173
21-05-2021,madurai,11765,1355,787,27,12306,51717,1355,171,0,53243,40180,757
21-05-2021,nagapattinam,4095,585,377,16,4287,21725,585,92,0,22402,17847,268
21-05-2021,namakkal,3227,405,388,8,3236,23481,405,107,0,23993,20577,180
21-05-2021,nilgiris,2570,357,224,1,2702,14031,357,41,0,14429,11660,67
21-05-2021,perambalur,1861,202,83,1,1979,5469,202,3,0,5674,3652,43
21-05-2021,pudukottai,2672,423,111,1,2983,18696,423,35,0,19154,15988,183
21-05-2021,ramanathapuram,2954,367,325,2,2994,13285,367,135,0,13787,10639,154
21-05-2021,ranipet,3384,635,750,12,3257,28903,635,49,0,29587,26008,322
21-05-2021,salem,4957,725,435,13,5234,54136,725,435,0,55296,49322,740
21-05-2021,sivagangai,1540,224,184,1,1579,11956,224,107,0,12287,10562,146
21-05-2021,tenkasi,3294,439,262,2,3469,17951,439,58,0,18448,14728,251
21-05-2021,thanjavur,4784,824,199,10,5399,37211,824,22,0,38057,32225,433
21-05-2021,theni,5314,723,628,6,5403,29958,723,45,0,30726,25034,289
21-05-2021,thirupathur,4007,630,491,6,4140,17209,630,118,0,17957,13561,256
21-05-2021,thiruvallur,11716,1667,1305,32,12046,88004,1667,10,0,89681,76502,1133
21-05-2021,thiruvannamalai,4972,726,294,8,5396,32573,726,398,0,33697,27925,376
21-05-2021,thiruvarur,3980,731,325,1,4385,22673,731,38,0,23442,18897,160
21-05-2021,thoothukudi,7049,882,914,6,7011,39392,882,275,0,40549,33328,210
21-05-2021,tirunelveli,6720,678,588,4,6806,37619,678,427,0,38724,31605,313
21-05-2021,tiruppur,9050,1796,704,10,10132,42193,1796,11,0,44000,33568,300
21-05-2021,trichy,10478,1331,933,15,10861,42602,1331,60,0,43993,32723,409
21-05-2021,vellore,3694,358,574,13,3465,35716,354,1507,4,37581,33528,588
21-05-2021,villupuram,3507,490,678,9,3310,27618,490,174,0,28282,24774,198
21-05-2021,virudhunagar,4212,850,255,13,4794,28186,850,104,0,29140,24029,317
21-05-2021,airport surveillance (international),2,0,0,0,2,0,0,1004,0,1004,1001,1
21-05-2021,airport surveillance (domestic),0,0,0,0,0,0,0,1075,0,1075,1074,1
21-05-2021,railway surveillance,0,0,0,0,0,0,0,428,0,428,428,0
22-05-2021,ariyalur,1906,275,229,2,1950,8739,275,20,0,9034,7018,66
22-05-2021,chengalpattu,15360,1954,2155,38,15121,124698,1954,5,0,126657,110062,1474
22-05-2021,chennai,48634,5559,4871,86,49236,468065,5559,47,0,473671,418137,6298
22-05-2021,coimbatore,29348,3165,2377,32,30104,131696,3165,51,0,134912,103809,999
22-05-2021,cuddalore,7090,801,313,6,7572,41821,801,203,0,42825,34818,435
22-05-2021,dharmapuri,2794,360,218,2,2934,14898,360,216,0,15474,12444,96
22-05-2021,dindigul,2720,452,390,3,2779,22705,452,77,0,23234,20140,315
22-05-2021,erode,9717,1758,981,10,10484,40155,1758,94,0,42007,31287,236
22-05-2021,kallakurichi,3054,266,121,1,3198,17162,266,404,0,17832,14513,121
22-05-2021,kancheepuram,7139,1017,1040,15,7101,55553,1017,4,0,56574,48671,802
22-05-2021,kanyakumari,10049,1621,416,20,11234,37842,1621,124,0,39587,27790,563
22-05-2021,karur,2105,315,336,2,2082,13177,315,47,0,13539,11316,141
22-05-2021,krishnagiri,7444,781,109,2,8114,26229,781,226,0,27236,18947,175
22-05-2021,madurai,12299,1352,748,28,12875,53065,1352,171,0,54588,40928,785
22-05-2021,nagapattinam,4291,651,571,3,4368,22314,651,92,0,23057,18418,271
22-05-2021,namakkal,3243,598,411,5,3425,23893,598,107,0,24598,20988,185
22-05-2021,nilgiris,2701,387,310,0,2778,14387,387,41,0,14815,11970,67
22-05-2021,perambalur,1981,219,96,4,2100,5673,219,3,0,5895,3748,47
22-05-2021,pudukottai,2977,406,226,3,3154,19113,406,35,0,19554,16214,186
22-05-2021,ramanathapuram,2997,364,151,25,3185,13655,364,135,0,14154,10790,179
22-05-2021,ranipet,3267,497,202,7,3555,29549,497,49,0,30095,26210,330
22-05-2021,salem,5238,742,361,18,5601,54865,742,435,0,56042,49683,758
22-05-2021,sivagangai,1574,168,231,0,1511,12175,168,107,0,12450,10793,146
22-05-2021,tenkasi,3470,553,301,9,3713,18391,553,58,0,19002,15029,260
22-05-2021,thanjavur,5402,884,523,5,5758,38038,884,22,0,38944,32748,438
22-05-2021,theni,5407,701,566,1,5541,30685,701,45,0,31431,25600,290
22-05-2021,thirupathur,4143,494,353,15,4269,17843,494,118,0,18455,13914,272
22-05-2021,thiruvallur,12091,1511,1487,20,12095,89717,1511,10,0,91238,77989,1154
22-05-2021,thiruvannamalai,5403,757,458,2,5700,33306,757,398,0,34461,28383,378
22-05-2021,thiruvarur,4387,569,344,3,4609,23406,569,38,0,24013,19241,163
22-05-2021,thoothukudi,7014,893,819,11,7077,40277,893,275,0,41445,34147,221
22-05-2021,tirunelveli,6805,589,781,5,6608,38296,589,427,0,39312,32386,318
22-05-2021,tiruppur,10138,1466,758,23,10823,43995,1466,11,0,45472,34326,323
22-05-2021,trichy,10870,1351,1232,16,10973,43942,1351,60,0,45353,33955,425
22-05-2021,vellore,3459,588,152,15,3880,36062,575,1511,13,38161,33680,601
22-05-2021,villupuram,3312,522,519,3,3312,28110,522,174,0,28806,25293,201
22-05-2021,virudhunagar,4798,1287,620,8,5457,29040,1287,104,0,30431,24649,325
22-05-2021,airport surveillance (international),2,0,0,0,2,0,0,1004,0,1004,1001,1
22-05-2021,airport surveillance (domestic),0,0,0,0,0,0,0,1075,0,1075,1074,1
22-05-2021,railway surveillance,0,0,0,0,0,0,0,428,0,428,428,0
23-05-2021,ariyalur,1950,293,217,6,2020,9014,293,20,0,9327,7235,72
23-05-2021,chengalpattu,15159,1982,1572,29,15540,126690,1982,5,0,128677,111634,1503
23-05-2021,chennai,49106,5169,5139,81,49055,473494,5169,47,0,478710,423276,6379
23-05-2021,coimbatore,30109,3944,2454,21,31578,134866,3944,51,0,138861,106263,1020
23-05-2021,cuddalore,7574,720,633,8,7653,42624,720,203,0,43547,35451,443
23-05-2021,dharmapuri,2934,351,266,1,3018,15258,351,216,0,15825,12710,97
23-05-2021,dindigul,2772,542,195,5,3114,23150,542,77,0,23769,20335,320
23-05-2021,erode,10471,1352,621,4,11198,41900,1352,94,0,43346,31908,240
23-05-2021,kallakurichi,3202,419,247,0,3374,17432,419,404,0,18255,14760,121
23-05-2021,kancheepuram,7099,897,838,15,7143,56568,897,4,0,57469,49509,817
23-05-2021,kanyakumari,11239,1160,1040,20,11339,39468,1160,124,0,40752,28830,583
23-05-2021,karur,2083,275,147,8,2203,13493,275,47,0,13815,11463,149
23-05-2021,krishnagiri,8108,818,210,2,8714,27004,818,226,0,28048,19157,177
23-05-2021,madurai,12874,1139,909,13,13091,54416,1139,171,0,55726,41837,798
23-05-2021,nagapattinam,4368,461,368,3,4458,22965,461,92,0,23518,18786,274
23-05-2021,namakkal,3433,1032,511,4,3950,24498,1032,107,0,25637,21499,188
23-05-2021,nilgiris,2778,401,330,3,2846,14774,401,41,0,15216,12300,70
23-05-2021,perambalur,2100,475,77,2,2496,5892,475,3,0,6370,3825,49
23-05-2021,pudukottai,3157,415,212,2,3358,19523,415,35,0,19973,16426,189
23-05-2021,ramanathapuram,3186,255,185,4,3252,14021,255,135,0,14411,10975,184
23-05-2021,ranipet,3567,701,244,7,4017,30058,701,49,0,30808,26454,337
23-05-2021,salem,5609,966,877,15,5683,55615,966,435,0,57016,50560,773
23-05-2021,sivagangai,1509,217,120,1,1605,12341,217,107,0,12665,10913,147
23-05-2021,tenkasi,3713,339,171,11,3870,18944,339,58,0,19341,15200,271
23-05-2021,thanjavur,5762,1176,563,20,6355,38925,1176,22,0,40123,33311,457
23-05-2021,theni,5535,575,387,12,5711,31380,575,45,0,32000,25987,302
23-05-2021,thirupathur,4277,659,164,11,4761,18345,659,118,0,19122,14078,283
23-05-2021,thiruvallur,12133,1259,1239,27,12126,91267,1259,10,0,92536,79228,1182
23-05-2021,thiruvannamalai,5718,1006,499,4,6221,34081,1006,398,0,35485,28882,382
23-05-2021,thiruvarur,4611,572,392,5,4786,23977,572,38,0,24587,19633,168
23-05-2021,thoothukudi,7081,843,651,6,7267,41174,843,275,0,42292,34798,227
23-05-2021,tirunelveli,6606,486,734,6,6352,38881,486,427,0,39794,33120,322
23-05-2021,tiruppur,10832,1446,763,11,11504,45470,1446,11,0,46927,35089,334
23-05-2021,trichy,10975,1407,1226,13,11143,45295,1407,60,0,46762,35181,438
23-05-2021,vellore,3867,563,88,31,4311,36625,556,1524,7,38712,33768,633
23-05-2021,villupuram,3317,499,338,2,3476,28637,499,174,0,29310,25631,203
23-05-2021,virudhunagar,5462,669,569,9,5553,30332,669,104,0,31105,25218,334
23-05-2021,airport surveillance (international),2,0,0,0,2,0,0,1004,0,1004,1001,1
23-05-2021,airport surveillance (domestic),0,0,0,0,0,0,0,1075,0,1075,1074,1
23-05-2021,railway surveillance,0,0,0,0,0,0,0,428,0,428,428,0
24-05-2021,ariyalur,2004,264,230,2,2036,9291,264,20,0,9575,7465,74
24-05-2021,chengalpattu,15550,1899,1154,38,16257,128683,1899,5,0,130587,112788,1542
24-05-2021,chennai,49117,4985,5870,81,48151,478725,4985,47,0,483757,429146,6460
24-05-2021,coimbatore,31604,4277,2528,28,33325,138836,4277,51,0,143164,108791,1048
24-05-2021,cuddalore,7652,715,628,6,7733,43343,715,203,0,44261,36079,449
24-05-2021,dharmapuri,3013,381,284,3,3107,15604,381,216,0,16201,12994,100
24-05-2021,dindigul,3113,432,374,5,3166,23691,432,77,0,24200,20709,325
24-05-2021,erode,11203,1467,848,12,11810,43257,1467,94,0,44818,32756,252
24-05-2021,kallakurichi,3357,355,227,0,3485,17834,355,404,0,18593,14987,121
24-05-2021,kancheepuram,7162,813,807,15,7153,57483,813,4,0,58300,50316,831
24-05-2021,kanyakumari,11339,1083,1148,22,11252,40628,1083,124,0,41835,29978,605
24-05-2021,karur,2203,330,121,4,2408,13768,330,47,0,14145,11584,153
24-05-2021,krishnagiri,8715,833,1168,4,8376,27823,833,226,0,28882,20325,181
24-05-2021,madurai,13094,1453,915,16,13616,55558,1453,171,0,57182,42752,814
24-05-2021,nagapattinam,4463,574,262,3,4772,23431,574,92,0,24097,19048,277
24-05-2021,namakkal,3954,737,383,5,4303,25534,737,107,0,26378,21882,193
24-05-2021,nilgiris,2846,435,377,3,2901,15175,435,41,0,15651,12677,73
24-05-2021,perambalur,2504,127,196,1,2434,6375,127,3,0,6505,4021,50
24-05-2021,pudukottai,3353,399,206,3,3543,19933,399,35,0,20367,16632,192
24-05-2021,ramanathapuram,3251,297,388,6,3154,14275,297,135,0,14707,11363,190
24-05-2021,ranipet,4016,365,219,8,4154,30759,365,49,0,31173,26673,346
24-05-2021,salem,5691,889,835,38,5707,56589,889,435,0,57913,51395,811
24-05-2021,sivagangai,1605,215,85,6,1729,12558,215,107,0,12880,10998,153
24-05-2021,tenkasi,3869,456,345,2,3978,19283,456,58,0,19797,15545,274
24-05-2021,thanjavur,6357,918,651,4,6620,40103,918,22,0,41043,33962,461
24-05-2021,theni,5711,541,278,1,5973,31955,541,45,0,32541,26265,303
24-05-2021,thirupathur,4751,562,461,10,4842,19000,562,118,0,19680,14539,299
24-05-2021,thiruvallur,12033,1231,618,16,12630,92433,1231,10,0,93674,79846,1198
24-05-2021,thiruvannamalai,6227,1120,504,1,6842,35093,1120,398,0,36611,29386,383
24-05-2021,thiruvarur,4790,708,140,2,5356,24553,708,38,0,25299,19773,170
24-05-2021,thoothukudi,7269,860,320,7,7802,42019,860,275,0,43154,35118,234
24-05-2021,tirunelveli,6353,488,932,2,5907,39366,488,427,0,40281,34052,322
24-05-2021,tiruppur,11466,1808,558,5,12711,46878,1808,11,0,48697,35647,339
24-05-2021,trichy,11154,1268,1620,22,10780,46713,1268,60,0,48041,36801,460
24-05-2021,vellore,4316,415,445,15,4271,37180,414,1531,1,39126,34213,642
24-05-2021,villupuram,3480,464,359,3,3582,29140,464,174,0,29778,25990,206
24-05-2021,virudhunagar,5556,703,542,5,5712,31004,703,104,0,31811,25760,339
24-05-2021,airport surveillance (international),2,0,0,0,2,0,0,1004,0,1004,1001,1
24-05-2021,airport surveillance (domestic),0,0,0,0,0,0,0,1075,0,1075,1074,1
24-05-2021,railway surveillance,0,0,0,0,0,0,0,428,0,428,428,0
26-05-2021,ariyalur,2162,227,147,7,2235,9766,227,20,0,10013,7693,85
26-05-2021,chengalpattu,16661,1302,2149,38,15776,132518,1302,5,0,133825,116432,1617
26-05-2021,chennai,47498,3561,5223,98,45738,487589,3561,47,0,491197,438815,6644
26-05-2021,coimbatore,34257,4268,2787,31,35707,146758,4268,51,0,151077,114267,1103
26-05-2021,cuddalore,7511,649,617,5,7538,44662,649,203,0,45514,37513,463
26-05-2021,dharmapuri,3153,363,349,5,3162,16375,363,216,0,16954,13684,108
26-05-2021,dindigul,3318,480,423,7,3368,24658,480,77,0,25215,21498,349
26-05-2021,erode,12380,1642,1021,15,12986,46262,1642,94,0,47998,34733,279
26-05-2021,kallakurichi,3502,422,170,2,3752,18571,422,404,0,19397,15517,128
26-05-2021,kancheepuram,6944,909,795,14,7044,59189,909,4,0,60102,52188,870
26-05-2021,kanyakumari,10931,1116,1153,23,10871,42849,1116,124,0,44089,32588,630
26-05-2021,karur,2564,359,252,5,2666,14416,359,47,0,14822,11987,169
26-05-2021,krishnagiri,7544,670,817,1,7396,29445,670,227,0,30342,22762,184
26-05-2021,madurai,14036,1538,463,15,15096,58365,1538,171,0,60074,44142,836
26-05-2021,nagapattinam,4814,820,651,5,4978,24616,820,92,0,25528,20248,302
26-05-2021,namakkal,4591,695,391,5,4890,26990,695,107,0,27792,22702,200
26-05-2021,nilgiris,3007,422,341,2,3086,16087,422,41,0,16550,13389,75
26-05-2021,perambalur,2557,226,153,2,2628,6799,226,3,0,7028,4348,52
26-05-2021,pudukottai,3622,325,370,1,3576,20680,325,35,0,21040,17271,193
26-05-2021,ramanathapuram,3120,263,297,5,3081,14922,263,135,0,15320,12040,199
26-05-2021,ranipet,4383,525,346,11,4551,31580,525,49,0,32154,27236,367
26-05-2021,salem,5803,841,597,31,6016,58423,841,435,0,59699,52821,862
26-05-2021,sivagangai,1959,238,173,0,2024,13088,238,107,0,13433,11257,152
26-05-2021,tenkasi,4039,317,259,2,4095,20143,317,58,0,20518,16133,290
26-05-2021,thanjavur,6685,995,480,1,7199,42137,995,22,0,43154,35475,480
26-05-2021,theni,6400,530,249,15,6666,33070,530,45,0,33645,26654,325
26-05-2021,thirupathur,4730,331,722,7,4332,20047,331,118,0,20496,15848,316
26-05-2021,thiruvallur,13025,1181,1820,31,12355,95111,1181,10,0,96302,82681,1266
26-05-2021,thiruvannamalai,7173,692,486,3,7376,37191,692,398,0,38281,30514,391
26-05-2021,thiruvarur,5820,796,666,4,5946,26170,796,38,0,27004,20880,178
26-05-2021,thoothukudi,7972,507,599,8,7872,43575,507,275,0,44357,36235,250
26-05-2021,tirunelveli,5646,505,639,5,5507,40311,505,427,0,41243,35404,332
26-05-2021,tiruppur,13811,1880,767,15,14909,50547,1880,11,0,52438,37150,379
26-05-2021,trichy,10332,1775,1264,20,10823,49102,1775,60,0,50937,39617,497
26-05-2021,vellore,4547,442,896,20,4073,38055,442,1536,0,40033,35299,661
26-05-2021,villupuram,3832,754,667,6,3913,30221,754,174,0,31149,27015,221
26-05-2021,virudhunagar,6321,1198,518,10,6991,32731,1198,104,0,34033,26682,360
26-05-2021,airport surveillance (international),2,0,0,0,2,0,0,1004,0,1004,1001,1
26-05-2021,airport surveillance (domestic),0,0,0,0,0,0,0,1075,0,1075,1074,1
26-05-2021,railway surveillance,0,0,0,0,0,0,0,428,0,428,428,0
27-05-2021,ariyalur,2229,276,104,8,2393,9987,276,20,0,10283,7797,93
27-05-2021,chengalpattu,15848,1392,2330,52,14858,133892,1392,5,0,135289,118762,1669
27-05-2021,chennai,45643,2779,4719,79,43624,491055,2779,47,0,493881,443534,6723
27-05-2021,coimbatore,35716,4734,2930,32,37488,151035,4734,51,0,155820,117197,1135
27-05-2021,cuddalore,7549,613,570,10,7582,45321,613,203,0,46137,38083,472
27-05-2021,dharmapuri,3169,304,297,4,3172,16745,304,216,0,17265,13981,112
27-05-2021,dindigul,3353,376,291,11,3427,25123,376,77,0,25576,21789,360
27-05-2021,erode,12974,1699,1146,11,13516,47892,1699,94,0,49685,35879,290
27-05-2021,kallakurichi,3740,448,195,0,3993,18981,448,404,0,19833,15712,128
27-05-2021,kancheepuram,6979,751,720,20,6990,60034,751,4,0,60789,52908,891
27-05-2021,kanyakumari,10872,979,1305,10,10536,43966,979,124,0,45069,33893,640
27-05-2021,karur,2668,409,190,3,2884,14777,409,47,0,15233,12177,172
27-05-2021,krishnagiri,7395,469,1078,3,6783,30114,469,227,0,30810,23840,187
27-05-2021,madurai,15105,1395,689,10,15801,59912,1395,171,0,61478,44831,846
27-05-2021,nagapattinam,4972,777,642,4,5103,25430,777,92,0,26299,20890,306
27-05-2021,namakkal,4896,883,416,9,5354,27691,883,107,0,28681,23118,209
27-05-2021,nilgiris,3087,434,320,3,3198,16510,434,41,0,16985,13709,78
27-05-2021,perambalur,2631,274,168,0,2737,7028,274,3,0,7305,4516,52
27-05-2021,pudukottai,3575,385,228,0,3732,21004,385,35,0,21424,17499,193
27-05-2021,ramanathapuram,3086,256,214,5,3123,15190,256,135,0,15581,12254,204
27-05-2021,ranipet,4566,544,582,18,4510,32125,544,49,0,32718,27818,390
27-05-2021,salem,6018,987,637,30,6338,59267,987,435,0,60689,53458,893
27-05-2021,sivagangai,2017,173,171,4,2015,13319,173,107,0,13599,11428,156
27-05-2021,tenkasi,4111,461,419,14,4139,20476,461,58,0,20995,16552,304
27-05-2021,thanjavur,7202,936,656,13,7469,43135,936,22,0,44093,36131,493
27-05-2021,theni,6668,564,523,4,6705,33602,564,45,0,34211,27177,329
27-05-2021,thirupathur,4334,508,459,2,4381,20386,508,118,0,21012,16307,324
27-05-2021,thiruvallur,12398,1221,1987,24,11608,96335,1221,10,0,97566,84668,1290
27-05-2021,thiruvannamalai,7387,734,465,5,7651,37894,734,398,0,39026,30979,396
27-05-2021,thiruvarur,5950,487,564,5,5868,26970,487,38,0,27495,21444,183
27-05-2021,thoothukudi,7883,667,709,3,7838,44093,667,275,0,45035,36944,253
27-05-2021,tirunelveli,5480,454,490,2,5442,40789,454,427,0,41670,35894,334
27-05-2021,tiruppur,14921,2074,909,34,16052,52439,2074,11,0,54524,38059,413
27-05-2021,trichy,10832,1617,1396,10,11043,50886,1617,60,0,52563,41013,507
27-05-2021,vellore,4053,487,617,16,3907,38465,487,1536,0,40488,35916,665
27-05-2021,villupuram,3920,798,526,5,4187,30982,798,174,0,31954,27541,226
27-05-2021,virudhunagar,6995,1016,401,11,7599,33933,1016,104,0,35053,27083,371
27-05-2021,airport surveillance (international),2,0,0,0,2,0,0,1004,0,1004,1001,1
27-05-2021,airport surveillance (domestic),0,0,0,0,0,0,0,1075,0,1075,1074,1
27-05-2021,railway surveillance,0,0,0,0,0,0,0,428,0,428,428,0
30-05-2021,ariyalur,2601,268,293,7,2569,10746,268,20,0,11034,8354,111
30-05-2021,chengalpattu,12953,1194,2617,37,11493,138064,1194,5,0,139263,125981,1789
30-05-2021,chennai,38622,2689,5795,93,35423,499194,2689,47,0,501930,459499,7008
30-05-2021,coimbatore,38832,3537,3275,47,39047,163415,3537,51,0,167003,126721,1235
30-05-2021,cuddalore,7151,722,843,14,7016,47113,722,203,0,48038,40513,509
30-05-2021,dharmapuri,3178,311,386,3,3100,17761,311,216,0,18288,15061,127
30-05-2021,dindigul,3415,334,262,7,3480,26255,334,77,0,26666,22794,392
30-05-2021,erode,14386,1784,941,22,15207,53036,1784,94,0,54914,39367,340
30-05-2021,kallakurichi,4110,337,159,1,4287,20088,337,404,0,20829,16412,130
30-05-2021,kancheepuram,6858,664,888,20,6614,62244,664,4,0,62912,55350,948
30-05-2021,kanyakumari,9829,912,731,19,9991,46874,912,124,0,47910,37216,703
30-05-2021,karur,3399,488,339,9,3539,16197,488,47,0,16732,12996,197
30-05-2021,krishnagiri,5459,486,731,6,5208,31569,486,227,0,32282,26879,195
30-05-2021,madurai,16034,792,992,19,15815,63244,792,171,0,64207,47504,888
30-05-2021,nagapattinam,5240,665,670,4,5231,27619,665,92,0,28376,22819,326
30-05-2021,namakkal,6285,877,603,6,6553,30320,877,107,0,31304,24511,240
30-05-2021,nilgiris,3481,538,387,6,3626,17912,538,41,0,18491,14777,88
30-05-2021,perambalur,2845,275,426,0,2694,7928,275,3,0,8206,5457,55
30-05-2021,pudukottai,3989,330,238,5,4076,22156,330,35,0,22521,18241,204
30-05-2021,ramanathapuram,3288,318,260,11,3335,16045,318,135,0,16498,12941,222
30-05-2021,ranipet,4762,350,138,12,4962,33733,350,49,0,34132,28730,440
30-05-2021,salem,7600,1295,782,17,8096,62724,1295,435,0,64454,55408,950
30-05-2021,sivagangai,2022,211,256,0,1977,13918,211,107,0,14236,12100,159
30-05-2021,tenkasi,4064,397,470,2,3989,21713,397,58,0,22168,17850,329
30-05-2021,thanjavur,7632,786,1084,4,7330,45716,786,22,0,46524,38684,510
30-05-2021,theni,6532,521,689,9,6355,35327,521,45,0,35893,29190,348
30-05-2021,thirupathur,4442,424,665,12,4189,21872,424,118,0,22414,17877,348
30-05-2021,thiruvallur,9527,887,1705,18,8691,99578,887,10,0,100475,90421,1363
30-05-2021,thiruvannamalai,7847,540,628,5,7754,39898,540,398,0,40836,32671,411
30-05-2021,thiruvarur,5859,585,732,3,5709,28613,585,38,0,29236,23336,191
30-05-2021,thoothukudi,7836,664,525,6,7969,46223,664,275,0,47162,38919,274
30-05-2021,tirunelveli,5245,448,915,2,4776,42045,448,427,0,42920,37802,342
30-05-2021,tiruppur,17641,1496,1085,17,18035,58056,1496,11,0,59563,41065,463
30-05-2021,trichy,10635,1128,932,15,10816,54902,1128,60,0,56090,44723,551
30-05-2021,vellore,3503,418,399,21,3501,39806,418,1536,0,41760,37534,725
30-05-2021,villupuram,4859,596,592,7,4856,33032,596,174,0,33802,28700,246
30-05-2021,virudhunagar,8194,597,549,7,8235,36303,597,104,0,37004,28374,395
30-05-2021,airport surveillance (international),2,0,0,0,2,0,0,1004,0,1004,1001,1
30-05-2021,airport surveillance (domestic),0,0,0,0,0,0,0,1075,0,1075,1074,1
30-05-2021,railway surveillance,0,0,0,0,0,0,0,428,0,428,428,0
02-06-2021,ariyalur,2528,282,485,5,2320,11504,282,20,0,11806,9361,125
02-06-2021,chengalpattu,9901,996,1481,34,9382,141714,996,5,0,142715,131409,1924
02-06-2021,chennai,32149,2217,4463,77,29826,506970,2217,47,0,509234,472186,7222
02-06-2021,coimbatore,40577,3061,4488,38,39112,173798,3061,51,0,176910,136453,1345
02-06-2021,cuddalore,6108,595,719,7,5977,49072,595,203,0,49870,43352,541
02-06-2021,dharmapuri,3058,332,384,1,3005,18742,332,216,0,19290,16154,131
02-06-2021,dindigul,3334,349,530,3,3150,27204,349,77,0,27630,24060,420
02-06-2021,erode,16095,1488,1538,25,16020,58186,1488,94,0,59768,43367,381
02-06-2021,kallakurichi,4573,363,324,3,4609,21137,363,404,0,21904,17153,142
02-06-2021,kancheepuram,5573,527,1202,22,4876,63865,527,4,0,64396,58517,1003
02-06-2021,kanyakumari,9544,826,1161,15,9194,49536,826,124,0,50486,40533,759
02-06-2021,karur,3433,415,205,17,3626,17553,415,47,0,18015,14150,239
02-06-2021,krishnagiri,4604,480,827,5,4252,32941,480,227,0,33648,29188,208
02-06-2021,madurai,15169,572,1226,11,14504,65313,572,171,0,66056,50621,931
02-06-2021,nagapattinam,5546,674,552,15,5653,29665,674,92,0,30431,24420,358
02-06-2021,namakkal,7271,809,620,9,7451,33089,809,107,0,34005,26283,271
02-06-2021,nilgiris,3955,579,460,6,4068,19621,579,41,0,20241,16073,100
02-06-2021,perambalur,2727,236,482,1,2480,8666,236,3,0,8905,6362,63
02-06-2021,pudukottai,3683,283,516,2,3448,23130,283,35,0,23448,19790,210
02-06-2021,ramanathapuram,3256,260,221,4,3291,16895,260,135,0,17290,13762,237
02-06-2021,ranipet,3413,406,328,24,3467,34901,406,49,0,35356,31373,516
02-06-2021,salem,8684,1290,703,23,9248,66341,1290,435,0,68066,57807,1011
02-06-2021,sivagangai,2011,211,230,0,1992,14520,211,107,0,14838,12685,161
02-06-2021,tenkasi,3679,309,276,9,3703,22707,309,58,0,23074,19020,351
02-06-2021,thanjavur,6899,920,924,13,6882,48183,920,22,0,49125,41709,534
02-06-2021,theni,5581,459,510,0,5530,36865,459,45,0,37369,31477,362
02-06-2021,thirupathur,3821,330,567,3,3581,23074,330,118,0,23522,19569,372
02-06-2021,thiruvallur,7591,735,1055,17,7254,101964,735,10,0,102709,94028,1427
02-06-2021,thiruvannamalai,7395,342,617,4,7116,41372,342,398,0,42112,34568,428
02-06-2021,thiruvarur,5647,629,715,4,5557,30289,629,38,0,30956,25196,203
02-06-2021,thoothukudi,8064,411,669,2,7804,48074,411,275,0,48760,40670,286
02-06-2021,tirunelveli,4442,347,421,3,4365,43235,347,427,0,44009,39291,353
02-06-2021,tiruppur,18598,1252,1083,24,18743,62289,1252,11,0,63552,44302,507
02-06-2021,trichy,10996,882,564,12,11302,58131,882,60,0,59073,47157,614
02-06-2021,vellore,2966,366,138,29,3165,40999,365,1542,1,42907,38965,777
02-06-2021,villupuram,5117,605,488,6,5228,34868,605,174,0,35647,30160,259
02-06-2021,virudhunagar,8141,479,1091,10,7519,38133,479,104,0,38716,30765,432
02-06-2021,airport surveillance (international),2,0,0,0,2,0,0,1004,0,1004,1001,1
02-06-2021,airport surveillance (domestic),0,0,0,0,0,0,0,1075,0,1075,1074,1
02-06-2021,railway surveillance,0,0,0,0,0,0,0,428,0,428,428,0
03-06-2021,ariyalur,2325,264,319,8,2262,11791,264,20,0,12075,9680,133
03-06-2021,chengalpattu,9412,983,1782,47,8566,142742,983,5,0,143730,133191,1973
03-06-2021,chennai,29787,2062,3595,68,28186,509149,2062,47,0,511258,475781,7291
03-06-2021,coimbatore,39119,2980,4546,48,37505,176867,2980,51,0,179898,140999,1394
03-06-2021,cuddalore,5982,569,539,7,6005,49672,569,203,0,50444,43891,548
03-06-2021,dharmapuri,2999,307,385,5,2916,19068,307,216,0,19591,16539,136
03-06-2021,dindigul,3144,325,497,9,2963,27546,325,77,0,27948,24557,428
03-06-2021,erode,15989,1671,1565,8,16087,59643,1671,94,0,61408,44932,389
03-06-2021,kallakurichi,4600,324,331,1,4592,21491,324,404,0,22219,17484,143
03-06-2021,kancheepuram,4861,492,1120,12,4221,64374,492,4,0,64870,59637,1012
03-06-2021,kanyakumari,9192,739,1092,6,8833,50360,739,124,0,51223,41625,765
03-06-2021,karur,3630,326,454,10,3492,17972,326,47,0,18345,14604,249
03-06-2021,krishnagiri,4257,411,883,5,3780,33426,411,227,0,34064,30071,213
03-06-2021,madurai,14501,519,783,13,14224,65881,519,171,0,66571,51404,943
03-06-2021,nagapattinam,5648,613,706,7,5548,30334,613,92,0,31039,25126,365
03-06-2021,namakkal,7461,801,740,10,7512,33908,801,107,0,34816,27023,281
03-06-2021,nilgiris,4068,584,440,5,4207,20200,584,41,0,20825,16513,105
03-06-2021,perambalur,2483,228,128,7,2576,8905,228,3,0,9136,6490,70
03-06-2021,pudukottai,3461,311,766,7,2999,23426,311,35,0,23772,20556,217
03-06-2021,ramanathapuram,3292,237,230,10,3289,17157,237,135,0,17529,13992,248
03-06-2021,ranipet,3484,318,636,12,3154,35324,318,49,0,35691,32009,528
03-06-2021,salem,9265,1253,687,33,9798,67648,1253,435,0,69336,58494,1044
03-06-2021,sivagangai,1994,160,204,1,1949,14733,160,107,0,15000,12889,162
03-06-2021,tenkasi,3701,306,275,9,3723,23014,306,58,0,23378,19295,360
03-06-2021,thanjavur,6887,1020,1058,10,6839,49108,1020,22,0,50150,42767,544
03-06-2021,theni,5529,481,528,11,5471,37323,481,45,0,37849,32005,373
03-06-2021,thirupathur,3580,327,441,4,3462,23403,327,118,0,23848,20010,376
03-06-2021,thiruvallur,7257,695,1476,17,6459,102702,695,10,0,103407,95504,1444
03-06-2021,thiruvannamalai,7120,437,582,4,6971,41718,437,398,0,42553,35150,432
03-06-2021,thiruvarur,5559,620,629,8,5542,30920,620,38,0,31578,25825,211
03-06-2021,thoothukudi,7805,344,664,3,7482,48486,344,275,0,49105,41334,289
03-06-2021,tirunelveli,4372,289,406,6,4249,43589,289,427,0,44305,39697,359
03-06-2021,tiruppur,18762,1264,1069,14,18943,63560,1264,11,0,64835,45371,521
03-06-2021,trichy,11275,823,659,11,11428,58986,823,60,0,59869,47816,625
03-06-2021,vellore,3138,297,304,17,3114,41337,292,1543,5,43177,39269,794
03-06-2021,villupuram,5238,577,659,3,5153,35483,577,174,0,36234,30819,262
03-06-2021,virudhunagar,7523,448,1043,4,6924,38616,448,104,0,39168,31808,436
03-06-2021,airport surveillance (international),2,0,0,0,2,0,0,1004,0,1004,1001,1
03-06-2021,airport surveillance (domestic),0,0,0,0,0,0,0,1075,0,1075,1074,1
03-06-2021,railway surveillance,0,0,0,0,0,0,0,428,0,428,428,0
04-06-2021,ariyalur,2262,246,324,5,2179,12055,246,20,0,12321,10004,138
04-06-2021,chengalpattu,8561,909,1408,38,8024,143725,909,5,0,144639,134599,2016
04-06-2021,chennai,28186,1971,3364,71,26722,511211,1971,47,0,513229,479145,7362
04-06-2021,coimbatore,37505,2810,4590,31,35694,179847,2810,51,0,182708,145589,1425
04-06-2021,cuddalore,6005,488,1198,13,5282,50241,488,203,0,50932,45089,561
04-06-2021,dharmapuri,2916,318,363,0,2871,19375,318,216,0,19909,16902,136
04-06-2021,dindigul,2963,308,514,21,2736,27871,308,77,0,28256,25071,449
04-06-2021,erode,16087,1619,1616,12,16078,61314,1619,94,0,63027,46548,401
04-06-2021,kallakurichi,4592,243,367,1,4467,21815,243,404,0,22462,17851,144
04-06-2021,kancheepuram,4226,388,720,15,3879,64866,388,4,0,65258,60357,1022
04-06-2021,kanyakumari,8833,712,1134,22,8389,51099,712,124,0,51935,42759,787
04-06-2021,karur,3492,337,409,8,3412,18298,337,47,0,18682,15013,257
04-06-2021,krishnagiri,3780,377,637,6,3514,33837,377,227,0,34441,30708,219
04-06-2021,madurai,14224,481,1559,5,13141,66400,481,171,0,67052,52963,948
04-06-2021,nagapattinam,5548,516,828,13,5223,30947,516,92,0,31555,25954,378
04-06-2021,namakkal,7512,719,687,11,7533,34709,719,107,0,35535,27710,292
04-06-2021,nilgiris,4207,515,436,4,4282,20784,515,41,0,21340,16949,109
04-06-2021,perambalur,2576,209,298,22,2465,9133,209,3,0,9345,6788,92
04-06-2021,pudukottai,2999,288,540,7,2740,23737,288,35,0,24060,21096,224
04-06-2021,ramanathapuram,3289,171,406,17,3037,17394,171,135,0,17700,14398,265
04-06-2021,ranipet,3154,306,545,3,2912,35642,306,49,0,35997,32554,531
04-06-2021,salem,9798,1187,772,20,10193,68901,1187,435,0,70523,59266,1064
04-06-2021,sivagangai,1949,187,264,5,1867,14893,187,107,0,15187,13153,167
04-06-2021,tenkasi,3723,226,353,1,3595,23320,226,58,0,23604,19648,361
04-06-2021,thanjavur,6839,1004,1075,2,6766,50128,1004,22,0,51154,43842,546
04-06-2021,theni,5471,445,859,0,5057,37804,445,45,0,38294,32864,373
04-06-2021,thirupathur,3462,341,387,7,3409,23730,341,118,0,24189,20397,383
04-06-2021,thiruvallur,6459,583,1229,29,5784,103397,583,10,0,103990,96733,1473
04-06-2021,thiruvannamalai,6971,497,487,7,6974,42155,497,398,0,43050,35637,439
04-06-2021,thiruvarur,5542,576,579,5,5534,31540,576,38,0,32154,26404,216
04-06-2021,thoothukudi,7482,365,681,4,7162,48830,365,275,0,49470,42015,293
04-06-2021,tirunelveli,4249,256,415,2,4088,43878,256,427,0,44561,40112,361
04-06-2021,tiruppur,18943,1161,1587,16,18501,64824,1161,11,0,65996,46958,537
04-06-2021,trichy,11428,689,709,15,11393,59809,689,60,0,60558,48525,640
04-06-2021,vellore,3114,271,597,12,2776,41629,265,1548,6,43448,39866,806
04-06-2021,villupuram,5153,521,683,8,4983,36060,521,174,0,36755,31502,270
04-06-2021,virudhunagar,6924,411,1026,5,6304,39064,411,104,0,39579,32834,441
04-06-2021,airport surveillance (international),2,0,0,0,2,0,0,1004,0,1004,1001,1
04-06-2021,airport surveillance (domestic),0,0,0,0,0,0,0,1075,0,1075,1074,1
04-06-2021,railway surveillance,0,0,0,0,0,0,0,428,0,428,428,0
05-06-2021,ariyalur,2179,192,216,5,2150,12301,192,20,0,12513,10220,143
05-06-2021,chengalpattu,8023,862,1323,41,7521,144634,862,5,0,145501,135922,2058
05-06-2021,chennai,26721,1789,4158,62,24290,513182,1789,47,0,515018,483303,7425
05-06-2021,coimbatore,35694,2663,4656,43,33658,182657,2663,51,0,185371,150245,1468
05-06-2021,cuddalore,5282,590,574,15,5283,50729,590,203,0,51522,45663,576
05-06-2021,dharmapuri,2871,370,305,4,2932,19693,370,216,0,20279,17207,140
05-06-2021,dindigul,2736,298,433,3,2598,28179,298,77,0,28554,25504,452
05-06-2021,erode,16078,1569,1721,24,15902,62933,1569,94,0,64596,48269,425
05-06-2021,kallakurichi,4467,226,312,0,4381,22058,226,404,0,22688,18163,144
05-06-2021,kancheepuram,3880,372,867,10,3375,65254,372,4,0,65630,61224,1031
05-06-2021,kanyakumari,8389,633,1102,8,7912,51811,633,124,0,52568,43861,795
05-06-2021,karur,3412,322,476,8,3250,18635,322,47,0,19004,15489,265
05-06-2021,krishnagiri,3514,359,444,5,3424,34214,358,227,1,34800,31152,224
05-06-2021,madurai,13141,468,981,12,12616,66881,468,171,0,67520,53944,960
05-06-2021,nagapattinam,5223,510,784,13,4936,31463,510,92,0,32065,26738,391
05-06-2021,namakkal,7533,682,874,11,7330,35428,682,107,0,36217,28584,303
05-06-2021,nilgiris,4283,517,461,6,4333,21299,517,41,0,21857,17410,114
05-06-2021,perambalur,2465,158,507,10,2106,9342,158,3,0,9503,7295,102
05-06-2021,pudukottai,2740,137,391,8,2478,24025,137,35,0,24197,21487,232
05-06-2021,ramanathapuram,3037,133,231,6,2933,17565,133,135,0,17833,14629,271
05-06-2021,ranipet,2912,283,567,4,2624,35948,283,49,0,36280,33121,535
05-06-2021,salem,10193,1171,1050,20,10294,70088,1171,435,0,71694,60316,1084
05-06-2021,sivagangai,1867,146,205,1,1807,15080,146,107,0,15333,13358,168
05-06-2021,tenkasi,3595,291,491,11,3384,23546,291,58,0,23895,20139,372
05-06-2021,thanjavur,6766,929,836,5,6854,51132,929,22,0,52083,44678,551
05-06-2021,theni,5057,391,579,12,4857,38249,391,45,0,38685,33443,385
05-06-2021,thirupathur,3408,336,398,5,3341,24071,336,118,0,24525,20795,389
05-06-2021,thiruvallur,5782,525,990,14,5303,103980,525,10,0,104515,97723,1489
05-06-2021,thiruvannamalai,6974,482,490,3,6963,42652,482,398,0,43532,36127,442
05-06-2021,thiruvarur,5535,431,697,8,5261,32116,431,38,0,32585,27101,223
05-06-2021,thoothukudi,7162,358,780,5,6735,49195,358,275,0,49828,42795,298
05-06-2021,tirunelveli,4088,271,317,5,4037,44134,271,427,0,44832,40429,366
05-06-2021,tiruppur,18501,1104,840,11,18754,65985,1104,11,0,67100,47798,548
05-06-2021,trichy,11393,651,1218,11,10815,60498,651,60,0,61209,49743,651
05-06-2021,vellore,2778,248,399,15,2612,41894,245,1554,3,43696,40265,819
05-06-2021,villupuram,4983,471,575,6,4873,36581,471,174,0,37226,32077,276
05-06-2021,virudhunagar,6304,472,1224,13,5539,39475,472,104,0,40051,34058,454
05-06-2021,airport surveillance (international),2,0,0,0,2,0,0,1004,0,1004,1001,1
05-06-2021,airport surveillance (domestic),0,0,0,0,0,0,0,1075,0,1075,1074,1
05-06-2021,railway surveillance,0,0,0,0,0,0,0,428,0,428,428,0
06-06-2021,ariyalur,2151,187,169,3,2166,12492,187,20,0,12699,10389,144
06-06-2021,chengalpattu,7562,832,1309,21,7064,145537,832,5,0,146374,137231,2079
06-06-2021,chennai,24256,1644,4446,50,21404,514937,1644,47,0,516628,487749,7475
06-06-2021,coimbatore,33665,2645,4733,38,31539,185327,2645,51,0,188023,154978,1506
06-06-2021,cuddalore,5284,539,769,13,5041,51319,539,203,0,52061,46432,588
06-06-2021,dharmapuri,2932,341,365,5,2903,20063,341,216,0,20620,17572,145
06-06-2021,dindigul,2602,284,393,1,2492,28481,284,77,0,28842,25897,453
06-06-2021,erode,15886,1694,2078,10,15492,64486,1694,94,0,66274,50347,435
06-06-2021,kallakurichi,4377,308,376,3,4306,22280,308,404,0,22992,18539,147
06-06-2021,kancheepuram,3395,352,565,14,3168,65646,352,4,0,66002,61789,1045
06-06-2021,kanyakumari,7919,557,967,19,7490,52451,557,124,0,53132,44828,814
06-06-2021,karur,3252,301,516,7,3030,18959,301,47,0,19307,16005,272
06-06-2021,krishnagiri,3431,334,453,5,3307,34579,334,228,0,35141,31605,229
06-06-2021,madurai,12585,441,1569,14,11443,67318,441,171,0,67930,55513,974
06-06-2021,nagapattinam,4938,542,583,3,4894,31975,542,92,0,32609,27321,394
06-06-2021,namakkal,7336,608,858,6,7080,36116,608,107,0,36831,29442,309
06-06-2021,nilgiris,4335,510,505,2,4338,21818,510,41,0,22369,17915,116
06-06-2021,perambalur,2107,140,316,5,1926,9503,140,3,0,9646,7611,109
06-06-2021,pudukottai,2490,189,277,9,2393,24172,189,35,0,24396,21764,239
06-06-2021,ramanathapuram,2939,118,211,6,2840,17704,118,135,0,17957,14840,277
06-06-2021,ranipet,2626,270,475,17,2404,36235,270,49,0,36554,33596,554
06-06-2021,salem,10307,1071,903,34,10441,71272,1071,435,0,72778,61219,1118
06-06-2021,sivagangai,1809,125,184,6,1744,15229,125,107,0,15461,13542,175
06-06-2021,tenkasi,3385,222,280,15,3312,23838,222,58,0,24118,20419,387
06-06-2021,thanjavur,6858,875,806,9,6918,52066,875,22,0,52963,45484,561
06-06-2021,theni,4854,342,951,11,4234,38637,342,45,0,39024,34394,396
06-06-2021,thirupathur,3333,291,403,4,3217,24399,291,118,0,24808,21198,393
06-06-2021,thiruvallur,5205,487,1029,14,4649,104407,487,10,0,104904,98752,1503
06-06-2021,thiruvannamalai,6979,420,493,5,6901,43150,420,398,0,43968,36620,447
06-06-2021,thiruvarur,5259,395,877,7,4770,32545,395,38,0,32978,27978,230
06-06-2021,thoothukudi,6738,344,852,6,6224,49557,344,275,0,50176,43647,305
06-06-2021,tirunelveli,4032,263,473,3,3819,44399,263,427,0,45089,40902,368
06-06-2021,tiruppur,18766,1068,967,8,18859,67101,1068,11,0,68180,48765,556
06-06-2021,trichy,10815,590,986,21,10398,61149,590,60,0,61799,50729,672
06-06-2021,vellore,2618,259,601,29,2247,42143,256,1557,3,43959,40866,846
06-06-2021,villupuram,4879,413,353,7,4932,37059,413,174,0,37646,32430,284
06-06-2021,virudhunagar,5556,420,1070,4,4902,39964,420,104,0,40488,35128,458
06-06-2021,airport surveillance (international),2,0,0,0,2,0,0,1004,0,1004,1001,1
06-06-2021,airport surveillance (domestic),0,0,0,0,0,0,0,1075,0,1075,1074,1
06-06-2021,railway surveillance,0,0,0,0,0,0,0,428,0,428,428,0
07-06-2021,ariyalur,2166,193,309,0,2050,12679,193,20,0,12892,10698,144
07-06-2021,chengalpattu,7060,837,1505,22,6370,146367,837,5,0,147209,138736,2103
07-06-2021,chennai,21407,1530,3713,40,19184,516585,1530,47,0,518162,491462,7516
07-06-2021,coimbatore,31545,2564,4815,26,29268,187978,2564,51,0,190593,159793,1532
07-06-2021,cuddalore,5042,496,585,5,4948,51859,496,203,0,52558,47017,593
07-06-2021,dharmapuri,2906,298,354,3,2847,20407,298,216,0,20921,17926,148
07-06-2021,dindigul,2489,269,362,2,2394,28762,269,77,0,29108,26259,455
07-06-2021,erode,15477,1646,2392,19,14712,66165,1646,94,0,67905,52739,454
07-06-2021,kallakurichi,4306,293,354,4,4241,22588,293,404,0,23285,18893,151
07-06-2021,kancheepuram,3167,306,670,18,2785,65994,306,4,0,66304,62459,1060
07-06-2021,kanyakumari,7491,534,970,21,7034,53009,534,124,0,53667,45798,835
07-06-2021,karur,3031,281,471,7,2834,19261,281,47,0,19589,16476,279
07-06-2021,krishnagiri,3305,323,310,4,3314,34911,323,228,0,35462,31915,233
07-06-2021,madurai,11437,401,1164,8,10666,67752,401,171,0,68324,56677,981
07-06-2021,nagapattinam,4898,492,659,11,4720,32521,492,92,0,33105,27980,405
07-06-2021,namakkal,7096,597,900,13,6780,36740,597,107,0,37444,30342,322
07-06-2021,nilgiris,4338,503,540,3,4298,22328,503,41,0,22872,18455,119
07-06-2021,perambalur,1926,118,315,4,1725,9643,118,3,0,9764,7926,113
07-06-2021,pudukottai,2393,223,201,9,2406,24361,223,35,0,24619,21965,248
07-06-2021,ramanathapuram,2842,121,258,4,2701,17825,121,135,0,18081,15098,282
07-06-2021,ranipet,2416,394,374,4,2432,36519,394,49,0,36962,33970,560
07-06-2021,salem,10435,997,751,12,10669,72337,997,435,0,73769,61970,1130
07-06-2021,sivagangai,1737,115,187,0,1665,15347,115,107,0,15569,13729,175
07-06-2021,tenkasi,3312,230,274,0,3268,24060,230,58,0,24348,20693,387
07-06-2021,thanjavur,6927,831,787,9,6962,52950,831,22,0,53803,46271,570
07-06-2021,theni,4235,307,570,0,3972,38980,307,45,0,39332,34964,396
07-06-2021,thirupathur,3224,266,461,4,3025,24698,266,118,0,25082,21659,398
07-06-2021,thiruvallur,4651,436,867,15,4205,104896,436,10,0,105342,99619,1518
07-06-2021,thiruvannamalai,6903,361,474,30,6760,43572,361,398,0,44331,37094,477
07-06-2021,thiruvarur,4760,387,559,11,4577,32930,387,38,0,33355,28537,241
07-06-2021,thoothukudi,6224,326,575,6,5969,49901,326,275,0,50502,44222,311
07-06-2021,tirunelveli,3815,202,355,0,3662,44658,202,427,0,45287,41257,368
07-06-2021,tiruppur,18863,1027,1030,11,18849,68173,1027,11,0,69211,49795,567
07-06-2021,trichy,10398,548,1606,14,9326,61739,548,60,0,62347,52335,686
07-06-2021,vellore,2227,218,413,2,2030,42376,216,1560,2,44154,41279,845
07-06-2021,villupuram,4932,389,576,3,4742,37472,389,174,0,38035,33006,287
07-06-2021,virudhunagar,4906,389,654,7,4634,40388,389,104,0,40881,35782,465
07-06-2021,airport surveillance (international),2,0,0,0,2,0,0,1004,0,1004,1001,1
07-06-2021,airport surveillance (domestic),0,0,0,0,0,0,0,1075,0,1075,1074,1
07-06-2021,railway surveillance,0,0,0,0,0,0,0,428,0,428,428,0
08-06-2021,ariyalur,2052,145,419,10,1768,12874,145,20,0,13039,11117,154
08-06-2021,chengalpattu,6384,773,1154,16,5987,147218,773,5,0,147996,139890,2119
08-06-2021,chennai,19157,1437,3843,42,16709,518090,1437,47,0,519574,495305,7560
08-06-2021,coimbatore,29273,2439,4917,44,26751,190547,2439,51,0,193037,164710,1576
08-06-2021,cuddalore,4955,463,516,8,4894,52363,463,203,0,53029,47533,602
08-06-2021,dharmapuri,2851,240,313,6,2772,20709,240,216,0,21165,18239,154
08-06-2021,dindigul,2390,199,361,22,2206,29027,199,77,0,29303,26620,477
08-06-2021,erode,14696,1596,2003,5,14284,67795,1596,94,0,69485,54742,459
08-06-2021,kallakurichi,4225,270,307,4,4184,22865,270,404,0,23539,19200,155
08-06-2021,kancheepuram,2793,279,508,6,2558,66306,279,4,0,66589,62967,1064
08-06-2021,kanyakumari,7034,487,695,16,6810,53543,487,124,0,54154,46493,851
08-06-2021,karur,2834,195,307,6,2716,19542,195,47,0,19784,16783,285
08-06-2021,krishnagiri,3316,275,323,3,3265,35236,275,228,0,35739,32238,236
08-06-2021,madurai,10661,365,1348,7,9671,68148,365,171,0,68684,58025,988
08-06-2021,nagapattinam,4719,446,610,4,4551,33012,446,92,0,33550,28590,409
08-06-2021,namakkal,6798,525,882,4,6437,37355,525,107,0,37987,31224,326
08-06-2021,nilgiris,4298,498,587,5,4204,22831,498,41,0,23370,19042,124
08-06-2021,perambalur,1729,115,279,11,1554,9765,115,3,0,9883,8205,124
08-06-2021,pudukottai,2406,193,311,4,2284,24583,193,35,0,24811,22276,251
08-06-2021,ramanathapuram,2701,107,248,3,2557,17946,107,135,0,18188,15346,285
08-06-2021,ranipet,2430,335,413,7,2345,36913,335,49,0,37297,34383,569
08-06-2021,salem,10670,975,1062,25,10558,73334,975,435,0,74744,63032,1154
08-06-2021,sivagangai,1667,138,208,1,1596,15464,138,107,0,15709,13937,176
08-06-2021,tenkasi,3268,198,521,10,2935,24290,198,58,0,24546,21214,397
08-06-2021,thanjavur,6969,770,783,13,6943,53788,770,22,0,54580,47054,583
08-06-2021,theni,3973,256,539,16,3674,39288,256,45,0,39589,35503,412
08-06-2021,thirupathur,3021,227,552,3,2693,24963,227,118,0,25308,22211,404
08-06-2021,thiruvallur,4200,407,864,22,3721,105327,407,10,0,105744,100483,1540
08-06-2021,thiruvannamalai,6766,334,541,5,6554,43939,334,398,0,44671,37635,482
08-06-2021,thiruvarur,4573,324,784,7,4106,33313,324,38,0,33675,29321,248
08-06-2021,thoothukudi,5969,281,679,9,5562,50227,281,275,0,50783,44901,320
08-06-2021,tirunelveli,3664,185,471,5,3373,44862,185,427,0,45474,41728,373
08-06-2021,tiruppur,18856,995,864,18,18969,69207,995,11,0,70213,50659,585
08-06-2021,trichy,9311,490,1287,18,8496,62272,490,60,0,62822,53622,704
08-06-2021,vellore,2036,277,412,11,1890,42594,276,1562,1,44433,41691,852
08-06-2021,villupuram,4744,443,649,8,4530,37863,443,174,0,38480,33655,295
08-06-2021,virudhunagar,4635,341,485,5,4486,40778,341,104,0,41223,36267,470
08-06-2021,airport surveillance (international),2,0,0,0,2,0,0,1004,0,1004,1001,1
08-06-2021,airport surveillance (domestic),0,0,0,0,0,0,0,1075,0,1075,1074,1
08-06-2021,railway surveillance,0,0,0,0,0,0,0,428,0,428,428,0
09-06-2021,ariyalur,1770,174,323,3,1618,13021,174,20,0,13215,11440,157
09-06-2021,chengalpattu,5999,726,1108,29,5588,148001,726,5,0,148732,140998,2146
09-06-2021,chennai,16666,1345,3281,52,14678,519485,1345,47,0,520877,498586,7613
09-06-2021,coimbatore,26757,2319,4992,62,24022,192992,2319,51,0,195362,169702,1638
09-06-2021,cuddalore,4894,427,477,13,4831,52826,427,203,0,53456,48010,615
09-06-2021,dharmapuri,2764,263,336,5,2686,20941,263,216,0,21420,18575,159
09-06-2021,dindigul,2200,223,371,5,2047,29220,223,77,0,29520,26991,482
09-06-2021,erode,14282,1405,1953,10,13724,69389,1405,94,0,70888,56695,469
09-06-2021,kallakurichi,4188,297,454,5,4026,23140,297,404,0,23841,19654,161
09-06-2021,kancheepuram,2572,294,526,12,2328,66600,294,4,0,66898,63493,1077
09-06-2021,kanyakumari,6810,447,282,14,6961,54030,447,124,0,54601,46775,865
09-06-2021,karur,2711,188,350,6,2543,19732,188,47,0,19967,17133,291
09-06-2021,krishnagiri,3274,293,616,10,2941,35520,293,228,0,36041,32854,246
09-06-2021,madurai,9667,369,1255,15,8766,68509,369,171,0,69049,59280,1003
09-06-2021,nagapattinam,4551,422,600,8,4365,33458,422,92,0,33972,29190,417
09-06-2021,namakkal,6445,472,991,10,5916,37888,472,107,0,38467,32215,336
09-06-2021,nilgiris,4204,489,583,1,4109,23329,489,41,0,23859,19625,125
09-06-2021,perambalur,1556,133,227,15,1447,9882,133,3,0,10018,8432,139
09-06-2021,pudukottai,2286,185,321,0,2150,24778,185,35,0,24998,22597,251
09-06-2021,ramanathapuram,2558,127,148,2,2535,18054,127,135,0,18316,15494,287
09-06-2021,ranipet,2348,326,414,7,2253,37251,326,49,0,37626,34797,576
09-06-2021,salem,10558,957,1115,23,10377,74309,956,435,1,75701,64147,1177
09-06-2021,sivagangai,1595,117,146,0,1566,15601,117,107,0,15825,14083,176
09-06-2021,tenkasi,2937,190,677,9,2441,24490,190,58,0,24738,21891,406
09-06-2021,thanjavur,6946,685,814,7,6810,54561,685,22,0,55268,47868,590
09-06-2021,theni,3676,263,436,0,3503,39546,263,45,0,39854,35939,412
09-06-2021,thirupathur,2692,214,714,6,2186,25189,214,118,0,25521,22925,410
09-06-2021,thiruvallur,3711,404,737,12,3366,105724,404,10,0,106138,101220,1552
09-06-2021,thiruvannamalai,6559,313,484,6,6382,44278,313,398,0,44989,38119,488
09-06-2021,thiruvarur,4104,289,700,7,3686,33635,289,38,0,33962,30021,255
09-06-2021,thoothukudi,5564,297,762,3,5096,50511,297,275,0,51083,45663,324
09-06-2021,tirunelveli,3367,258,602,3,3020,45041,258,427,0,45726,42330,376
09-06-2021,tiruppur,18972,913,1511,15,18359,70205,913,11,0,71129,52170,600
09-06-2021,trichy,8502,510,1097,12,7903,62768,510,60,0,63338,54719,716
09-06-2021,vellore,1889,259,398,10,1740,42869,258,1563,1,44691,42089,862
09-06-2021,villupuram,4531,392,683,4,4236,38306,392,174,0,38872,34338,298
09-06-2021,virudhunagar,4488,336,769,4,4051,41120,336,104,0,41560,37036,473
09-06-2021,airport surveillance (international),2,0,0,0,2,0,0,1004,0,1004,1001,1
09-06-2021,airport surveillance (domestic),0,0,0,0,0,0,0,1075,0,1075,1074,1
09-06-2021,railway surveillance,0,0,0,0,0,0,0,428,0,428,428,0
10-06-2021,ariyalur,1619,108,282,1,1444,13196,108,20,0,13324,11722,158
10-06-2021,chengalpattu,5611,676,1031,22,5234,148750,676,5,0,149431,142029,2168
10-06-2021,chennai,14630,1223,3598,45,12210,520782,1223,47,0,522052,502184,7658
10-06-2021,coimbatore,24025,2236,5057,20,21184,195314,2236,51,0,197601,174759,1658
10-06-2021,cuddalore,4832,394,519,13,4694,53254,394,203,0,53851,48529,628
10-06-2021,dharmapuri,2686,292,326,2,2650,21204,292,216,0,21712,18901,161
10-06-2021,dindigul,2044,240,351,3,1930,29440,240,77,0,29757,27342,485
10-06-2021,erode,13708,1390,1990,6,13102,70778,1390,94,0,72262,58685,475
10-06-2021,kallakurichi,4030,272,363,8,3931,23441,272,404,0,24117,20017,169
10-06-2021,kancheepuram,2318,355,455,5,2213,66884,355,4,0,67243,63948,1082
10-06-2021,kanyakumari,6961,469,818,9,6603,54477,469,124,0,55070,47593,874
10-06-2021,karur,2553,172,199,13,2513,19930,172,47,0,20149,17332,304
10-06-2021,krishnagiri,2944,298,672,10,2560,35816,298,228,0,36342,33526,256
10-06-2021,madurai,8758,279,1177,6,7854,68870,279,171,0,69320,60457,1009
10-06-2021,nagapattinam,4366,504,685,7,4178,33881,504,92,0,34477,29875,424
10-06-2021,namakkal,5908,453,893,1,5467,38352,453,107,0,38912,33108,337
10-06-2021,nilgiris,4109,442,579,3,3969,23818,442,41,0,24301,20204,128
10-06-2021,perambalur,1450,112,248,7,1307,10018,112,3,0,10133,8680,146
10-06-2021,pudukottai,2158,182,300,6,2034,24971,182,35,0,25188,22897,257
10-06-2021,ramanathapuram,2537,121,230,7,2421,18183,121,135,0,18439,15724,294
10-06-2021,ranipet,2255,266,426,9,2086,37579,266,49,0,37894,35223,585
10-06-2021,salem,10387,945,1141,23,10168,75275,945,436,0,76656,65288,1200
10-06-2021,sivagangai,1568,102,148,2,1520,15720,102,107,0,15929,14231,178
10-06-2021,tenkasi,2441,235,715,8,1953,24680,235,58,0,24973,22606,414
10-06-2021,thanjavur,6816,652,1009,16,6443,55252,652,22,0,55926,48877,606
10-06-2021,theni,3502,258,755,19,2986,39808,258,45,0,40111,36694,431
10-06-2021,thirupathur,2186,207,474,19,1900,25403,207,118,0,25728,23399,429
10-06-2021,thiruvallur,3393,428,722,4,3095,106155,428,10,0,106593,101942,1556
10-06-2021,thiruvannamalai,6390,304,464,14,6216,44599,304,398,0,45301,38583,502
10-06-2021,thiruvarur,3685,294,701,0,3278,33923,294,38,0,34255,30722,255
10-06-2021,thoothukudi,5096,345,653,5,4783,50808,345,275,0,51428,46316,329
10-06-2021,tirunelveli,3022,267,277,4,3008,45301,267,427,0,45995,42607,380
10-06-2021,tiruppur,18370,897,1770,12,17485,71129,897,11,0,72037,53940,612
10-06-2021,trichy,7879,470,1109,8,7232,63254,470,60,0,63784,55828,724
10-06-2021,vellore,1727,227,383,15,1556,43114,225,1564,2,44905,42472,877
10-06-2021,villupuram,4238,404,597,4,4041,38700,404,174,0,39278,34935,302
10-06-2021,virudhunagar,4054,294,932,2,3414,41459,294,104,0,41857,37968,475
10-06-2021,airport surveillance (international),2,0,0,0,2,0,0,1004,0,1004,1001,1
10-06-2021,airport surveillance (domestic),0,0,0,0,0,0,0,1075,0,1075,1074,1
10-06-2021,railway surveillance,0,0,0,0,0,0,0,428,0,428,428,0
11-06-2021,ariyalur,1445,105,256,11,1283,13305,105,20,0,13430,11978,169
11-06-2021,chengalpattu,5243,621,1282,16,4566,149435,621,5,0,150061,143311,2184
11-06-2021,chennai,12184,1094,2377,59,10842,521982,1094,47,0,523123,504561,7720
11-06-2021,coimbatore,21187,2056,4612,31,18600,197553,2056,51,0,199660,179371,1689
11-06-2021,cuddalore,4698,354,353,22,4677,53653,354,203,0,54210,48882,651
11-06-2021,dharmapuri,2653,251,329,3,2572,21499,251,216,0,21966,19230,164
11-06-2021,dindigul,1927,207,252,5,1877,29678,207,77,0,29962,27594,491
11-06-2021,erode,13087,1365,1921,11,12520,72153,1365,94,0,73612,60606,486
11-06-2021,kallakurichi,3925,243,410,4,3754,23706,243,404,0,24353,20427,172
11-06-2021,kancheepuram,2217,325,604,7,1931,67244,325,4,0,67573,64552,1090
11-06-2021,kanyakumari,6604,456,1005,15,6040,54947,456,124,0,55527,48598,889
11-06-2021,karur,2517,158,395,6,2274,20106,158,47,0,20311,17727,310
11-06-2021,krishnagiri,2551,288,404,2,2433,36104,288,228,0,36620,33930,257
11-06-2021,madurai,7848,283,1060,7,7064,69143,283,171,0,69597,61517,1016
11-06-2021,nagapattinam,4169,482,573,9,4069,34377,482,92,0,34951,30448,434
11-06-2021,namakkal,5475,434,822,7,5080,38811,434,107,0,39352,33930,342
11-06-2021,nilgiris,3970,419,585,0,3804,24261,419,41,0,24721,20789,128
11-06-2021,perambalur,1308,96,217,5,1182,10131,96,3,0,10230,8897,151
11-06-2021,pudukottai,2037,159,306,1,1889,25155,159,35,0,25349,23203,257
11-06-2021,ramanathapuram,2420,125,1190,4,1351,18305,125,135,0,18565,16914,300
11-06-2021,ranipet,2089,249,320,3,2015,37848,249,49,0,38146,35543,588
11-06-2021,salem,10178,916,1282,13,9799,76231,916,436,0,77583,66570,1214
11-06-2021,sivagangai,1521,117,215,2,1421,15822,117,107,0,16046,14446,179
11-06-2021,tenkasi,1953,198,388,5,1758,24915,198,58,0,25171,22994,419
11-06-2021,thanjavur,6449,656,1028,8,6069,55910,656,22,0,56588,49905,614
11-06-2021,theni,2986,212,524,13,2661,40066,212,45,0,40323,37218,444
11-06-2021,thirupathur,1905,176,325,13,1743,25616,176,118,0,25910,23724,443
11-06-2021,thiruvallur,3087,402,689,20,2780,106570,402,10,0,106982,102631,1571
11-06-2021,thiruvannamalai,6217,298,432,13,6070,44904,298,398,0,45600,39015,515
11-06-2021,thiruvarur,3278,272,737,6,2807,34217,272,38,0,34527,31459,261
11-06-2021,thoothukudi,4784,338,562,8,4552,51154,338,275,0,51767,46878,337
11-06-2021,tirunelveli,3009,231,432,1,2807,45569,231,427,0,46227,43039,381
11-06-2021,tiruppur,17494,853,836,13,17498,72035,853,11,0,72899,54776,625
11-06-2021,trichy,7229,439,1114,20,6534,63721,439,60,0,64220,56942,744
11-06-2021,vellore,1554,209,312,9,1442,43337,207,1566,2,45112,42784,886
11-06-2021,villupuram,4046,382,609,2,3817,39109,382,174,0,39665,35544,304
11-06-2021,virudhunagar,3418,290,485,4,3219,41757,290,104,0,42151,38453,479
11-06-2021,airport surveillance (international),2,0,0,0,2,0,0,1004,0,1004,1001,1
11-06-2021,airport surveillance (domestic),0,0,0,0,0,0,0,1075,0,1075,1074,1
11-06-2021,railway surveillance,0,0,0,0,0,0,0,428,0,428,428,0
12-06-2021,ariyalur,1283,98,278,1,1102,13410,98,20,0,13528,12256,170
12-06-2021,chengalpattu,4576,586,618,13,4531,150066,586,5,0,150657,143929,2197
12-06-2021,chennai,10815,989,1893,73,9838,523049,989,47,0,524085,506454,7793
12-06-2021,coimbatore,18602,1982,2283,27,18274,199611,1982,51,0,201644,181654,1716
12-06-2021,cuddalore,4677,349,557,10,4459,54007,349,203,0,54559,49439,661
12-06-2021,dharmapuri,2570,241,309,3,2499,21748,241,216,0,22205,19539,167
12-06-2021,dindigul,1871,196,246,21,1800,29879,196,77,0,30152,27840,512
12-06-2021,erode,12524,1353,1982,3,11892,73522,1353,94,0,74969,62588,489
12-06-2021,kallakurichi,3754,231,531,4,3450,23949,231,404,0,24584,20958,176
12-06-2021,kancheepuram,1933,305,366,6,1866,67571,305,4,0,67880,64918,1096
12-06-2021,kanyakumari,6040,444,839,8,5637,55403,444,124,0,55971,49437,897
12-06-2021,karur,2275,127,332,4,2066,20265,127,47,0,20439,18059,314
12-06-2021,krishnagiri,2435,266,369,3,2329,36394,266,228,0,36888,34299,260
12-06-2021,madurai,7068,279,1420,6,5921,69430,279,171,0,69880,62937,1022
12-06-2021,nagapattinam,4067,419,691,13,3782,34857,419,92,0,35368,31139,447
12-06-2021,namakkal,5068,398,794,4,4668,39233,398,107,0,39738,34724,346
12-06-2021,nilgiris,3804,415,515,4,3700,24680,415,41,0,25136,21304,132
12-06-2021,perambalur,1183,84,230,4,1033,10228,84,3,0,10315,9127,155
12-06-2021,pudukottai,1894,151,369,2,1674,25319,151,35,0,25505,23572,259
12-06-2021,ramanathapuram,1353,115,371,1,1096,18432,115,135,0,18682,17285,301
12-06-2021,ranipet,2016,237,309,10,1934,38098,237,49,0,38384,35852,598
12-06-2021,salem,9805,894,1373,30,9296,77153,894,436,0,78483,67943,1244
12-06-2021,sivagangai,1421,145,181,2,1383,15939,145,107,0,16191,14627,181
12-06-2021,tenkasi,1765,176,229,4,1708,25120,176,58,0,25354,23223,423
12-06-2021,thanjavur,6057,645,621,5,6076,56553,645,22,0,57220,50526,618
12-06-2021,theni,2662,219,762,12,2107,40279,219,45,0,40543,37980,456
12-06-2021,thirupathur,1744,182,338,7,1581,25793,182,118,0,26093,24062,450
12-06-2021,thiruvallur,2783,392,613,29,2533,106975,392,10,0,107377,103244,1600
12-06-2021,thiruvannamalai,6073,338,2511,5,3895,45205,338,398,0,45941,41526,520
12-06-2021,thiruvarur,2818,261,579,3,2497,34501,261,38,0,34800,32038,265
12-06-2021,thoothukudi,4560,296,497,6,4353,51500,296,275,0,52071,47375,343
12-06-2021,tirunelveli,2786,196,447,1,2534,45779,196,427,0,46402,43486,382
12-06-2021,tiruppur,17506,844,1777,6,16567,72896,844,11,0,73751,56553,631
12-06-2021,trichy,6534,420,986,11,5957,64160,420,60,0,64640,57928,755
12-06-2021,vellore,1439,190,226,20,1383,43541,187,1568,3,45299,43010,906
12-06-2021,villupuram,3818,372,577,5,3608,39492,372,174,0,40038,36121,309
12-06-2021,virudhunagar,3221,273,444,8,3042,42049,273,104,0,42426,38897,487
12-06-2021,airport surveillance (international),2,0,0,0,2,0,0,1004,0,1004,1001,1
12-06-2021,airport surveillance (domestic),0,0,0,0,0,0,0,1075,0,1075,1074,1
12-06-2021,railway surveillance,0,0,0,0,0,0,0,428,0,428,428,0
13-06-2021,ariyalur,1102,91,164,0,1029,13508,91,20,0,13619,12420,170
13-06-2021,chengalpattu,4540,563,882,16,4205,150660,563,5,0,151228,144811,2212
13-06-2021,chennai,9821,935,1589,27,9140,524027,935,47,0,525009,508043,7826
13-06-2021,coimbatore,18275,1895,2534,19,17617,201594,1895,51,0,203540,184188,1735
13-06-2021,cuddalore,4458,319,721,5,4051,54355,319,203,0,54877,50160,666
13-06-2021,dharmapuri,2502,211,320,5,2388,21992,211,216,0,22419,19859,172
13-06-2021,dindigul,1796,165,309,13,1639,30071,165,77,0,30313,28149,525
13-06-2021,erode,11860,1323,1809,3,11371,74843,1323,94,0,76260,64397,492
13-06-2021,kallakurichi,3447,170,636,6,2975,24177,170,404,0,24751,21594,182
13-06-2021,kancheepuram,1867,292,400,13,1746,67878,292,4,0,68174,65318,1110
13-06-2021,kanyakumari,5638,403,827,8,5206,55848,403,124,0,56375,50264,905
13-06-2021,karur,2067,95,402,2,1758,20393,95,47,0,20535,18461,316
13-06-2021,krishnagiri,2330,273,253,1,2349,36661,273,228,0,37162,34552,261
13-06-2021,madurai,5911,227,773,7,5358,69699,227,171,0,70097,63710,1029
13-06-2021,nagapattinam,3787,323,598,8,3504,35280,323,92,0,35695,31737,454
13-06-2021,namakkal,4684,373,734,6,4317,39647,373,107,0,40127,35458,352
13-06-2021,nilgiris,3700,422,517,3,3602,25095,422,41,0,25558,21821,135
13-06-2021,perambalur,1033,66,210,3,886,10312,66,3,0,10381,9337,158
13-06-2021,pudukottai,1667,123,260,7,1523,25463,123,35,0,25621,23832,266
13-06-2021,ramanathapuram,1097,117,117,7,1090,18548,117,135,0,18800,17402,308
13-06-2021,ranipet,1932,184,285,18,1813,38334,184,49,0,38567,36137,617
13-06-2021,salem,9310,855,1400,11,8754,78061,855,436,0,79352,69343,1255
13-06-2021,sivagangai,1386,135,345,0,1176,16087,135,107,0,16329,14972,181
13-06-2021,tenkasi,1716,153,216,8,1645,25305,153,58,0,25516,23439,432
13-06-2021,thanjavur,6075,615,1311,4,5375,57197,615,22,0,57834,51837,622
13-06-2021,theni,2108,196,508,2,1794,40499,196,45,0,40740,38488,458
13-06-2021,thirupathur,1576,165,339,5,1397,25971,165,118,0,26254,24401,456
13-06-2021,thiruvallur,2536,359,514,15,2366,107365,359,10,0,107734,103758,1610
13-06-2021,thiruvannamalai,3897,306,1776,5,2422,45545,306,398,0,46249,43302,525
13-06-2021,thiruvarur,2497,239,426,8,2302,34763,239,38,0,35040,32464,274
13-06-2021,thoothukudi,4358,289,1023,5,3619,51801,289,275,0,52365,48398,348
13-06-2021,tirunelveli,2519,151,175,6,2489,45960,151,427,0,46538,43661,388
13-06-2021,tiruppur,16578,820,1570,3,15825,73751,820,11,0,74582,58123,634
13-06-2021,trichy,5956,413,875,11,5483,64579,413,60,0,65052,58803,766
13-06-2021,vellore,1387,185,247,2,1323,43730,184,1571,1,45486,43257,906
13-06-2021,villupuram,3609,304,524,1,3388,39863,304,174,0,40341,36645,308
13-06-2021,virudhunagar,3049,260,306,4,2999,42329,260,104,0,42693,39203,491
13-06-2021,airport surveillance (international),2,1,0,0,3,0,0,1004,1,1005,1001,1
13-06-2021,airport surveillance (domestic),0,0,0,0,0,0,0,1075,0,1075,1074,1
13-06-2021,railway surveillance,0,0,0,0,0,0,0,428,0,428,428,0
14-06-2021,ariyalur,1031,82,181,4,928,13600,82,20,0,13702,12601,173
14-06-2021,chengalpattu,4212,522,829,33,3872,151232,522,5,0,151759,145640,2247
14-06-2021,chennai,9129,828,1454,28,8475,524951,828,47,0,525826,509497,7854
14-06-2021,coimbatore,17618,1728,2664,27,16655,203490,1728,51,0,205269,186852,1762
14-06-2021,cuddalore,4051,283,949,8,3377,54675,283,203,0,55161,51109,675
14-06-2021,dharmapuri,2388,167,371,3,2181,22203,167,216,0,22586,20230,175
14-06-2021,dindigul,1629,147,294,1,1481,30227,147,77,0,30451,28443,527
14-06-2021,erode,11371,1295,1698,3,10965,76166,1295,94,0,77555,66095,495
14-06-2021,kallakurichi,2974,145,613,1,2505,24346,145,404,0,24895,22207,183
14-06-2021,kancheepuram,1743,210,356,13,1584,68165,210,4,0,68379,65674,1121
14-06-2021,kanyakumari,5206,364,938,4,4628,56251,364,124,0,56739,51202,909
14-06-2021,karur,1760,129,456,0,1433,20490,129,47,0,20666,18917,316
14-06-2021,krishnagiri,2349,242,468,1,2122,36934,242,228,0,37404,35020,262
14-06-2021,madurai,5357,219,1277,9,4290,69925,219,171,0,70315,64987,1038
14-06-2021,nagapattinam,3506,285,629,9,3153,35605,285,92,0,35982,32366,463
14-06-2021,namakkal,4320,313,691,5,3937,40023,313,107,0,40443,36149,357
14-06-2021,nilgiris,3602,380,510,2,3470,25517,380,41,0,25938,22331,137
14-06-2021,perambalur,886,52,158,6,774,10378,52,3,0,10433,9495,164
14-06-2021,pudukottai,1524,89,198,2,1413,25587,89,35,0,25711,24030,268
14-06-2021,ramanathapuram,1091,95,199,1,986,18666,95,135,0,18896,17601,309
14-06-2021,ranipet,1815,293,278,6,1824,38521,293,49,0,38863,36415,624
14-06-2021,salem,8755,796,1620,11,7920,78917,796,436,0,80149,70963,1266
14-06-2021,sivagangai,1180,88,237,1,1030,16226,88,107,0,16421,15209,182
14-06-2021,tenkasi,1653,126,72,0,1707,25466,126,58,0,25650,23511,432
14-06-2021,thanjavur,5367,596,881,3,5079,57804,596,22,0,58422,52718,625
14-06-2021,theni,1794,171,290,7,1668,40695,171,45,0,40911,38778,465
14-06-2021,thirupathur,1399,196,293,7,1295,26138,196,118,0,26452,24694,463
14-06-2021,thiruvallur,2367,329,476,5,2215,107725,329,10,0,108064,104234,1615
14-06-2021,thiruvannamalai,2427,252,423,6,2250,45856,252,398,0,46506,43725,531
14-06-2021,thiruvarur,2305,193,390,7,2101,35005,193,38,0,35236,32854,281
14-06-2021,thoothukudi,3621,250,941,2,2928,52092,250,275,0,52617,49339,350
14-06-2021,tirunelveli,2476,134,279,3,2328,46098,134,427,0,46659,43940,391
14-06-2021,tiruppur,15831,781,2217,8,14387,74577,781,11,0,75369,60340,642
14-06-2021,trichy,5483,378,824,11,5026,64991,378,60,0,65429,59627,776
14-06-2021,vellore,1313,153,273,8,1185,43903,151,1572,2,45628,43530,913
14-06-2021,villupuram,3388,263,473,3,3175,40167,263,174,0,40604,37118,311
14-06-2021,virudhunagar,3003,198,661,6,2534,42593,198,104,0,42895,39864,497
14-06-2021,airport surveillance (international),3,0,0,0,3,0,0,1005,0,1005,1001,1
14-06-2021,airport surveillance (domestic),0,0,0,0,0,0,0,1075,0,1075,1074,1
14-06-2021,railway surveillance,0,0,0,0,0,0,0,428,0,428,428,0
15-06-2021,ariyalur,928,67,210,1,784,13682,67,20,0,13769,12811,174
15-06-2021,chengalpattu,3873,497,851,14,3505,151755,497,5,0,152257,146491,2261
15-06-2021,chennai,8469,793,1777,21,7464,525774,793,47,0,526614,511274,7876
15-06-2021,coimbatore,16656,1563,2754,16,15449,205219,1563,51,0,206833,189606,1778
15-06-2021,cuddalore,3380,262,481,19,3142,54961,262,203,0,55426,51590,694
15-06-2021,dharmapuri,2183,143,338,0,1988,22372,143,216,0,22731,20568,175
15-06-2021,dindigul,1479,129,301,3,1304,30372,129,77,0,30578,28744,530
15-06-2021,erode,10960,1270,1639,2,10589,77456,1270,94,0,78820,67734,497
15-06-2021,kallakurichi,2504,118,260,1,2361,24490,118,404,0,25012,22467,184
15-06-2021,kancheepuram,1582,220,311,5,1486,68373,220,4,0,68597,65985,1126
15-06-2021,kanyakumari,4628,333,297,16,4648,56615,333,124,0,57072,51499,925
15-06-2021,karur,1434,123,310,5,1242,20620,123,47,0,20790,19227,321
15-06-2021,krishnagiri,2120,220,272,2,2066,37174,220,228,0,37622,35292,264
15-06-2021,madurai,4287,192,901,6,3572,70140,192,171,0,70503,65888,1043
15-06-2021,nagapattinam,3153,256,492,4,2913,35890,256,92,0,36238,32858,467
15-06-2021,namakkal,3938,306,624,0,3620,40337,306,107,0,40750,36773,357
15-06-2021,nilgiris,3470,308,503,1,3274,25897,308,41,0,26246,22834,138
15-06-2021,perambalur,777,53,150,3,677,10433,53,3,0,10489,9645,167
15-06-2021,pudukottai,1413,81,181,6,1307,25676,81,35,0,25792,24211,274
15-06-2021,ramanathapuram,987,82,81,5,983,18762,82,135,0,18979,17682,314
15-06-2021,ranipet,1824,265,393,10,1686,38816,265,49,0,39130,36808,636
15-06-2021,salem,7924,759,1879,24,6780,79717,759,436,0,80912,72842,1290
15-06-2021,sivagangai,1031,77,143,4,961,16315,77,107,0,16499,15352,186
15-06-2021,tenkasi,1711,115,188,4,1634,25596,115,58,0,25769,23699,436
15-06-2021,thanjavur,5080,541,834,20,4767,58401,541,22,0,58964,53552,645
15-06-2021,theni,1668,150,228,6,1584,40866,150,45,0,41061,39006,471
15-06-2021,thirupathur,1297,169,263,4,1199,26336,169,118,0,26623,24957,467
15-06-2021,thiruvallur,2214,306,439,14,2067,108053,306,10,0,108369,104673,1629
15-06-2021,thiruvannamalai,2251,246,363,7,2127,46109,246,398,0,46753,44088,538
15-06-2021,thiruvarur,2099,170,386,3,1880,35196,170,38,0,35404,33240,284
15-06-2021,thoothukudi,2935,222,526,4,2627,52349,222,275,0,52846,49865,354
15-06-2021,tirunelveli,2318,116,643,1,1790,46222,116,427,0,46765,44583,392
15-06-2021,tiruppur,14391,728,2377,4,12738,75362,728,11,0,76101,62717,646
15-06-2021,trichy,5020,360,683,14,4683,65363,360,60,0,65783,60310,790
15-06-2021,vellore,1184,143,292,14,1021,44051,141,1574,2,45768,43822,925
15-06-2021,villupuram,3177,244,412,1,3008,40432,244,174,0,40850,37530,312
15-06-2021,virudhunagar,2536,178,425,3,2286,42793,178,104,0,43075,40289,500
15-06-2021,airport surveillance (international),3,0,0,0,3,0,0,1005,0,1005,1001,1
15-06-2021,airport surveillance (domestic),0,0,0,0,0,0,0,1075,0,1075,1074,1
15-06-2021,railway surveillance,0,0,0,0,0,0,0,428,0,428,428,0
16-06-2021,ariyalur,784,83,165,5,697,13749,83,20,0,13852,12976,179
16-06-2021,chengalpattu,3513,456,787,13,3169,152261,456,5,0,152722,147278,2275
16-06-2021,chennai,7442,689,1558,42,6531,526547,689,47,0,527283,512832,7920
16-06-2021,coimbatore,15449,1420,2445,28,14396,206782,1420,51,0,208253,192051,1806
16-06-2021,cuddalore,3144,248,347,7,3038,55223,248,203,0,55674,51937,699
16-06-2021,dharmapuri,1989,179,304,2,1862,22516,179,216,0,22911,20872,177
16-06-2021,dindigul,1304,117,231,12,1178,30501,117,77,0,30695,28975,542
16-06-2021,erode,10584,1123,1733,12,9962,78721,1123,94,0,79938,69467,509
16-06-2021,kallakurichi,2359,155,327,1,2186,24606,155,404,0,25165,22794,185
16-06-2021,kancheepuram,1486,176,290,4,1368,68592,176,4,0,68772,66275,1129
16-06-2021,kanyakumari,4650,250,404,5,4491,56950,250,124,0,57324,51903,930
16-06-2021,karur,1244,110,98,2,1254,20745,110,47,0,20902,19325,323
16-06-2021,krishnagiri,2064,207,220,5,2046,37392,207,228,0,37827,35512,269
16-06-2021,madurai,3576,178,624,5,3125,70336,178,171,0,70685,66512,1048
16-06-2021,nagapattinam,2913,206,472,6,2641,36149,206,92,0,36447,33330,476
16-06-2021,namakkal,3624,314,608,6,3324,40647,314,107,0,41068,37381,363
16-06-2021,nilgiris,3274,242,498,2,3016,26205,242,41,0,26488,23332,140
16-06-2021,perambalur,678,45,109,3,611,10488,45,3,0,10536,9754,171
16-06-2021,pudukottai,1305,74,200,4,1175,25755,74,35,0,25864,24411,278
16-06-2021,ramanathapuram,983,76,160,1,898,18844,76,135,0,19055,17842,315
16-06-2021,ranipet,1680,223,336,3,1564,39076,223,49,0,39348,37144,640
16-06-2021,salem,6784,693,1456,18,6003,80479,693,436,0,81608,74298,1307
16-06-2021,sivagangai,961,104,88,0,977,16392,104,107,0,16603,15440,186
16-06-2021,tenkasi,1638,98,211,5,1520,25715,98,58,0,25871,23910,441
16-06-2021,thanjavur,4768,405,569,8,4596,58943,405,22,0,59370,54121,653
16-06-2021,theni,1585,154,163,1,1575,41017,154,45,0,41216,39169,472
16-06-2021,thirupathur,1195,126,426,20,875,26503,126,118,0,26747,25383,489
16-06-2021,thiruvallur,2075,275,418,7,1925,108365,275,10,0,108650,105091,1634
16-06-2021,thiruvannamalai,2128,197,659,2,1664,46356,197,398,0,46951,44747,540
16-06-2021,thiruvarur,1880,154,323,3,1708,35366,154,38,0,35558,33563,287
16-06-2021,thoothukudi,2629,167,358,4,2434,52573,167,275,0,53015,50223,358
16-06-2021,tirunelveli,1783,108,416,2,1473,46331,108,427,0,46866,44999,394
16-06-2021,tiruppur,12731,608,1968,10,11361,76083,608,11,0,76702,64685,656
16-06-2021,trichy,4685,318,649,6,4348,65724,318,60,0,66102,60959,795
16-06-2021,vellore,1029,126,506,10,639,44197,124,1576,2,45899,44328,932
16-06-2021,villupuram,3010,182,390,3,2799,40678,182,174,0,41034,37920,315
16-06-2021,virudhunagar,2286,162,542,3,1903,42971,162,104,0,43237,40831,503
16-06-2021,airport surveillance (international),3,0,0,0,3,0,0,1005,0,1005,1001,1
16-06-2021,airport surveillance (domestic),0,0,0,0,0,0,0,1075,0,1075,1074,1
16-06-2021,railway surveillance,0,0,0,0,0,0,0,428,0,428,428,0
17-06-2021,ariyalur,698,85,168,0,615,13833,85,20,0,13938,13144,179
17-06-2021,chengalpattu,3178,364,1059,10,2473,152726,364,5,0,153095,148337,2285
17-06-2021,chennai,6524,559,2367,33,4683,527229,559,47,0,527835,515199,7953
17-06-2021,coimbatore,14397,1227,2787,17,12820,208203,1227,51,0,209481,194838,1823
17-06-2021,cuddalore,3036,234,594,3,2673,55469,234,203,0,55906,52531,702
17-06-2021,dharmapuri,1864,133,235,6,1756,22697,133,216,0,23046,21107,183
17-06-2021,dindigul,1177,92,243,5,1021,30617,92,77,0,30786,29218,547
17-06-2021,erode,9909,1041,1239,2,9709,79792,1041,94,0,80927,70706,512
17-06-2021,kallakurichi,2186,172,258,1,2099,24761,172,404,0,25337,23052,186
17-06-2021,kancheepuram,1373,152,287,6,1232,68773,152,4,0,68929,66562,1135
17-06-2021,kanyakumari,4491,179,1005,5,3660,57200,179,124,0,57503,52908,935
17-06-2021,karur,1255,132,437,3,947,20856,132,47,0,21035,19762,326
17-06-2021,krishnagiri,2046,195,406,3,1832,37599,195,228,0,38022,35918,272
17-06-2021,madurai,3118,164,939,2,2341,70507,164,171,0,70842,67451,1050
17-06-2021,nagapattinam,2640,186,433,1,2392,36354,186,92,0,36632,33763,477
17-06-2021,namakkal,3343,330,526,2,3145,40980,330,107,0,41417,37907,365
17-06-2021,nilgiris,3016,174,489,1,2700,26447,171,41,3,26662,23821,141
17-06-2021,perambalur,612,40,118,2,532,10534,40,3,0,10577,9872,173
17-06-2021,pudukottai,1179,69,259,4,985,25833,69,35,0,25937,24670,282
17-06-2021,ramanathapuram,898,65,230,3,730,18920,65,135,0,19120,18072,318
17-06-2021,ranipet,1559,178,334,2,1401,39293,178,49,0,39520,37478,641
17-06-2021,salem,6020,598,970,15,5633,81188,598,436,0,82222,75268,1321
17-06-2021,sivagangai,978,84,136,0,926,16497,84,107,0,16688,15576,186
17-06-2021,tenkasi,1520,93,599,1,1013,25813,93,58,0,25964,24509,442
17-06-2021,thanjavur,4599,311,959,8,3943,59350,311,22,0,59683,55080,660
17-06-2021,theni,1574,139,227,0,1486,41170,139,45,0,41354,39396,472
17-06-2021,thirupathur,875,108,228,11,744,26630,108,118,0,26856,25611,501
17-06-2021,thiruvallur,1912,226,703,7,1428,108627,226,10,0,108863,105794,1641
17-06-2021,thiruvannamalai,1667,177,305,5,1534,46556,177,398,0,47131,45052,545
17-06-2021,thiruvarur,1712,132,287,5,1552,35525,132,38,0,35695,33850,293
17-06-2021,thoothukudi,2435,149,313,5,2266,52741,149,275,0,53165,50536,363
17-06-2021,tirunelveli,1475,87,169,3,1390,46441,87,427,0,46955,45168,397
17-06-2021,tiruppur,11383,542,877,9,11039,76713,542,11,0,77266,65562,665
17-06-2021,trichy,4337,283,1133,16,3471,66031,283,60,0,66374,62092,811
17-06-2021,vellore,643,113,443,8,305,44325,113,1578,0,46016,44771,940
17-06-2021,villupuram,2800,163,445,3,2515,40861,163,174,0,41198,38365,318
17-06-2021,virudhunagar,1903,142,513,3,1529,43133,142,104,0,43379,41344,506
17-06-2021,airport surveillance (international),3,0,0,0,3,0,0,1005,0,1005,1001,1
17-06-2021,airport surveillance (domestic),0,0,0,0,0,0,0,1075,0,1075,1074,1
17-06-2021,railway surveillance,0,0,0,0,0,0,0,428,0,428,428,0
18-06-2021,ariyalur,615,98,113,3,597,13918,98,20,0,14036,13257,182
18-06-2021,chengalpattu,2476,353,871,9,1949,153093,353,5,0,153451,149208,2294
18-06-2021,chennai,4678,492,1762,48,3360,527783,492,47,0,528322,516961,8001
18-06-2021,coimbatore,12822,1089,2237,30,11644,209433,1089,51,0,210573,197075,1854
18-06-2021,cuddalore,2673,224,601,5,2291,55703,224,203,0,56130,53132,707
18-06-2021,dharmapuri,1756,130,263,1,1622,22830,130,216,0,23176,21370,184
18-06-2021,dindigul,1022,104,233,9,884,30710,104,77,0,30891,29451,556
18-06-2021,erode,9679,964,1266,12,9365,80803,964,94,0,81861,71972,524
18-06-2021,kallakurichi,2098,167,366,1,1898,24932,167,404,0,25503,23418,187
18-06-2021,kancheepuram,1238,143,357,8,1016,68931,143,4,0,69078,66919,1143
18-06-2021,kanyakumari,3654,156,442,6,3362,57373,156,124,0,57653,53350,941
18-06-2021,karur,951,126,217,4,856,20992,126,47,0,21165,19979,330
18-06-2021,krishnagiri,1832,185,301,6,1710,37794,185,228,0,38207,36219,278
18-06-2021,madurai,2336,160,760,10,1726,70666,160,171,0,70997,68211,1060
18-06-2021,nagapattinam,2393,168,517,3,2041,36540,168,92,0,36800,34280,479
18-06-2021,namakkal,3158,326,938,3,2543,41323,326,107,0,41756,38845,368
18-06-2021,nilgiris,2700,181,443,1,2437,26618,181,44,0,26843,24264,142
18-06-2021,perambalur,532,66,136,5,457,10574,66,3,0,10643,10008,178
18-06-2021,pudukottai,985,83,140,2,926,25902,83,35,0,26020,24810,284
18-06-2021,ramanathapuram,731,67,128,2,668,18986,67,135,0,19188,18200,320
18-06-2021,ranipet,1395,169,266,10,1288,39465,169,49,0,39683,37744,651
18-06-2021,salem,5634,541,956,23,5196,81787,541,436,0,82764,76224,1344
18-06-2021,sivagangai,927,79,94,0,912,16581,79,107,0,16767,15670,185
18-06-2021,tenkasi,1013,83,103,2,991,25906,83,58,0,26047,24612,444
18-06-2021,thanjavur,3938,367,655,2,3648,59656,367,22,0,60045,55735,662
18-06-2021,theni,1489,129,215,0,1403,41312,129,45,0,41486,39611,472
18-06-2021,thirupathur,747,94,155,15,671,26741,94,118,0,26953,25766,516
18-06-2021,thiruvallur,1426,220,422,4,1220,108851,220,10,0,109081,106216,1645
18-06-2021,thiruvannamalai,1539,182,252,10,1459,46738,182,398,0,47318,45304,555
18-06-2021,thiruvarur,1553,137,298,0,1392,35659,137,38,0,35834,34148,294
18-06-2021,thoothukudi,2264,141,320,0,2085,52888,141,275,0,53304,50856,363
18-06-2021,tirunelveli,1393,76,209,2,1258,46532,76,427,0,47035,45377,400
18-06-2021,tiruppur,11046,481,2591,19,8917,77262,481,11,0,77754,68153,684
18-06-2021,trichy,3474,267,489,13,3239,66317,267,60,0,66644,62581,824
18-06-2021,vellore,301,96,119,15,263,44434,94,1578,2,46108,44890,955
18-06-2021,villupuram,2517,155,394,3,2275,41026,155,174,0,41355,38759,321
18-06-2021,virudhunagar,1535,134,231,1,1437,43280,134,104,0,43518,41575,506
18-06-2021,airport surveillance (international),3,0,0,0,3,0,0,1005,0,1005,1001,1
18-06-2021,airport surveillance (domestic),0,0,0,0,0,0,0,1075,0,1075,1074,1
18-06-2021,railway surveillance,0,0,0,0,0,0,0,428,0,428,428,0
19-06-2021,ariyalur,597,91,127,1,560,14016,91,20,0,14127,13384,183
19-06-2021,chengalpattu,1957,334,535,8,1748,153455,334,5,0,153794,149743,2303
19-06-2021,chennai,3338,468,1513,31,2262,528253,468,47,0,528768,518474,8032
19-06-2021,coimbatore,11645,1014,1451,17,11191,210523,1014,51,0,211588,198526,1871
19-06-2021,cuddalore,2289,211,482,7,2011,55925,211,203,0,56339,53614,714
19-06-2021,dharmapuri,1618,122,292,2,1446,22956,122,216,0,23294,21662,186
19-06-2021,dindigul,883,96,188,5,786,30813,96,77,0,30986,29639,561
19-06-2021,erode,9365,933,1363,7,8928,81767,933,94,0,82794,73335,531
19-06-2021,kallakurichi,1899,173,480,0,1592,25100,173,404,0,25677,23898,187
19-06-2021,kancheepuram,1021,128,327,5,817,69078,128,4,0,69210,67246,1147
19-06-2021,kanyakumari,3363,150,555,3,2955,57530,150,124,0,57804,53905,944
19-06-2021,karur,861,113,129,1,844,21123,113,47,0,21283,20108,331
19-06-2021,krishnagiri,1714,178,255,4,1633,37983,178,228,0,38389,36474,282
19-06-2021,madurai,1726,145,635,3,1233,70826,145,171,0,71142,68846,1063
19-06-2021,nagapattinam,2042,157,490,2,1707,36709,157,92,0,36958,34770,481
19-06-2021,namakkal,2544,328,421,1,2450,41650,328,107,0,42085,39266,369
19-06-2021,nilgiris,2437,140,419,1,2157,26799,140,44,0,26983,24683,143
19-06-2021,perambalur,457,59,113,2,401,10640,59,3,0,10702,10121,180
19-06-2021,pudukottai,933,80,134,1,878,25992,80,35,0,26107,24944,285
19-06-2021,ramanathapuram,669,63,76,3,653,19054,63,135,0,19252,18276,323
19-06-2021,ranipet,1288,158,250,2,1194,39635,158,49,0,39842,37994,654
19-06-2021,salem,5196,533,923,11,4795,82328,533,436,0,83297,77147,1355
19-06-2021,sivagangai,911,76,82,0,905,16659,76,107,0,16842,15752,185
19-06-2021,tenkasi,1027,71,161,5,932,26025,71,58,0,26154,24773,449
19-06-2021,thanjavur,3653,361,650,7,3357,60028,361,22,0,60411,56385,669
19-06-2021,theni,1403,123,223,1,1302,41441,123,45,0,41609,39834,473
19-06-2021,thirupathur,671,87,121,9,628,26837,87,118,0,27042,25887,527
19-06-2021,thiruvallur,1219,207,305,3,1118,109070,207,10,0,109287,106521,1648
19-06-2021,thiruvannamalai,1460,172,290,0,1342,46921,172,398,0,47491,45594,555
19-06-2021,thiruvarur,1392,127,281,10,1228,35796,127,38,0,35961,34429,304
19-06-2021,thoothukudi,2086,131,309,2,1906,53030,131,275,0,53436,51165,365
19-06-2021,tirunelveli,1216,66,249,4,1029,46566,66,427,0,47059,45626,404
19-06-2021,tiruppur,8917,489,2896,4,6506,77743,489,11,0,78243,71049,688
19-06-2021,trichy,3229,242,510,9,2952,66574,242,60,0,66876,63091,833
19-06-2021,vellore,265,90,125,5,225,44527,87,1580,3,46197,45015,957
19-06-2021,villupuram,2276,148,790,0,1634,41182,148,174,0,41504,39549,321
19-06-2021,virudhunagar,1439,119,82,4,1472,43416,119,104,0,43639,41657,510
19-06-2021,airport surveillance (international),3,0,0,0,3,0,0,1005,0,1005,1001,1
19-06-2021,airport surveillance (domestic),0,0,0,0,0,0,0,1075,0,1075,1074,1
19-06-2021,railway surveillance,0,0,0,0,0,0,0,428,0,428,428,0
20-06-2021,ariyalur,561,81,76,4,562,14108,81,20,0,14209,13460,187
20-06-2021,chengalpattu,1744,328,253,4,1815,153785,328,5,0,154118,149996,2307
20-06-2021,chennai,2250,455,1375,14,1316,528709,455,47,0,529211,519849,8046
20-06-2021,coimbatore,11192,904,1277,17,10802,211538,904,51,0,212493,199803,1888
20-06-2021,cuddalore,2014,197,299,5,1907,56139,197,203,0,56539,53913,719
20-06-2021,dharmapuri,1446,129,254,3,1318,23078,129,216,0,23423,21916,189
20-06-2021,dindigul,784,82,195,3,668,30907,82,77,0,31066,29834,564
20-06-2021,erode,8922,870,1451,15,8326,82694,870,94,0,83658,74786,546
20-06-2021,kallakurichi,1592,166,469,1,1288,25273,166,404,0,25843,24367,188
20-06-2021,kancheepuram,824,114,306,2,630,69213,114,4,0,69331,67552,1149
20-06-2021,kanyakumari,2955,140,471,5,2619,57680,140,124,0,57944,54376,949
20-06-2021,karur,845,103,161,0,787,21237,103,47,0,21387,20269,331
20-06-2021,krishnagiri,1633,170,222,2,1579,38161,170,228,0,38559,36696,284
20-06-2021,madurai,1239,151,562,5,823,70977,151,171,0,71299,69408,1068
20-06-2021,nagapattinam,1708,135,390,2,1451,36867,135,92,0,37094,35160,483
20-06-2021,namakkal,2452,327,397,10,2372,41980,327,107,0,42414,39663,379
20-06-2021,nilgiris,2157,175,415,3,1914,26939,175,44,0,27158,25098,146
20-06-2021,perambalur,401,52,96,1,356,10699,52,3,0,10754,10217,181
20-06-2021,pudukottai,879,84,187,2,774,26073,84,35,0,26192,25131,287
20-06-2021,ramanathapuram,653,57,82,2,626,19117,57,135,0,19309,18358,325
20-06-2021,ranipet,1194,145,237,3,1099,39793,145,49,0,39987,38231,657
20-06-2021,salem,4796,517,900,21,4392,82862,517,436,0,83815,78047,1376
20-06-2021,sivagangai,908,77,165,0,820,16738,77,107,0,16922,15917,185
20-06-2021,tenkasi,949,54,179,2,822,26116,54,58,0,26228,24952,454
20-06-2021,thanjavur,3353,370,634,8,3081,60385,370,22,0,60777,57019,677
20-06-2021,theni,1302,97,244,1,1154,41564,97,45,0,41706,40078,474
20-06-2021,thirupathur,626,74,79,2,619,26924,74,118,0,27116,25966,531
20-06-2021,thiruvallur,1118,204,268,5,1049,109277,204,10,0,109491,106789,1653
20-06-2021,thiruvannamalai,1345,206,101,5,1445,47096,206,398,0,47700,45695,560
20-06-2021,thiruvarur,1230,110,266,1,1073,35925,110,38,0,36073,34695,305
20-06-2021,thoothukudi,1915,119,342,1,1691,53170,119,275,0,53564,51507,366
20-06-2021,tirunelveli,993,51,233,2,809,46593,51,427,0,47071,45859,403
20-06-2021,tiruppur,6510,477,2518,8,4461,78236,477,11,0,78724,73567,696
20-06-2021,trichy,2952,263,916,13,2286,66816,263,60,0,67139,64007,846
20-06-2021,vellore,225,95,84,7,229,44612,92,1583,3,46290,45099,962
20-06-2021,villupuram,1636,126,373,2,1387,41332,126,174,0,41632,39922,323
20-06-2021,virudhunagar,1474,112,566,1,1019,43537,112,104,0,43753,42223,511
20-06-2021,airport surveillance (international),3,0,0,0,3,0,0,1005,0,1005,1001,1
20-06-2021,airport surveillance (domestic),0,0,0,0,0,0,0,1075,0,1075,1074,1
20-06-2021,railway surveillance,0,0,0,0,0,0,0,428,0,428,428,0
21-06-2021,ariyalur,563,83,55,3,588,14189,83,20,0,14292,13515,189
21-06-2021,chengalpattu,1814,310,206,9,1909,154113,310,5,0,154428,150202,2317
21-06-2021,chennai,1316,439,387,25,1343,529164,439,47,0,529650,520236,8071
21-06-2021,coimbatore,10802,891,2104,23,9566,212442,891,51,0,213384,201907,1911
21-06-2021,cuddalore,1907,189,258,7,1831,56336,189,203,0,56728,54171,726
21-06-2021,dharmapuri,1318,116,281,2,1151,23207,116,216,0,23539,22197,191
21-06-2021,dindigul,668,78,176,0,570,30989,78,77,0,31144,30010,564
21-06-2021,erode,8326,795,2042,9,7070,83564,795,94,0,84453,76828,555
21-06-2021,kallakurichi,1288,147,147,0,1288,25439,147,404,0,25990,24514,188
21-06-2021,kancheepuram,631,103,288,5,441,69327,103,4,0,69434,67840,1153
21-06-2021,kanyakumari,2619,133,877,2,1873,57820,133,124,0,58077,55253,951
21-06-2021,karur,787,101,116,1,771,21340,101,47,0,21488,20385,332
21-06-2021,krishnagiri,1579,167,258,3,1485,38331,167,228,0,38726,36954,287
21-06-2021,madurai,823,144,209,5,753,71128,144,171,0,71443,69617,1073
21-06-2021,nagapattinam,1451,120,324,4,1243,37002,120,92,0,37214,35484,487
21-06-2021,namakkal,2372,314,376,4,2306,42307,314,107,0,42728,40039,383
21-06-2021,nilgiris,1914,166,442,4,1634,27114,166,44,0,27324,25540,150
21-06-2021,perambalur,355,37,84,1,307,10751,37,3,0,10791,10301,183
21-06-2021,pudukottai,774,86,174,6,680,26157,86,35,0,26278,25305,293
21-06-2021,ramanathapuram,626,49,93,1,581,19174,49,135,0,19358,18451,326
21-06-2021,ranipet,1098,132,185,6,1039,39938,132,49,0,40119,38416,664
21-06-2021,salem,4392,511,858,9,4036,83379,511,436,0,84326,78905,1385
21-06-2021,sivagangai,820,74,171,0,723,16815,73,107,1,16996,16088,185
21-06-2021,tenkasi,822,51,148,0,725,26170,51,58,0,26279,25100,454
21-06-2021,thanjavur,3081,388,570,8,2891,60755,388,22,0,61165,57589,685
21-06-2021,theni,1154,77,198,1,1032,41661,77,45,0,41783,40276,475
21-06-2021,thirupathur,617,71,57,3,628,26998,71,118,0,27187,26023,536
21-06-2021,thiruvallur,1049,197,249,6,991,109481,197,10,0,109688,107038,1659
21-06-2021,thiruvannamalai,1445,194,96,5,1538,47302,194,398,0,47894,45791,565
21-06-2021,thiruvarur,1073,103,238,2,936,36035,103,38,0,36176,34933,307
21-06-2021,thoothukudi,1691,99,441,1,1348,53289,99,275,0,53663,51948,367
21-06-2021,tirunelveli,809,45,104,0,750,46644,45,427,0,47116,45963,403
21-06-2021,tiruppur,4461,458,1575,3,3341,78713,458,11,0,79182,75142,699
21-06-2021,trichy,2286,251,884,12,1641,67079,251,60,0,67390,64891,858
21-06-2021,vellore,232,87,40,16,263,44704,85,1586,2,46377,45139,975
21-06-2021,villupuram,1387,115,306,1,1195,41458,115,174,0,41747,40228,324
21-06-2021,virudhunagar,1019,106,264,2,859,43649,106,104,0,43859,42487,513
21-06-2021,airport surveillance (international),3,0,0,0,3,0,0,1005,0,1005,1001,1
21-06-2021,airport surveillance (domestic),0,0,0,0,0,0,0,1075,0,1075,1074,1
21-06-2021,railway surveillance,0,0,0,0,0,0,0,428,0,428,428,0
23-06-2021,ariyalur,545,67,43,2,567,14345,67,20,0,14432,13669,196
23-06-2021,chengalpattu,1949,277,196,5,2025,154712,277,5,0,154994,150643,2326
23-06-2021,chennai,3353,396,282,20,3447,529989,396,47,0,530432,518870,8115
23-06-2021,coimbatore,8374,793,1488,25,7654,214207,793,51,0,215051,205441,1956
23-06-2021,cuddalore,1739,168,245,8,1654,56707,168,203,0,57078,54685,739
23-06-2021,dharmapuri,1043,102,193,1,951,23425,102,216,0,23743,22598,194
23-06-2021,dindigul,484,63,125,2,420,31136,63,77,0,31276,30285,571
23-06-2021,erode,5944,686,1307,5,5318,85092,686,94,0,85872,79990,564
23-06-2021,kallakurichi,1302,122,98,0,1326,25722,122,404,0,26248,24732,190
23-06-2021,kancheepuram,412,92,112,2,390,69534,92,4,0,69630,68082,1158
23-06-2021,kanyakumari,1310,122,447,5,980,58061,122,124,0,58307,56369,958
23-06-2021,karur,777,87,65,1,798,21535,87,47,0,21669,20537,334
23-06-2021,krishnagiri,1358,152,230,2,1278,38656,152,228,0,39036,37468,290
23-06-2021,madurai,687,120,155,0,652,71393,120,171,0,71684,69957,1075
23-06-2021,nagapattinam,1050,119,217,8,944,37235,119,92,0,37446,36001,501
23-06-2021,namakkal,2255,269,278,4,2242,42889,269,107,0,43265,40630,393
23-06-2021,nilgiris,1391,125,338,3,1175,27419,125,44,0,27588,26259,154
23-06-2021,perambalur,267,44,52,1,258,10822,44,3,0,10869,10420,191
23-06-2021,pudukottai,640,81,98,6,617,26337,81,35,0,26453,25533,303
23-06-2021,ramanathapuram,523,42,87,3,475,19265,42,135,0,19442,18638,329
23-06-2021,ranipet,868,103,170,1,800,40192,103,49,0,40344,38873,671
23-06-2021,salem,3697,472,743,8,3418,84391,472,436,0,85299,80465,1416
23-06-2021,sivagangai,716,92,91,0,717,16976,92,108,0,17176,16274,185
23-06-2021,tenkasi,594,49,142,0,501,26263,49,58,0,26370,25415,454
23-06-2021,thanjavur,2692,338,496,3,2531,61499,338,22,0,61859,58636,692
23-06-2021,theni,947,75,128,0,894,41807,75,45,0,41927,40557,476
23-06-2021,thirupathur,609,55,63,6,595,27132,55,118,0,27305,26160,550
23-06-2021,thiruvallur,929,183,205,7,900,109863,183,10,0,110056,107482,1674
23-06-2021,thiruvannamalai,1440,173,215,4,1394,47680,173,398,0,48251,46280,577
23-06-2021,thiruvarur,840,77,139,3,775,36238,77,38,0,36353,35265,313
23-06-2021,thoothukudi,1157,85,267,0,975,53487,85,275,0,53847,52504,368
23-06-2021,tirunelveli,657,41,104,1,593,46725,41,427,0,47193,46194,406
23-06-2021,tiruppur,2847,419,857,8,2401,79609,419,11,0,80039,76918,720
23-06-2021,trichy,1383,247,391,5,1234,67548,247,60,0,67855,65753,868
23-06-2021,vellore,306,74,27,15,338,44860,74,1589,0,46523,45194,991
23-06-2021,villupuram,994,95,228,1,860,41677,95,174,0,41946,40760,326
23-06-2021,virudhunagar,804,91,110,1,784,43854,91,104,0,44049,42745,520
23-06-2021,airport surveillance (international),3,0,0,0,3,0,0,1005,0,1005,1001,1
23-06-2021,airport surveillance (domestic),0,0,0,0,0,0,0,1075,0,1075,1074,1
23-06-2021,railway surveillance,0,0,0,0,0,0,0,428,0,428,428,0
24-06-2021,ariyalur,567,63,36,1,593,14412,63,20,0,14495,13705,197
24-06-2021,chengalpattu,2095,262,193,6,2158,155058,262,5,0,155325,150836,2331
24-06-2021,chennai,3431,372,258,15,3530,530370,372,47,0,530789,519128,8131
24-06-2021,coimbatore,7655,756,1151,12,7248,215001,756,51,0,215808,206592,1968
24-06-2021,cuddalore,1657,151,230,3,1575,56878,151,203,0,57232,54915,742
24-06-2021,dharmapuri,955,107,185,3,874,23531,107,216,0,23854,22783,197
24-06-2021,dindigul,420,55,110,3,362,31199,55,77,0,31331,30395,574
24-06-2021,erode,5319,641,994,1,4965,85779,641,94,0,86514,80984,565
24-06-2021,kallakurichi,1323,119,143,1,1298,25841,119,404,0,26364,24875,191
24-06-2021,kancheepuram,388,86,74,7,393,69624,86,4,0,69714,68156,1165
24-06-2021,kanyakumari,978,115,423,4,666,58181,115,124,0,58420,56792,962
24-06-2021,karur,800,80,76,2,802,21624,80,47,0,21751,20613,336
24-06-2021,krishnagiri,1277,146,213,2,1208,38807,146,228,0,39181,37681,292
24-06-2021,madurai,649,112,128,2,631,71510,112,171,0,71793,70085,1077
24-06-2021,nagapattinam,944,108,206,2,844,37354,108,92,0,37554,36207,503
24-06-2021,namakkal,2231,257,289,6,2193,43147,257,107,0,43511,40919,399
24-06-2021,nilgiris,1175,138,345,1,967,27544,138,44,0,27726,26604,155
24-06-2021,perambalur,261,37,44,2,252,10869,37,3,0,10909,10464,193
24-06-2021,pudukottai,616,77,105,5,583,26417,77,35,0,26529,25638,308
24-06-2021,ramanathapuram,475,37,83,0,429,19307,37,135,0,19479,18721,329
24-06-2021,ranipet,801,96,138,15,744,40297,96,49,0,40442,39011,687
24-06-2021,salem,3425,419,710,7,3127,84870,419,436,0,85725,81175,1423
24-06-2021,sivagangai,719,84,95,2,706,17070,84,108,0,17262,16369,187
24-06-2021,tenkasi,500,31,126,4,401,26311,31,58,0,26400,25541,458
24-06-2021,thanjavur,2533,305,431,2,2405,61839,305,22,0,62166,59067,694
24-06-2021,theni,893,69,158,3,801,41881,69,45,0,41995,40715,479
24-06-2021,thirupathur,595,46,59,8,574,27187,46,118,0,27351,26219,558
24-06-2021,thiruvallur,897,169,192,8,866,110043,169,10,0,110222,107674,1682
24-06-2021,thiruvannamalai,1397,164,241,4,1316,47856,164,398,0,48418,46521,581
24-06-2021,thiruvarur,776,80,118,0,738,36316,80,38,0,36434,35383,313
24-06-2021,thoothukudi,978,73,284,3,764,53575,73,275,0,53923,52788,371
24-06-2021,tirunelveli,534,38,42,0,530,46707,38,427,0,47172,46236,406
24-06-2021,tiruppur,2402,386,538,3,2247,80029,386,11,0,80426,77456,723
24-06-2021,trichy,1226,235,305,8,1148,67787,235,60,0,68082,66058,876
24-06-2021,vellore,340,72,31,10,371,44935,69,1589,3,46596,45225,1000
24-06-2021,villupuram,863,94,204,0,753,41775,94,174,0,42043,40964,326
24-06-2021,virudhunagar,786,82,88,0,780,43947,82,104,0,44133,42833,520
24-06-2021,airport surveillance (international),3,0,0,0,3,0,0,1005,0,1005,1001,1
24-06-2021,airport surveillance (domestic),0,0,0,0,0,0,0,1075,0,1075,1074,1
24-06-2021,railway surveillance,0,0,0,0,0,0,0,428,0,428,428,0
25-06-2021,ariyalur,594,59,41,3,609,14476,59,20,0,14555,13746,200
25-06-2021,chengalpattu,2277,251,187,4,2337,155440,251,5,0,155696,151023,2336
25-06-2021,chennai,3517,350,245,11,3611,530730,350,47,0,531127,519373,8143
25-06-2021,coimbatore,7248,698,1199,26,6721,215757,698,51,0,216506,207791,1994
25-06-2021,cuddalore,1576,138,209,4,1501,57030,138,203,0,57371,55124,746
25-06-2021,dharmapuri,874,102,158,1,817,23638,102,216,0,23956,22941,198
25-06-2021,dindigul,363,48,82,0,329,31255,48,77,0,31380,30477,574
25-06-2021,erode,4964,597,865,1,4695,86419,597,94,0,87110,81849,566
25-06-2021,kallakurichi,1298,110,161,0,1247,25960,110,404,0,26474,25036,191
25-06-2021,kancheepuram,397,82,66,2,411,69713,82,4,0,69799,68222,1166
25-06-2021,kanyakumari,667,106,317,3,453,58297,106,124,0,58527,57109,965
25-06-2021,karur,802,69,71,0,800,21704,69,47,0,21820,20684,336
25-06-2021,krishnagiri,1208,139,198,2,1147,38953,139,228,0,39320,37879,294
25-06-2021,madurai,628,104,112,1,619,71619,104,171,0,71894,70197,1078
25-06-2021,nagapattinam,843,97,187,5,748,37462,97,92,0,37651,36394,509
25-06-2021,namakkal,2193,228,261,6,2154,43404,228,107,0,43739,41180,405
25-06-2021,nilgiris,967,132,317,0,782,27682,132,44,0,27858,26921,155
25-06-2021,perambalur,251,33,38,0,246,10906,33,3,0,10942,10502,194
25-06-2021,pudukottai,585,73,92,1,565,26496,73,35,0,26604,25730,309
25-06-2021,ramanathapuram,429,35,74,1,389,19344,35,135,0,19514,18795,330
25-06-2021,ranipet,742,92,115,4,715,40392,92,49,0,40533,39126,692
25-06-2021,salem,3124,398,657,9,2856,85286,398,436,0,86120,81832,1432
25-06-2021,sivagangai,706,88,81,1,712,17154,88,108,0,17350,16450,188
25-06-2021,tenkasi,344,45,39,0,350,26285,45,58,0,26388,25580,458
25-06-2021,thanjavur,2405,277,376,4,2302,62144,277,22,0,62443,59443,698
25-06-2021,theni,801,65,149,4,713,41950,65,45,0,42060,40864,483
25-06-2021,thirupathur,572,42,43,2,569,27232,42,118,0,27392,26262,561
25-06-2021,thiruvallur,875,144,156,7,856,110220,144,10,0,110374,107830,1688
25-06-2021,thiruvannamalai,1318,156,225,5,1244,48022,156,398,0,48576,46746,586
25-06-2021,thiruvarur,739,72,105,4,702,36396,72,38,0,36506,35488,316
25-06-2021,thoothukudi,770,70,249,2,589,53654,70,275,0,53999,53037,373
25-06-2021,tirunelveli,455,40,31,1,463,46670,40,427,0,47137,46267,407
25-06-2021,tiruppur,2249,361,462,13,2135,80417,361,11,0,80789,77918,736
25-06-2021,trichy,1149,220,258,7,1104,68022,220,60,0,68302,66316,882
25-06-2021,vellore,372,68,29,16,395,45003,64,1592,4,46663,45254,1014
25-06-2021,villupuram,756,87,198,0,645,41872,87,174,0,42133,41162,326
25-06-2021,virudhunagar,784,79,79,0,784,44033,79,104,0,44216,42912,520
25-06-2021,airport surveillance (international),3,0,0,0,3,0,0,1005,0,1005,1001,1
25-06-2021,airport surveillance (domestic),0,0,0,0,0,0,0,1075,0,1075,1074,1
25-06-2021,railway surveillance,0,0,0,0,0,0,0,428,0,428,428,0
26-06-2021,ariyalur,610,57,61,1,605,14536,57,20,0,14613,13807,201
26-06-2021,chengalpattu,2338,254,246,5,2341,155692,254,5,0,155951,151269,2341
26-06-2021,chennai,3613,314,328,9,3590,531082,314,47,0,531443,519701,8152
26-06-2021,coimbatore,6723,671,1263,9,6122,216457,671,51,0,217179,209054,2003
26-06-2021,cuddalore,1502,127,288,2,1339,57169,127,203,0,57499,55412,748
26-06-2021,dharmapuri,815,112,143,2,782,23738,112,216,0,24066,23084,200
26-06-2021,dindigul,328,50,56,7,315,31302,50,77,0,31429,30533,581
26-06-2021,erode,4696,574,748,13,4509,87017,574,94,0,87685,82597,579
26-06-2021,kallakurichi,1245,140,189,0,1196,26068,140,404,0,26612,25225,191
26-06-2021,kancheepuram,458,78,52,1,483,69842,78,4,0,69924,68274,1167
26-06-2021,kanyakumari,453,93,93,4,449,58403,93,124,0,58620,57202,969
26-06-2021,karur,801,52,83,0,770,21774,52,47,0,21873,20767,336
26-06-2021,krishnagiri,1148,122,156,2,1112,39092,122,228,0,39442,38035,295
26-06-2021,madurai,617,92,87,3,619,71721,92,171,0,71984,70284,1081
26-06-2021,nagapattinam,748,78,143,1,682,37560,78,92,0,37730,36537,511
26-06-2021,namakkal,2153,214,309,6,2052,43631,214,107,0,43952,41489,411
26-06-2021,nilgiris,782,128,168,3,739,27814,128,44,0,27986,27089,158
26-06-2021,perambalur,246,31,21,0,256,10939,31,3,0,10973,10523,194
26-06-2021,pudukottai,567,72,79,6,554,26571,72,35,0,26678,25809,315
26-06-2021,ramanathapuram,389,31,82,0,338,19379,31,135,0,19545,18877,330
26-06-2021,ranipet,715,88,104,6,693,40486,88,49,0,40623,39230,700
26-06-2021,salem,2860,369,620,11,2598,85688,369,436,0,86493,82452,1443
26-06-2021,sivagangai,713,79,113,0,679,17243,79,108,0,17430,16563,188
26-06-2021,tenkasi,296,40,24,2,310,26276,40,58,0,26374,25604,460
26-06-2021,thanjavur,2304,260,356,4,2204,62422,260,22,0,62704,59799,701
26-06-2021,theni,713,56,133,3,633,42015,56,45,0,42116,40997,486
26-06-2021,thirupathur,569,38,62,5,540,27275,38,118,0,27431,26324,567
26-06-2021,thiruvallur,909,134,152,7,884,110417,134,10,0,110561,107982,1695
26-06-2021,thiruvannamalai,1244,151,236,3,1156,48178,151,398,0,48727,46982,589
26-06-2021,thiruvarur,701,68,81,0,688,36467,68,38,0,36573,35569,316
26-06-2021,thoothukudi,589,58,208,0,439,53725,58,275,0,54058,53245,374
26-06-2021,tirunelveli,413,47,42,2,416,46659,47,427,0,47133,46309,408
26-06-2021,tiruppur,2134,337,448,2,2021,80777,337,11,0,81125,78366,738
26-06-2021,trichy,1099,198,238,7,1052,68237,198,60,0,68495,66554,889
26-06-2021,vellore,395,60,23,19,413,45065,58,1596,2,46721,45277,1031
26-06-2021,villupuram,645,75,132,2,586,41959,75,174,0,42208,41294,328
26-06-2021,virudhunagar,784,67,93,1,757,44112,67,104,0,44283,43005,521
26-06-2021,airport surveillance (international),3,0,1,0,2,0,0,1005,0,1005,1002,1
26-06-2021,airport surveillance (domestic),0,0,0,0,0,0,0,1075,0,1075,1074,1
26-06-2021,railway surveillance,0,0,0,0,0,0,0,428,0,428,428,0
28-06-2021,ariyalur,607,68,82,1,592,14659,68,20,0,14747,13950,205
28-06-2021,chengalpattu,2360,238,281,4,2313,156204,238,5,0,156447,151788,2346
28-06-2021,chennai,3538,291,363,4,3462,531668,291,47,0,532006,520379,8165
28-06-2021,coimbatore,5609,597,1089,7,5110,217778,597,51,0,218426,211299,2017
28-06-2021,cuddalore,1214,104,209,6,1103,57419,104,203,0,57726,55866,757
28-06-2021,dharmapuri,755,110,93,1,771,23955,110,216,0,24281,23306,204
28-06-2021,dindigul,311,43,46,0,308,31404,43,77,0,31524,30633,583
28-06-2021,erode,4322,506,603,2,4223,88123,506,94,0,88723,83915,585
28-06-2021,kallakurichi,1136,116,227,0,1025,26331,116,404,0,26851,25634,192
28-06-2021,kancheepuram,512,85,31,3,563,69998,85,4,0,70087,68353,1171
28-06-2021,kanyakumari,445,89,69,5,460,58581,89,124,0,58794,57357,977
28-06-2021,karur,739,41,104,3,673,21873,41,47,0,21961,20946,342
28-06-2021,krishnagiri,1084,107,126,3,1062,39333,107,228,0,39668,38306,300
28-06-2021,madurai,622,78,61,9,630,71895,78,171,0,72144,70421,1093
28-06-2021,nagapattinam,632,64,94,2,600,37710,64,92,0,37866,36753,513
28-06-2021,namakkal,1915,184,293,1,1805,44036,184,107,0,44327,42108,414
28-06-2021,nilgiris,700,87,118,4,665,28060,87,44,0,28191,27362,164
28-06-2021,perambalur,259,18,14,0,263,10993,18,3,0,11014,10556,195
28-06-2021,pudukottai,553,74,62,1,564,26717,74,35,0,26826,25945,317
28-06-2021,ramanathapuram,297,19,46,0,270,19434,19,135,0,19588,18988,330
28-06-2021,ranipet,675,76,86,6,659,40655,76,49,0,40780,39411,710
28-06-2021,salem,2461,318,543,6,2230,86507,318,436,0,87261,83577,1454
28-06-2021,sivagangai,646,65,82,1,628,17393,65,108,0,17566,16749,189
28-06-2021,tenkasi,229,40,17,0,252,26265,40,58,0,26363,25647,464
28-06-2021,thanjavur,2114,231,296,4,2045,62913,231,22,0,63166,60416,705
28-06-2021,theni,563,53,102,0,514,42129,53,45,0,42227,41225,488
28-06-2021,thirupathur,519,31,73,2,475,27349,31,118,0,27498,26452,571
28-06-2021,thiruvallur,866,118,124,6,854,110681,118,10,0,110809,108253,1702
28-06-2021,thiruvannamalai,1082,137,183,1,1035,48478,137,398,0,49013,47386,592
28-06-2021,thiruvarur,676,56,84,3,645,36600,56,38,0,36694,35726,323
28-06-2021,thoothukudi,317,63,67,1,312,53856,63,275,0,54194,53507,375
28-06-2021,tirunelveli,327,41,21,1,346,46655,41,427,0,47123,46368,409
28-06-2021,tiruppur,1996,294,448,3,1839,81516,294,11,0,81821,79235,747
28-06-2021,trichy,1008,185,179,4,1010,68626,185,60,0,68871,66961,900
28-06-2021,vellore,444,51,19,2,474,45177,51,1598,0,46826,45317,1035
28-06-2021,villupuram,525,67,112,0,480,42105,67,174,0,42346,41537,329
28-06-2021,virudhunagar,741,59,106,2,692,44252,59,104,0,44415,43200,523
28-06-2021,airport surveillance (international),2,0,0,0,2,0,0,1005,0,1005,1002,1
28-06-2021,airport surveillance (domestic),0,0,0,0,0,0,0,1075,0,1075,1074,1
28-06-2021,railway surveillance,0,0,0,0,0,0,0,428,0,428,428,0
29-06-2021,ariyalur,592,59,93,1,557,14727,59,20,0,14806,14043,206
29-06-2021,chengalpattu,2314,229,346,6,2191,156443,229,5,0,156677,152134,2352
29-06-2021,chennai,3453,275,414,7,3307,531950,275,47,0,532272,520793,8172
29-06-2021,coimbatore,5111,563,986,12,4676,218376,563,51,0,218990,212285,2029
29-06-2021,cuddalore,1104,115,176,1,1042,57524,115,203,0,57842,56042,758
29-06-2021,dharmapuri,773,105,84,1,793,24067,105,216,0,24388,23390,205
29-06-2021,dindigul,308,37,33,5,307,31447,37,77,0,31561,30666,588
29-06-2021,erode,4219,493,546,3,4163,88625,493,94,0,89212,84461,588
29-06-2021,kallakurichi,1024,99,137,2,984,26446,99,404,0,26949,25771,194
29-06-2021,kancheepuram,564,76,41,2,597,70084,76,4,0,70164,68394,1173
29-06-2021,kanyakumari,460,92,62,5,485,58670,92,124,0,58886,57419,982
29-06-2021,karur,674,35,116,0,593,21915,35,47,0,21997,21062,342
29-06-2021,krishnagiri,1057,98,108,2,1045,39435,98,228,0,39761,38414,302
29-06-2021,madurai,627,70,58,12,627,71970,70,171,0,72211,70479,1105
29-06-2021,mayiladuthurai,311,37,47,0,301,20057,37,39,0,20133,19582,250
29-06-2021,nagapattinam,292,32,34,3,287,17720,32,53,0,17805,17252,266
29-06-2021,namakkal,1804,173,246,4,1727,44219,173,107,0,44499,42354,418
29-06-2021,nilgiris,665,75,86,0,654,28147,75,44,0,28266,27448,164
29-06-2021,perambalur,263,20,17,2,264,11011,20,3,0,11034,10573,197
29-06-2021,pudukottai,567,71,58,4,576,26794,71,35,0,26900,26003,321
29-06-2021,ramanathapuram,272,15,29,0,258,19455,15,135,0,19605,19017,330
29-06-2021,ranipet,655,72,73,7,647,40727,72,49,0,40848,39484,717
29-06-2021,salem,2236,302,508,9,2021,86831,302,436,0,87569,84085,1463
29-06-2021,sivagangai,625,61,67,0,619,17455,61,108,0,17624,16816,189
29-06-2021,tenkasi,254,34,19,0,269,26307,34,58,0,26399,25666,464
29-06-2021,thanjavur,2042,215,265,0,1992,63141,215,22,0,63378,60681,705
29-06-2021,theni,514,47,84,3,474,42182,47,45,0,42274,41309,491
29-06-2021,thirupathur,477,27,94,0,410,27382,27,118,0,27527,26546,571
29-06-2021,thiruvallur,861,104,111,1,853,110806,104,10,0,110920,108364,1703
29-06-2021,thiruvannamalai,1037,125,157,4,1001,48617,125,398,0,49140,47543,596
29-06-2021,thiruvarur,645,49,79,2,613,36656,49,38,0,36743,35805,325
29-06-2021,thoothukudi,315,59,53,2,319,53922,59,275,0,54256,53560,377
29-06-2021,tirunelveli,339,49,28,1,359,46689,49,427,0,47165,46396,410
29-06-2021,tiruppur,1840,281,396,3,1722,81811,281,11,0,82103,79631,750
29-06-2021,trichy,1008,170,143,2,1033,68809,170,60,0,69039,67104,902
29-06-2021,vellore,476,48,26,7,491,45230,46,1598,2,46876,45343,1042
29-06-2021,villupuram,481,52,72,1,460,42173,52,174,0,42399,41609,330
29-06-2021,virudhunagar,693,48,121,4,616,44312,48,104,0,44464,43321,527
29-06-2021,airport surveillance (international),2,0,0,0,2,0,0,1005,0,1005,1002,1
29-06-2021,airport surveillance (domestic),0,0,0,0,0,0,0,1075,0,1075,1074,1
29-06-2021,railway surveillance,0,0,0,0,0,0,0,428,0,428,428,0
30-06-2021,ariyalur,557,55,87,5,520,14786,55,20,0,14861,14130,211
30-06-2021,chengalpattu,2191,207,351,6,2041,156672,207,5,0,156884,152485,2358
30-06-2021,chennai,3307,257,428,15,3121,532225,257,47,0,532529,521221,8187
30-06-2021,coimbatore,4676,514,942,12,4236,218939,514,51,0,219504,213227,2041
30-06-2021,cuddalore,1042,102,158,4,982,57639,102,203,0,57944,56200,762
30-06-2021,dharmapuri,793,114,76,3,828,24172,114,216,0,24502,23466,208
30-06-2021,dindigul,307,54,27,4,330,31484,54,77,0,31615,30693,592
30-06-2021,erode,4163,420,489,1,4093,89118,420,94,0,89632,84950,589
30-06-2021,kallakurichi,984,115,121,0,978,26545,115,404,0,27064,25892,194
30-06-2021,kancheepuram,597,68,34,3,628,70160,68,4,0,70232,68428,1176
30-06-2021,kanyakumari,485,83,48,5,515,58762,83,124,0,58969,57467,987
30-06-2021,karur,593,32,123,0,502,21950,32,47,0,22029,21185,342
30-06-2021,krishnagiri,1045,109,118,1,1035,39533,109,228,0,39870,38532,303
30-06-2021,madurai,627,68,56,3,636,72040,68,171,0,72279,70535,1108
30-06-2021,mayiladuthurai,301,44,53,2,290,20094,44,39,0,20177,19635,252
30-06-2021,nagapattinam,287,45,21,0,311,17752,45,53,0,17850,17273,266
30-06-2021,namakkal,1727,158,198,0,1687,44392,158,107,0,44657,42552,418
30-06-2021,nilgiris,654,87,66,0,675,28222,87,44,0,28353,27514,164
30-06-2021,perambalur,264,22,21,1,264,11031,22,3,0,11056,10594,198
30-06-2021,pudukottai,576,66,52,0,590,26865,66,35,0,26966,26055,321
30-06-2021,ramanathapuram,258,14,32,3,237,19470,14,135,0,19619,19049,333
30-06-2021,ranipet,647,64,53,3,655,40799,64,49,0,40912,39537,720
30-06-2021,salem,2021,295,466,9,1841,87133,295,436,0,87864,84551,1472
30-06-2021,sivagangai,619,65,62,0,622,17516,65,108,0,17689,16878,189
30-06-2021,tenkasi,269,28,15,0,282,26341,28,58,0,26427,25681,464
30-06-2021,thanjavur,1992,197,225,3,1961,63356,197,22,0,63575,60906,708
30-06-2021,theni,474,45,76,2,441,42229,45,45,0,42319,41385,493
30-06-2021,thirupathur,410,31,98,1,342,27409,31,118,0,27558,26644,572
30-06-2021,thiruvallur,853,105,105,2,851,110910,105,10,0,111025,108469,1705
30-06-2021,thiruvannamalai,1001,199,146,1,1053,48742,199,398,0,49339,47689,597
30-06-2021,thiruvarur,613,71,85,2,597,36705,71,38,0,36814,35890,327
30-06-2021,thoothukudi,319,75,38,1,355,53981,75,275,0,54331,53598,378
30-06-2021,tirunelveli,359,42,31,0,370,46738,42,427,0,47207,46427,410
30-06-2021,tiruppur,1722,270,321,7,1664,82092,270,11,0,82373,79952,757
30-06-2021,trichy,1033,205,121,8,1109,68979,205,60,0,69244,67225,910
30-06-2021,vellore,491,43,22,5,507,45276,43,1600,0,46919,45365,1047
30-06-2021,villupuram,460,65,64,0,461,42225,65,174,0,42464,41673,330
30-06-2021,virudhunagar,616,72,108,1,579,44360,72,104,0,44536,43429,528
30-06-2021,airport surveillance (international),2,0,0,0,2,0,0,1005,0,1005,1002,1
30-06-2021,airport surveillance (domestic),0,0,0,0,0,0,0,1075,0,1075,1074,1
30-06-2021,railway surveillance,0,0,0,0,0,0,0,428,0,428,428,0
01-07-2021,ariyalur,517,48,91,2,472,14838,48,20,0,14906,14221,213
01-07-2021,chengalpattu,2044,198,342,3,1897,156882,198,5,0,157085,152827,2361
01-07-2021,chennai,3102,249,416,4,2931,532463,249,47,0,532759,521637,8191
01-07-2021,coimbatore,4239,498,922,10,3805,219456,498,51,0,220005,214149,2051
01-07-2021,cuddalore,982,127,144,1,964,57741,127,203,0,58071,56344,763
01-07-2021,dharmapuri,822,109,71,0,860,24280,109,216,0,24605,23537,208
01-07-2021,dindigul,327,46,22,0,351,31535,46,77,0,31658,30715,592
01-07-2021,erode,3984,411,310,5,4080,89429,411,94,0,89934,85260,594
01-07-2021,kallakurichi,979,128,113,0,994,26661,128,404,0,27193,26005,194
01-07-2021,kancheepuram,667,71,32,2,704,70267,71,4,0,70342,68460,1178
01-07-2021,kanyakumari,515,78,40,1,552,58845,78,124,0,59047,57507,988
01-07-2021,karur,504,46,115,0,435,21984,46,47,0,22077,21300,342
01-07-2021,krishnagiri,1048,103,109,3,1039,39655,103,228,0,39986,38641,306
01-07-2021,madurai,640,94,48,1,685,72112,94,171,0,72377,70583,1109
01-07-2021,mayiladuthurai,260,30,15,0,275,20108,30,39,0,20177,19650,252
01-07-2021,nagapattinam,245,36,18,2,261,17731,36,53,0,17820,17291,268
01-07-2021,namakkal,1696,144,184,0,1656,44559,144,107,0,44810,42736,418
01-07-2021,nilgiris,675,90,55,0,710,28309,90,44,0,28443,27569,164
01-07-2021,perambalur,268,29,18,3,276,11057,29,3,0,11089,10612,201
01-07-2021,pudukottai,593,73,44,1,621,26934,73,35,0,27042,26099,322
01-07-2021,ramanathapuram,239,19,24,1,233,19486,19,135,0,19640,19073,334
01-07-2021,ranipet,654,59,41,3,669,40862,59,49,0,40970,39578,723
01-07-2021,salem,1903,279,492,5,1685,87490,279,436,0,88205,85043,1477
01-07-2021,sivagangai,618,66,56,2,626,17577,66,108,0,17751,16934,191
01-07-2021,tenkasi,248,29,10,1,266,26335,29,58,0,26422,25691,465
01-07-2021,thanjavur,1950,248,185,23,1990,63542,248,22,0,63812,61091,731
01-07-2021,theni,441,48,65,0,424,42274,48,45,0,42367,41450,493
01-07-2021,thirupathur,339,32,84,2,285,27437,32,118,0,27587,26728,574
01-07-2021,thiruvallur,859,102,87,3,871,111023,102,10,0,111135,108556,1708
01-07-2021,thiruvannamalai,1053,185,122,2,1114,48941,185,398,0,49524,47811,599
01-07-2021,thiruvarur,605,67,71,5,596,36784,67,38,0,36889,35961,332
01-07-2021,thoothukudi,356,69,23,0,402,54057,69,275,0,54401,53621,378
01-07-2021,tirunelveli,369,38,29,0,378,46779,38,427,0,47244,46456,410
01-07-2021,tiruppur,1758,256,342,6,1666,82456,256,11,0,82723,80294,763
01-07-2021,trichy,1140,198,137,4,1197,69215,198,60,0,69473,67362,914
01-07-2021,vellore,509,40,16,7,526,45321,39,1600,1,46961,45381,1054
01-07-2021,villupuram,462,70,55,0,477,42291,70,174,0,42535,41728,330
01-07-2021,virudhunagar,579,68,96,0,551,44432,68,104,0,44604,43525,528
01-07-2021,airport surveillance (international),2,0,0,0,2,0,0,1005,0,1005,1002,1
01-07-2021,airport surveillance (domestic),0,0,0,0,0,0,0,1075,0,1075,1074,1
01-07-2021,railway surveillance,0,0,0,0,0,0,0,428,0,428,428,0
02-07-2021,ariyalur,478,53,68,3,460,14892,53,20,0,14965,14289,216
02-07-2021,chengalpattu,1899,193,318,4,1770,157082,193,5,0,157280,153145,2365
02-07-2021,chennai,2926,238,446,5,2713,532707,238,47,0,532992,522083,8196
02-07-2021,coimbatore,3807,486,904,7,3382,219956,486,51,0,220493,215053,2058
02-07-2021,cuddalore,966,103,128,4,937,57870,103,203,0,58176,56472,767
02-07-2021,dharmapuri,861,97,68,0,890,24390,97,216,0,24703,23605,208
02-07-2021,dindigul,351,39,21,1,368,31581,39,77,0,31697,30736,593
02-07-2021,erode,3934,395,203,3,4123,89694,395,94,0,90183,85463,597
02-07-2021,kallakurichi,991,102,96,0,997,26786,102,404,0,27292,26101,194
02-07-2021,kancheepuram,705,67,57,2,713,70339,67,4,0,70410,68517,1180
02-07-2021,kanyakumari,543,75,38,0,580,58914,75,124,0,59113,57545,988
02-07-2021,karur,435,51,97,0,389,22030,51,47,0,22128,21397,342
02-07-2021,krishnagiri,1040,95,144,1,990,39759,94,228,1,40082,38785,307
02-07-2021,madurai,683,85,37,4,727,72204,85,171,0,72460,70620,1113
02-07-2021,mayiladuthurai,275,36,44,0,267,20138,36,39,0,20213,19694,252
02-07-2021,nagapattinam,261,32,12,2,279,17767,32,53,0,17852,17303,270
02-07-2021,namakkal,1657,132,210,0,1579,44704,127,107,5,44943,42946,418
02-07-2021,nilgiris,711,83,42,0,752,28400,83,44,0,28527,27611,164
02-07-2021,perambalur,276,27,19,1,283,11086,27,3,0,11116,10631,202
02-07-2021,pudukottai,631,71,59,7,636,27017,71,35,0,27123,26158,329
02-07-2021,ramanathapuram,238,20,31,1,226,19510,20,135,0,19665,19104,335
02-07-2021,ranipet,672,56,62,0,666,40926,56,49,0,41031,39640,725
02-07-2021,salem,1773,268,458,0,1583,87857,268,436,0,88561,85501,1477
02-07-2021,sivagangai,627,61,74,1,613,17644,61,108,0,17813,17008,192
02-07-2021,tenkasi,256,26,11,1,270,26354,26,58,0,26438,25702,466
02-07-2021,thanjavur,1964,239,198,30,1975,63764,239,22,0,64025,61289,761
02-07-2021,theni,424,52,56,0,420,42322,52,45,0,42419,41506,493
02-07-2021,thirupathur,284,29,57,2,254,27468,29,118,0,27615,26785,576
02-07-2021,thiruvallur,868,104,78,2,892,111122,104,10,0,111236,108634,1710
02-07-2021,thiruvannamalai,1115,174,128,3,1158,49127,174,398,0,49699,47939,602
02-07-2021,thiruvarur,595,60,94,3,558,36850,60,38,0,36948,36055,335
02-07-2021,thoothukudi,401,57,24,0,434,54125,57,275,0,54457,53645,378
02-07-2021,tirunelveli,371,30,54,2,345,46810,30,427,0,47267,46510,412
02-07-2021,tiruppur,1746,243,338,3,1648,82792,243,11,0,83046,80632,766
02-07-2021,trichy,1200,185,116,0,1269,69416,185,60,0,69661,67478,914
02-07-2021,vellore,527,38,35,3,527,45359,35,1601,3,46998,45416,1055
02-07-2021,villupuram,479,66,51,2,492,42363,66,174,0,42603,41779,332
02-07-2021,virudhunagar,554,62,76,0,540,44503,62,104,0,44669,43601,528
02-07-2021,airport surveillance (international),2,0,0,0,2,0,0,1005,0,1005,1002,1
02-07-2021,airport surveillance (domestic),0,0,0,0,0,0,0,1075,0,1075,1074,1
02-07-2021,railway surveillance,0,0,0,0,0,0,0,428,0,428,428,0
03-07-2021,ariyalur,463,51,57,0,457,14948,51,20,0,15019,14346,216
03-07-2021,chengalpattu,1770,188,286,1,1671,157275,188,5,0,157468,153431,2366
03-07-2021,chennai,2717,227,478,20,2446,532950,227,47,0,533224,522561,8217
03-07-2021,coimbatore,3384,474,857,5,2996,220444,474,51,0,220969,215910,2063
03-07-2021,cuddalore,938,98,98,0,938,57974,98,203,0,58275,56570,767
03-07-2021,dharmapuri,891,92,82,0,901,24488,92,216,0,24796,23687,208
03-07-2021,dindigul,354,31,12,6,367,31606,31,77,0,31714,30748,599
03-07-2021,erode,4049,360,143,6,4260,90015,360,94,0,90469,85606,603
03-07-2021,kallakurichi,997,91,94,0,994,26888,91,404,0,27383,26195,194
03-07-2021,kancheepuram,713,62,89,1,685,70406,62,4,0,70472,68606,1181
03-07-2021,kanyakumari,570,69,19,5,615,58979,69,124,0,59172,57564,993
03-07-2021,karur,392,44,78,2,356,22084,44,47,0,22175,21475,344
03-07-2021,krishnagiri,993,89,158,1,923,39856,89,229,0,40174,38943,308
03-07-2021,madurai,726,78,64,6,734,72288,78,171,0,72537,70684,1119
03-07-2021,mayiladuthurai,267,37,32,1,271,20174,37,39,0,20250,19726,253
03-07-2021,nagapattinam,279,42,38,2,281,17799,42,53,0,17894,17341,272
03-07-2021,namakkal,1586,118,228,2,1474,44838,118,112,0,45068,43174,420
03-07-2021,nilgiris,752,77,34,0,795,28483,77,44,0,28604,27645,164
03-07-2021,perambalur,283,24,39,0,268,11113,24,3,0,11140,10670,202
03-07-2021,pudukottai,635,66,81,0,620,27087,66,35,0,27188,26239,329
03-07-2021,ramanathapuram,226,25,43,1,207,19530,25,135,0,19690,19147,336
03-07-2021,ranipet,664,50,87,0,627,40980,50,49,0,41079,39727,725
03-07-2021,salem,1654,251,412,3,1490,88196,251,436,0,88883,85913,1480
03-07-2021,sivagangai,613,57,89,0,581,17705,57,108,0,17870,17097,192
03-07-2021,tenkasi,277,29,13,2,291,26387,29,58,0,26474,25715,468
03-07-2021,thanjavur,1971,232,189,26,1988,63999,232,22,0,64253,61478,787
03-07-2021,theni,421,49,33,1,436,42375,49,45,0,42469,41539,494
03-07-2021,thirupathur,250,27,42,2,233,27493,27,118,0,27638,26827,578
03-07-2021,thiruvallur,890,102,67,3,922,111224,102,10,0,111336,108701,1713
03-07-2021,thiruvannamalai,1159,161,109,2,1209,49302,161,398,0,49861,48048,604
03-07-2021,thiruvarur,545,55,69,3,528,36897,55,38,0,36990,36124,338
03-07-2021,thoothukudi,394,51,13,1,431,54142,51,275,0,54468,53658,379
03-07-2021,tirunelveli,329,32,29,0,332,46824,32,427,0,47283,46539,412
03-07-2021,tiruppur,1725,231,308,3,1645,83112,231,11,0,83354,80940,769
03-07-2021,trichy,1268,170,97,4,1337,69600,170,60,0,69830,67575,918
03-07-2021,vellore,528,45,54,2,517,45394,44,1604,1,47043,45470,1056
03-07-2021,villupuram,492,69,42,0,519,42429,69,174,0,42672,41821,332
03-07-2021,virudhunagar,540,58,61,4,533,44565,58,104,0,44727,43662,532
03-07-2021,airport surveillance (international),2,1,0,0,3,0,0,1005,1,1006,1002,1
03-07-2021,airport surveillance (domestic),0,0,0,0,0,0,0,1075,0,1075,1074,1
03-07-2021,railway surveillance,0,0,0,0,0,0,0,428,0,428,428,0
04-07-2021,ariyalur,456,52,52,0,456,14998,52,20,0,15070,14398,216
04-07-2021,chengalpattu,1674,184,198,0,1660,157466,184,5,0,157655,153629,2366
04-07-2021,chennai,2432,222,481,5,2168,533163,222,47,0,533432,523042,8222
04-07-2021,coimbatore,2997,445,585,6,2851,220919,445,51,0,221415,216495,2069
04-07-2021,cuddalore,939,96,94,3,938,58073,96,203,0,58372,56664,770
04-07-2021,dharmapuri,902,89,95,1,895,24581,89,216,0,24886,23782,209
04-07-2021,dindigul,369,35,19,3,382,31639,35,77,0,31751,30767,602
04-07-2021,erode,4257,349,375,4,4227,90372,349,94,0,90815,85981,607
04-07-2021,kallakurichi,995,95,91,1,998,26980,95,404,0,27479,26286,195
04-07-2021,kancheepuram,686,58,94,3,647,70469,58,4,0,70531,68700,1184
04-07-2021,kanyakumari,615,78,21,2,670,59048,78,124,0,59250,57585,995
04-07-2021,karur,356,41,79,0,318,22128,41,47,0,22216,21554,344
04-07-2021,krishnagiri,922,87,165,0,844,39944,87,229,0,40260,39108,308
04-07-2021,madurai,732,75,81,1,725,72364,75,171,0,72610,70765,1120
04-07-2021,mayiladuthurai,270,34,35,1,268,20211,34,39,0,20284,19761,255
04-07-2021,nagapattinam,282,39,29,2,290,17841,39,53,0,17933,17370,273
04-07-2021,namakkal,1479,114,249,3,1341,44961,114,112,0,45187,43423,423
04-07-2021,nilgiris,795,74,42,0,827,28560,74,44,0,28678,27687,164
04-07-2021,perambalur,270,22,35,0,257,11139,22,3,0,11164,10705,202
04-07-2021,pudukottai,621,61,75,4,603,27154,61,35,0,27250,26314,333
04-07-2021,ramanathapuram,209,24,35,0,198,19557,24,135,0,19716,19182,336
04-07-2021,ranipet,629,49,82,0,596,41032,49,49,0,41130,39809,725
04-07-2021,salem,1483,245,112,7,1609,88440,245,436,0,89121,86025,1487
04-07-2021,sivagangai,581,55,86,1,549,17762,55,108,0,17925,17183,193
04-07-2021,tenkasi,291,26,15,0,302,26416,26,58,0,26500,25730,468
04-07-2021,thanjavur,1979,227,220,8,1978,64222,227,22,0,64471,61698,795
04-07-2021,theni,436,45,34,0,447,42424,45,45,0,42514,41573,494
04-07-2021,thirupathur,233,25,34,1,223,27520,25,118,0,27663,26861,579
04-07-2021,thiruvallur,928,99,78,1,948,111332,99,10,0,111441,108779,1714
04-07-2021,thiruvannamalai,1211,127,131,0,1207,49465,127,398,0,49990,48179,604
04-07-2021,thiruvarur,535,52,65,1,521,36959,52,38,0,37049,36189,339
04-07-2021,thoothukudi,431,46,15,0,462,54193,46,275,0,54514,53673,379
04-07-2021,tirunelveli,333,34,31,0,336,46857,34,427,0,47318,46570,412
04-07-2021,tiruppur,1645,225,274,4,1592,83343,225,11,0,83579,81214,773
04-07-2021,trichy,1339,166,110,6,1389,69772,166,60,0,69998,67685,924
04-07-2021,vellore,514,52,56,4,506,45435,50,1605,2,47092,45526,1060
04-07-2021,villupuram,519,66,45,0,540,42498,66,174,0,42738,41866,332
04-07-2021,virudhunagar,533,54,64,0,523,44623,54,104,0,44781,43726,532
04-07-2021,airport surveillance (international),3,0,0,0,3,0,0,1006,0,1006,1002,1
04-07-2021,airport surveillance (domestic),0,0,0,0,0,0,0,1075,0,1075,1074,1
04-07-2021,railway surveillance,0,0,0,0,0,0,0,428,0,428,428,0
05-07-2021,ariyalur,459,46,41,0,464,15053,46,20,0,15119,14439,216
05-07-2021,chengalpattu,1663,188,173,1,1677,157654,188,5,0,157847,153802,2368
05-07-2021,chennai,2159,214,431,5,1937,533376,214,47,0,533637,523473,8227
05-07-2021,coimbatore,3020,436,457,7,2992,221533,436,51,0,222020,216952,2076
05-07-2021,cuddalore,906,94,65,1,934,58137,94,203,0,58434,56729,771
05-07-2021,dharmapuri,896,85,109,3,869,24671,85,216,0,24972,23891,212
05-07-2021,dindigul,367,31,11,1,386,31659,31,77,0,31767,30778,603
05-07-2021,erode,4040,330,287,3,4080,90533,330,94,0,90957,86268,609
05-07-2021,kallakurichi,997,87,117,1,966,27074,87,404,0,27565,26403,196
05-07-2021,kancheepuram,647,53,92,1,607,70527,53,4,0,70584,68792,1185
05-07-2021,kanyakumari,665,72,13,1,723,59120,72,124,0,59316,57598,995
05-07-2021,karur,318,37,52,2,301,22169,37,47,0,22253,21606,346
05-07-2021,krishnagiri,845,82,128,0,799,40032,82,229,0,40343,39236,308
05-07-2021,madurai,722,73,98,4,693,72437,73,171,0,72681,70863,1125
05-07-2021,mayiladuthurai,268,29,39,0,258,20245,29,39,0,20313,19800,255
05-07-2021,nagapattinam,292,33,24,2,299,17882,33,53,0,17968,17394,275
05-07-2021,namakkal,1351,128,219,3,1257,45085,128,112,0,45325,43642,426
05-07-2021,nilgiris,827,93,69,1,850,28634,93,44,0,28771,27756,165
05-07-2021,perambalur,256,20,48,1,227,11160,20,3,0,11183,10753,203
05-07-2021,pudukottai,606,56,86,4,572,27218,56,35,0,27309,26400,337
05-07-2021,ramanathapuram,198,21,48,0,171,19581,21,135,0,19737,19230,336
05-07-2021,ranipet,594,53,84,0,563,41081,53,49,0,41183,39893,727
05-07-2021,salem,1697,233,146,0,1784,88773,233,436,0,89442,86171,1487
05-07-2021,sivagangai,550,50,74,0,526,17817,50,108,0,17975,17257,192
05-07-2021,tenkasi,292,22,13,0,301,26432,22,58,0,26512,25743,468
05-07-2021,thanjavur,1960,218,239,3,1936,64432,218,22,0,64672,61937,799
05-07-2021,theni,448,39,49,0,438,42470,39,45,0,42554,41622,494
05-07-2021,thirupathur,222,21,25,0,218,27544,21,118,0,27683,26886,579
05-07-2021,thiruvallur,946,92,94,0,944,111429,92,10,0,111531,108873,1714
05-07-2021,thiruvannamalai,1209,129,104,3,1231,49594,129,398,0,50121,48283,607
05-07-2021,thiruvarur,499,44,54,2,487,36989,44,38,0,37071,36243,341
05-07-2021,thoothukudi,428,42,11,0,459,54205,42,275,0,54522,53684,379
05-07-2021,tirunelveli,311,30,23,0,318,46866,30,427,0,47323,46593,412
05-07-2021,tiruppur,1682,217,234,0,1665,83658,217,11,0,83886,81448,773
05-07-2021,trichy,1383,157,96,3,1441,69932,157,60,0,70149,67781,927
05-07-2021,vellore,507,49,64,1,491,45484,48,1607,1,47140,45590,1059
05-07-2021,villupuram,537,63,41,1,558,42561,63,174,0,42798,41907,333
05-07-2021,virudhunagar,524,48,71,0,501,44678,48,104,0,44830,43797,532
05-07-2021,airport surveillance (international),3,0,0,0,3,0,0,1006,0,1006,1002,1
05-07-2021,airport surveillance (domestic),0,0,0,0,0,0,0,1075,0,1075,1074,1
05-07-2021,railway surveillance,0,0,0,0,0,0,0,428,0,428,428,0
06-07-2021,ariyalur,465,37,53,2,447,15100,37,20,0,15157,14492,218
06-07-2021,chengalpattu,1759,180,217,2,1720,157924,180,5,0,158109,154019,2370
06-07-2021,chennai,1940,209,368,5,1776,533593,209,47,0,533849,523841,8232
06-07-2021,coimbatore,3197,407,298,5,3301,222174,407,51,0,222632,217250,2081
06-07-2021,cuddalore,922,83,71,3,931,58219,83,203,0,58505,56800,774
06-07-2021,dharmapuri,869,79,114,1,833,24756,79,216,0,25051,24005,213
06-07-2021,dindigul,369,29,28,0,370,31673,29,77,0,31779,30806,603
06-07-2021,erode,3876,311,302,0,3885,90659,311,94,0,91064,86570,609
06-07-2021,kallakurichi,967,76,132,0,911,27162,76,404,0,27642,26535,196
06-07-2021,kancheepuram,606,49,87,2,566,70579,49,4,0,70632,68879,1187
06-07-2021,kanyakumari,665,69,24,2,708,59134,69,124,0,59327,57622,997
06-07-2021,karur,267,30,32,0,265,22172,30,47,0,22249,21638,346
06-07-2021,krishnagiri,800,70,106,0,764,40115,70,229,0,40414,39342,308
06-07-2021,madurai,693,65,91,4,663,72510,65,171,0,72746,70954,1129
06-07-2021,mayiladuthurai,248,31,28,0,251,20265,31,39,0,20335,19828,256
06-07-2021,nagapattinam,298,27,12,1,312,17914,27,53,0,17994,17406,276
06-07-2021,namakkal,1263,113,227,2,1147,45219,113,112,0,45444,43869,428
06-07-2021,nilgiris,850,105,93,0,862,28727,105,44,0,28876,27849,165
06-07-2021,perambalur,219,22,37,0,204,11172,22,3,0,11197,10790,203
06-07-2021,pudukottai,575,48,79,0,544,27277,48,35,0,27360,26479,337
06-07-2021,ramanathapuram,171,17,31,2,155,19602,17,135,0,19754,19261,338
06-07-2021,ranipet,563,55,88,2,528,41134,55,49,0,41238,39981,729
06-07-2021,salem,1861,228,119,4,1966,89083,228,436,0,89747,86290,1491
06-07-2021,sivagangai,525,48,67,1,505,17866,48,108,0,18022,17324,193
06-07-2021,tenkasi,302,19,29,2,290,26455,19,58,0,26532,25772,470
06-07-2021,thanjavur,1867,206,225,2,1846,64580,206,22,0,64808,62162,800
06-07-2021,theni,427,36,57,4,402,42498,36,45,0,42579,41679,498
06-07-2021,thirupathur,213,20,14,1,218,27560,20,118,0,27698,26900,580
06-07-2021,thiruvallur,946,89,121,3,911,111523,89,10,0,111622,108994,1717
06-07-2021,thiruvannamalai,1231,115,89,4,1253,49723,115,398,0,50236,48372,611
06-07-2021,thiruvarur,482,39,62,4,455,37028,39,38,0,37105,36305,345
06-07-2021,thoothukudi,430,40,13,1,456,54218,40,275,0,54533,53697,380
06-07-2021,tirunelveli,311,26,25,0,312,46889,26,427,0,47342,46618,412
06-07-2021,tiruppur,1749,201,205,8,1737,83959,201,11,0,84171,81653,781
06-07-2021,trichy,1446,146,102,4,1486,70094,146,60,0,70300,67883,931
06-07-2021,vellore,489,45,72,2,460,45530,42,1608,3,47183,45662,1061
06-07-2021,villupuram,559,58,69,0,548,42625,58,174,0,42857,41976,333
06-07-2021,virudhunagar,503,51,68,0,486,44728,51,104,0,44883,43865,532
06-07-2021,airport surveillance (international),3,0,0,0,3,0,0,1006,0,1006,1002,1
06-07-2021,airport surveillance (domestic),0,0,0,0,0,0,0,1075,0,1075,1074,1
06-07-2021,railway surveillance,0,0,0,0,0,0,0,428,0,428,428,0
07-07-2021,ariyalur,444,49,42,1,450,15135,49,20,0,15204,14534,220
07-07-2021,chengalpattu,1816,175,271,2,1718,158200,175,5,0,158380,154290,2372
07-07-2021,chennai,1768,196,304,6,1654,533794,196,47,0,534037,524145,8238
07-07-2021,coimbatore,3561,385,291,4,3651,222841,385,51,0,223277,217541,2085
07-07-2021,cuddalore,931,89,68,2,950,58302,89,203,0,58594,56868,776
07-07-2021,dharmapuri,833,73,98,4,804,24835,73,216,0,25124,24103,217
07-07-2021,dindigul,370,25,32,0,363,31702,25,77,0,31804,30838,603
07-07-2021,erode,3615,288,256,0,3647,90700,288,94,0,91082,86826,609
07-07-2021,kallakurichi,911,70,112,1,868,27238,70,404,0,27712,26647,197
07-07-2021,kancheepuram,566,51,81,3,533,70628,51,4,0,70683,68960,1190
07-07-2021,kanyakumari,702,62,36,1,727,59197,62,124,0,59383,57658,998
07-07-2021,karur,262,27,19,0,270,22199,27,47,0,22273,21657,346
07-07-2021,krishnagiri,767,67,89,1,744,40188,67,229,0,40484,39431,309
07-07-2021,madurai,664,58,83,5,634,72576,58,171,0,72805,71037,1134
07-07-2021,mayiladuthurai,249,34,21,1,261,20294,34,39,0,20367,19849,257
07-07-2021,nagapattinam,292,36,14,1,313,17921,36,53,0,18010,17420,277
07-07-2021,namakkal,1151,108,221,1,1037,45335,108,112,0,45555,44090,428
07-07-2021,nilgiris,862,110,112,1,859,28832,110,44,0,28986,27961,166
07-07-2021,perambalur,208,19,31,0,196,11198,19,3,0,11220,10821,203
07-07-2021,pudukottai,545,44,65,2,522,27326,44,35,0,27405,26544,339
07-07-2021,ramanathapuram,155,13,19,1,148,19619,13,135,0,19767,19280,339
07-07-2021,ranipet,527,53,74,2,504,41188,53,49,0,41290,40055,731
07-07-2021,salem,2041,214,168,2,2085,89386,214,436,0,90036,86458,1493
07-07-2021,sivagangai,503,45,61,0,487,17912,45,108,0,18065,17385,193
07-07-2021,tenkasi,273,17,37,1,252,26457,17,58,0,26532,25809,471
07-07-2021,thanjavur,1818,198,217,3,1796,64758,198,22,0,64978,62379,803
07-07-2021,theni,341,32,48,5,320,42473,32,45,0,42550,41727,503
07-07-2021,thirupathur,201,24,11,2,212,27563,24,118,0,27705,26911,582
07-07-2021,thiruvallur,911,92,102,1,900,111612,92,10,0,111714,109096,1718
07-07-2021,thiruvannamalai,1253,107,108,1,1251,49838,107,398,0,50343,48480,612
07-07-2021,thiruvarur,438,46,49,2,433,37050,46,38,0,37134,36354,347
07-07-2021,thoothukudi,401,37,14,0,424,54203,37,275,0,54515,53711,380
07-07-2021,tirunelveli,298,23,17,2,302,46901,23,427,0,47351,46635,414
07-07-2021,tiruppur,1826,197,258,0,1765,84249,197,11,0,84457,81911,781
07-07-2021,trichy,1486,142,105,3,1520,70240,142,60,0,70442,67988,934
07-07-2021,vellore,461,50,68,2,441,45573,49,1611,1,47234,45730,1063
07-07-2021,villupuram,538,64,53,0,549,42673,64,174,0,42911,42029,333
07-07-2021,virudhunagar,486,47,49,1,483,44779,47,104,0,44930,43914,533
07-07-2021,airport surveillance (international),3,0,0,0,3,0,0,1006,0,1006,1002,1
07-07-2021,airport surveillance (domestic),0,0,0,0,0,0,0,1075,0,1075,1074,1
07-07-2021,railway surveillance,0,0,0,0,0,0,0,428,0,428,428,0
08-07-2021,ariyalur,446,47,38,0,455,15180,47,20,0,15247,14572,220
08-07-2021,chengalpattu,1744,164,312,1,1595,158401,164,5,0,158570,154602,2373
08-07-2021,chennai,1737,189,263,6,1657,534074,189,47,0,534310,524408,8245
08-07-2021,coimbatore,3869,366,271,7,3957,223444,366,51,0,223861,217812,2092
08-07-2021,cuddalore,933,92,76,3,946,58374,92,203,0,58669,56944,779
08-07-2021,dharmapuri,803,76,78,2,799,24907,76,216,0,25199,24181,219
08-07-2021,dindigul,360,20,44,2,334,31724,20,77,0,31821,30882,605
08-07-2021,erode,3422,251,241,2,3430,90763,251,94,0,91108,87067,611
08-07-2021,kallakurichi,866,89,103,0,852,27306,89,404,0,27799,26750,197
08-07-2021,kancheepuram,534,48,58,0,524,70680,48,4,0,70732,69018,1190
08-07-2021,kanyakumari,716,55,49,2,720,59248,55,124,0,59427,57707,1000
08-07-2021,karur,256,32,12,0,276,22212,32,47,0,22291,21669,346
08-07-2021,krishnagiri,744,62,71,1,734,40255,62,229,0,40546,39502,310
08-07-2021,madurai,630,51,74,4,603,72630,51,171,0,72852,71111,1138
08-07-2021,mayiladuthurai,258,35,18,0,275,20325,35,39,0,20399,19867,257
08-07-2021,nagapattinam,288,30,26,0,292,17932,30,53,0,18015,17446,277
08-07-2021,namakkal,1043,97,187,0,953,45449,97,112,0,45658,44277,428
08-07-2021,nilgiris,860,125,126,1,858,28943,125,44,0,29112,28087,167
08-07-2021,perambalur,182,17,24,1,174,11203,17,3,0,11223,10845,204
08-07-2021,pudukottai,501,50,53,1,497,27349,50,35,0,27434,26597,340
08-07-2021,ramanathapuram,148,10,11,0,147,19632,10,135,0,19777,19291,339
08-07-2021,ranipet,505,46,67,1,483,41242,46,49,0,41337,40122,732
08-07-2021,salem,2150,205,183,0,2172,89665,205,436,0,90306,86641,1493
08-07-2021,sivagangai,487,39,53,0,473,17957,39,108,0,18104,17438,193
08-07-2021,tenkasi,252,27,34,3,242,26474,27,58,0,26559,25843,474
08-07-2021,thanjavur,1750,190,196,2,1742,64909,190,22,0,65121,62575,804
08-07-2021,theni,290,28,27,0,291,42475,28,45,0,42548,41754,503
08-07-2021,thirupathur,213,26,13,0,226,27588,26,118,0,27732,26924,582
08-07-2021,thiruvallur,902,87,98,1,890,111706,87,10,0,111803,109194,1719
08-07-2021,thiruvannamalai,1252,96,111,3,1234,49946,96,398,0,50440,48591,615
08-07-2021,thiruvarur,436,41,40,1,436,37099,41,38,0,37178,36394,348
08-07-2021,thoothukudi,402,33,19,0,416,54218,33,275,0,54526,53730,380
08-07-2021,tirunelveli,290,25,24,3,288,46912,25,427,0,47364,46659,417
08-07-2021,tiruppur,1826,185,297,3,1711,84507,185,11,0,84703,82208,784
08-07-2021,trichy,1524,129,108,1,1544,70386,129,60,0,70575,68096,935
08-07-2021,vellore,441,45,64,3,419,45622,44,1612,1,47279,45794,1066
08-07-2021,villupuram,529,60,59,1,529,42717,60,174,0,42951,42088,334
08-07-2021,virudhunagar,484,43,37,2,488,44827,43,104,0,44974,43951,535
08-07-2021,airport surveillance (international),3,0,0,0,3,0,0,1006,0,1006,1002,1
08-07-2021,airport surveillance (domestic),0,0,0,0,0,0,0,1075,0,1075,1074,1
08-07-2021,railway surveillance,0,0,0,0,0,0,0,428,0,428,428,0
09-07-2021,ariyalur,452,38,46,1,443,15224,38,20,0,15282,14618,221
09-07-2021,chengalpattu,1599,156,288,0,1467,158568,156,5,0,158729,154890,2372
09-07-2021,chennai,1723,180,251,6,1646,534330,180,47,0,534557,524659,8252
09-07-2021,coimbatore,4123,349,346,5,4121,223976,349,51,0,224376,218158,2097
09-07-2021,cuddalore,942,98,71,2,967,58462,98,203,0,58763,57015,781
09-07-2021,dharmapuri,795,72,63,1,803,24979,72,216,0,25267,24244,220
09-07-2021,dindigul,317,18,35,1,299,31727,18,77,0,31822,30917,606
09-07-2021,erode,3260,230,247,1,3242,90844,230,94,0,91168,87314,612
09-07-2021,kallakurichi,852,80,92,0,840,27395,80,404,0,27879,26842,197
09-07-2021,kancheepuram,527,44,49,2,520,70731,44,4,0,70779,69067,1192
09-07-2021,kanyakumari,690,50,58,1,681,59273,50,124,0,59447,57765,1001
09-07-2021,karur,262,28,15,0,275,22230,28,47,0,22305,21684,346
09-07-2021,krishnagiri,734,57,54,1,736,40317,57,229,0,40603,39556,311
09-07-2021,madurai,603,45,61,2,585,72681,45,171,0,72897,71172,1140
09-07-2021,mayiladuthurai,276,30,16,0,290,20361,30,39,0,20430,19883,257
09-07-2021,nagapattinam,290,24,21,0,293,17960,24,53,0,18037,17467,277
09-07-2021,namakkal,988,95,183,1,899,45581,95,112,0,45788,44460,429
09-07-2021,nilgiris,858,103,114,2,845,29068,103,44,0,29215,28201,169
09-07-2021,perambalur,172,19,17,2,172,11218,19,3,0,11240,10862,206
09-07-2021,pudukottai,470,53,38,1,484,27372,53,35,0,27460,26635,341
09-07-2021,ramanathapuram,147,8,12,0,143,19642,8,135,0,19785,19303,339
09-07-2021,ranipet,483,44,56,1,470,41288,44,49,0,41381,40178,733
09-07-2021,salem,2177,191,187,6,2175,89875,191,436,0,90502,86828,1499
09-07-2021,sivagangai,474,51,41,0,484,17997,51,108,0,18156,17479,193
09-07-2021,tenkasi,229,21,28,2,220,26488,21,58,0,26567,25871,476
09-07-2021,thanjavur,1639,179,174,4,1640,64996,179,22,0,65197,62749,808
09-07-2021,theni,287,31,16,3,299,42499,31,45,0,42575,41770,506
09-07-2021,thirupathur,226,24,11,1,238,27614,24,118,0,27756,26935,583
09-07-2021,thiruvallur,889,93,82,2,898,111792,93,10,0,111895,109276,1721
09-07-2021,thiruvannamalai,1251,90,92,3,1246,50059,90,398,0,50547,48683,618
09-07-2021,thiruvarur,441,35,34,1,441,37145,35,38,0,37218,36428,349
09-07-2021,thoothukudi,414,35,15,2,432,54249,35,275,0,54559,53745,382
09-07-2021,tirunelveli,279,23,19,0,283,46928,23,427,0,47378,46678,417
09-07-2021,tiruppur,1807,176,319,8,1656,84788,176,11,0,84975,82527,792
09-07-2021,trichy,1550,121,126,1,1544,70521,121,60,0,70702,68222,936
09-07-2021,vellore,419,47,61,4,401,45666,46,1613,1,47326,45855,1070
09-07-2021,villupuram,529,62,47,0,544,42777,62,174,0,43013,42135,334
09-07-2021,virudhunagar,488,39,26,2,499,44870,39,104,0,45013,43977,537
09-07-2021,airport surveillance (international),3,0,0,0,3,0,0,1006,0,1006,1002,1
09-07-2021,airport surveillance (domestic),0,0,0,0,0,0,0,1075,0,1075,1074,1
09-07-2021,railway surveillance,0,0,0,0,0,0,0,428,0,428,428,0
10-07-2021,ariyalur,444,32,48,0,428,15263,32,20,0,15315,14666,221
10-07-2021,chengalpattu,1603,148,293,1,1457,158860,148,5,0,159013,155183,2373
10-07-2021,chennai,1734,174,245,4,1659,534598,174,47,0,534819,524904,8256
10-07-2021,coimbatore,4151,338,378,3,4108,224355,338,51,0,224744,218536,2100
10-07-2021,cuddalore,966,90,86,7,963,58559,90,203,0,58852,57101,788
10-07-2021,dharmapuri,803,65,67,2,799,25051,65,216,0,25332,24311,222
10-07-2021,dindigul,288,23,29,1,281,31734,23,77,0,31834,30946,607
10-07-2021,erode,2989,215,207,0,2997,90821,215,94,0,91130,87521,612
10-07-2021,kallakurichi,860,72,113,0,819,27495,72,404,0,27971,26955,197
10-07-2021,kancheepuram,540,42,58,1,523,70795,42,4,0,70841,69125,1193
10-07-2021,kanyakumari,616,45,56,1,604,59258,45,124,0,59427,57821,1002
10-07-2021,karur,275,23,12,1,285,22258,23,47,0,22328,21696,347
10-07-2021,krishnagiri,736,53,65,1,723,40374,52,229,1,40656,39621,312
10-07-2021,madurai,605,39,48,0,596,72746,39,171,0,72956,71220,1140
10-07-2021,mayiladuthurai,297,24,19,0,302,20398,24,39,0,20461,19902,257
10-07-2021,nagapattinam,285,54,17,2,320,17976,54,53,0,18083,17484,279
10-07-2021,namakkal,908,88,142,3,851,45685,88,112,0,45885,44602,432
10-07-2021,nilgiris,845,99,94,1,849,29171,99,44,0,29314,28295,170
10-07-2021,perambalur,172,16,12,2,174,11237,16,3,0,11256,10874,208
10-07-2021,pudukottai,483,46,23,2,504,27424,46,35,0,27505,26658,343
10-07-2021,ramanathapuram,144,6,11,0,139,19651,6,135,0,19792,19314,339
10-07-2021,ranipet,474,41,45,0,470,41335,41,49,0,41425,40223,732
10-07-2021,salem,2185,180,206,4,2155,90076,180,436,0,90692,87034,1503
10-07-2021,sivagangai,484,46,47,0,483,18048,46,108,0,18202,17526,193
10-07-2021,tenkasi,220,17,23,0,214,26509,17,58,0,26584,25894,476
10-07-2021,thanjavur,1634,174,148,2,1658,65169,174,22,0,65365,62897,810
10-07-2021,theni,289,32,12,0,309,42520,32,45,0,42597,41782,506
10-07-2021,thirupathur,204,41,13,0,232,27604,41,118,0,27763,26948,583
10-07-2021,thiruvallur,900,85,89,1,895,111887,85,10,0,111982,109365,1722
10-07-2021,thiruvannamalai,1246,84,97,1,1232,50149,84,398,0,50631,48780,619
10-07-2021,thiruvarur,410,30,24,2,414,37149,30,38,0,37217,36452,351
10-07-2021,thoothukudi,423,52,17,0,458,54275,52,275,0,54602,53762,382
10-07-2021,tirunelveli,281,20,21,0,280,46949,20,427,0,47396,46699,417
10-07-2021,tiruppur,1740,169,296,6,1607,85048,169,11,0,85228,82823,798
10-07-2021,trichy,1548,116,134,0,1530,70646,116,60,0,70822,68356,936
10-07-2021,vellore,395,43,52,1,385,45707,39,1614,4,47364,45907,1072
10-07-2021,villupuram,544,56,38,0,562,42839,56,174,0,43069,42173,334
10-07-2021,virudhunagar,500,35,36,0,499,44910,35,104,0,45049,44013,537
10-07-2021,airport surveillance (international),3,0,0,0,3,0,0,1006,0,1006,1002,1
10-07-2021,airport surveillance (domestic),0,0,0,0,0,0,0,1075,0,1075,1074,1
10-07-2021,railway surveillance,0,0,0,0,0,0,0,428,0,428,428,0
11-07-2021,ariyalur,431,29,37,0,423,15298,29,20,0,15347,14703,221
11-07-2021,chengalpattu,1520,144,296,0,1368,159071,144,5,0,159220,155479,2373
11-07-2021,chennai,1713,171,223,0,1661,534826,171,47,0,535044,525127,8256
11-07-2021,coimbatore,4109,298,394,7,4006,224694,298,51,0,225043,218930,2107
11-07-2021,cuddalore,963,87,91,5,954,58649,87,203,0,58939,57192,793
11-07-2021,dharmapuri,799,59,76,2,780,25116,59,216,0,25391,24387,224
11-07-2021,dindigul,258,21,21,0,258,31734,21,77,0,31832,30967,607
11-07-2021,erode,2826,198,174,3,2847,90865,198,94,0,91157,87695,615
11-07-2021,kallakurichi,818,68,92,0,794,27566,68,404,0,28038,27047,197
11-07-2021,kancheepuram,526,41,57,1,509,70840,41,4,0,70885,69182,1194
11-07-2021,kanyakumari,604,43,53,1,593,59303,43,124,0,59470,57874,1003
11-07-2021,karur,285,24,11,0,298,22281,24,47,0,22352,21707,347
11-07-2021,krishnagiri,723,54,61,0,716,40426,54,230,0,40710,39682,312
11-07-2021,madurai,598,35,43,0,590,72787,35,171,0,72993,71263,1140
11-07-2021,mayiladuthurai,302,22,15,1,308,20422,22,39,0,20483,19917,258
11-07-2021,nagapattinam,321,47,24,1,343,18031,47,53,0,18131,17508,280
11-07-2021,namakkal,857,85,109,2,831,45779,85,112,0,45976,44711,434
11-07-2021,nilgiris,849,88,78,1,858,29270,88,44,0,29402,28373,171
11-07-2021,perambalur,176,15,10,0,181,11255,15,3,0,11273,10884,208
11-07-2021,pudukottai,507,39,33,0,513,27473,39,35,0,27547,26691,343
11-07-2021,ramanathapuram,139,5,12,0,132,19657,5,135,0,19797,19326,339
11-07-2021,ranipet,471,38,34,0,475,41377,38,49,0,41464,40257,732
11-07-2021,salem,2158,175,238,9,2086,90259,175,436,0,90870,87272,1512
11-07-2021,sivagangai,482,41,35,0,488,18093,41,108,0,18242,17561,193
11-07-2021,tenkasi,214,20,27,0,207,26526,20,58,0,26604,25921,476
11-07-2021,thanjavur,1647,210,116,2,1739,65332,210,22,0,65564,63013,812
11-07-2021,theni,308,29,13,0,324,42551,29,45,0,42625,41795,506
11-07-2021,thirupathur,232,36,11,0,257,27645,36,118,0,27799,26959,583
11-07-2021,thiruvallur,899,80,97,1,881,111976,80,10,0,112066,109462,1723
11-07-2021,thiruvannamalai,1232,79,94,2,1215,50233,79,398,0,50710,48874,621
11-07-2021,thiruvarur,417,40,32,2,423,37182,40,38,0,37260,36484,353
11-07-2021,thoothukudi,458,45,28,0,475,54327,45,275,0,54647,53790,382
11-07-2021,tirunelveli,280,18,37,1,260,46969,18,427,0,47414,46736,418
11-07-2021,tiruppur,1669,163,278,2,1552,85279,163,11,0,85453,83101,800
11-07-2021,trichy,1527,108,144,0,1491,70759,108,60,0,70927,68500,936
11-07-2021,vellore,385,38,37,4,382,45746,38,1618,0,47402,45944,1076
11-07-2021,villupuram,562,50,31,0,581,42895,50,174,0,43119,42204,334
11-07-2021,virudhunagar,499,32,26,0,505,44945,32,104,0,45081,44039,537
11-07-2021,airport surveillance (international),3,0,0,0,3,0,0,1006,0,1006,1002,1
11-07-2021,airport surveillance (domestic),0,0,0,0,0,0,0,1075,0,1075,1074,1
11-07-2021,railway surveillance,0,0,0,0,0,0,0,428,0,428,428,0
13-07-2021,ariyalur,408,23,41,4,386,15351,23,20,0,15394,14782,226
13-07-2021,chengalpattu,1374,135,264,3,1242,159505,135,5,0,159645,156026,2377
13-07-2021,chennai,1681,160,187,5,1649,535232,160,47,0,535439,525523,8267
13-07-2021,coimbatore,3906,282,408,1,3779,225284,282,51,0,225617,219730,2108
13-07-2021,cuddalore,933,73,92,0,914,58810,73,203,0,59086,57380,792
13-07-2021,dharmapuri,761,49,83,1,726,25231,49,216,0,25496,24544,226
13-07-2021,dindigul,251,21,28,5,239,31774,21,77,0,31872,31021,612
13-07-2021,erode,2655,187,174,0,2668,91024,187,94,0,91305,88022,615
13-07-2021,kallakurichi,783,61,72,0,772,27699,61,404,0,28164,27195,197
13-07-2021,kancheepuram,491,35,51,3,472,70917,35,4,0,70956,69286,1198
13-07-2021,kanyakumari,523,40,36,0,527,59328,40,124,0,59492,57958,1007
13-07-2021,karur,294,19,18,1,294,22317,19,47,0,22383,21741,348
13-07-2021,krishnagiri,689,46,68,0,667,40525,46,230,0,40801,39822,312
13-07-2021,madurai,573,30,43,0,560,72856,30,171,0,73057,71357,1140
13-07-2021,mayiladuthurai,321,37,22,0,336,20478,37,39,0,20554,19958,260
13-07-2021,nagapattinam,343,34,18,0,359,18096,34,53,0,18183,17542,282
13-07-2021,namakkal,829,74,74,0,829,45949,74,112,0,46135,44872,434
13-07-2021,nilgiris,876,70,61,0,885,29442,70,44,0,29556,28499,172
13-07-2021,perambalur,177,16,13,0,180,11280,16,3,0,11299,10911,208
13-07-2021,pudukottai,514,33,44,2,501,27554,33,35,0,27622,26773,348
13-07-2021,ramanathapuram,141,13,9,0,145,19681,13,135,0,19829,19345,339
13-07-2021,ranipet,470,34,46,0,458,41451,34,49,0,41534,40344,732
13-07-2021,salem,2032,162,218,6,1970,90608,162,436,0,91206,87717,1519
13-07-2021,sivagangai,483,41,49,0,475,18169,41,108,0,18318,17649,194
13-07-2021,tenkasi,187,15,21,1,180,26554,15,58,0,26627,25970,477
13-07-2021,thanjavur,1820,185,97,2,1906,65722,185,22,0,65929,63205,818
13-07-2021,theni,331,22,23,0,330,42605,22,45,0,42672,41836,506
13-07-2021,thirupathur,272,26,16,1,281,27711,26,118,0,27855,26990,584
13-07-2021,thiruvallur,851,68,89,1,829,112131,68,10,0,112209,109653,1727
13-07-2021,thiruvannamalai,1180,71,128,2,1121,50393,71,398,0,50862,49118,623
13-07-2021,thiruvarur,387,32,41,3,375,37233,32,38,0,37303,36570,358
13-07-2021,thoothukudi,484,33,47,1,469,54418,33,275,0,54726,53874,383
13-07-2021,tirunelveli,244,25,32,0,237,47005,25,427,0,47457,46802,418
13-07-2021,tiruppur,1619,148,186,5,1576,85738,148,11,0,85897,83515,806
13-07-2021,trichy,1452,98,146,1,1403,70971,98,60,0,71129,68787,939
13-07-2021,vellore,393,31,21,0,403,45818,27,1619,4,47468,45988,1077
13-07-2021,villupuram,593,47,39,0,601,42995,47,174,0,43216,42281,334
13-07-2021,virudhunagar,495,28,53,0,470,45008,28,104,0,45140,44133,537
13-07-2021,airport surveillance (international),3,1,0,0,4,0,0,1006,1,1007,1002,1
13-07-2021,airport surveillance (domestic),0,0,0,0,0,0,0,1075,0,1075,1074,1
13-07-2021,railway surveillance,0,0,0,0,0,0,0,428,0,428,428,0
14-07-2021,ariyalur,386,28,33,0,381,15374,28,20,0,15422,14815,226
14-07-2021,chengalpattu,1236,131,231,0,1136,159634,131,5,0,159770,156257,2377
14-07-2021,chennai,1645,153,164,5,1629,535388,153,47,0,535588,525687,8272
14-07-2021,coimbatore,3781,270,414,8,3629,225568,270,51,0,225889,220144,2116
14-07-2021,cuddalore,913,95,89,2,917,58882,95,203,0,59180,57469,794
14-07-2021,dharmapuri,727,42,78,1,690,25281,42,216,0,25539,24622,227
14-07-2021,dindigul,239,18,26,1,230,31795,18,77,0,31890,31047,613
14-07-2021,erode,2659,175,193,0,2641,91203,175,94,0,91472,88215,616
14-07-2021,kallakurichi,774,65,74,0,765,27762,65,404,0,28231,27269,197
14-07-2021,kancheepuram,473,33,48,1,457,70953,33,4,0,70990,69334,1199
14-07-2021,kanyakumari,526,55,42,2,537,59367,55,124,0,59546,58000,1009
14-07-2021,karur,294,16,23,1,286,22336,16,47,0,22399,21764,349
14-07-2021,krishnagiri,667,43,65,1,644,40571,43,230,0,40844,39887,313
14-07-2021,madurai,559,31,47,0,543,72885,31,171,0,73087,71404,1140
14-07-2021,mayiladuthurai,338,34,28,1,343,20517,34,39,0,20590,19986,261
14-07-2021,nagapattinam,357,32,21,1,367,18128,32,53,0,18213,17563,283
14-07-2021,namakkal,834,66,78,1,821,46027,66,112,0,46205,44950,434
14-07-2021,nilgiris,886,68,56,0,898,29513,68,44,0,29625,28555,172
14-07-2021,perambalur,181,13,14,2,178,11297,13,3,0,11313,10925,210
14-07-2021,pudukottai,506,31,45,1,491,27592,31,35,0,27658,26818,349
14-07-2021,ramanathapuram,146,11,11,1,145,19695,11,135,0,19841,19356,340
14-07-2021,ranipet,458,30,42,0,446,41485,30,49,0,41564,40386,732
14-07-2021,salem,1971,164,227,2,1906,90771,164,436,0,91371,87944,1521
14-07-2021,sivagangai,477,45,53,0,469,18212,45,108,0,18365,17702,194
14-07-2021,tenkasi,180,14,18,0,176,26569,14,58,0,26641,25988,477
14-07-2021,thanjavur,1908,171,106,5,1968,65909,171,22,0,66102,63311,823
14-07-2021,theni,330,26,26,2,328,42627,26,45,0,42698,41862,508
14-07-2021,thirupathur,280,25,12,2,291,27736,25,118,0,27879,27002,586
14-07-2021,thiruvallur,831,64,86,2,807,112201,64,10,0,112275,109739,1729
14-07-2021,thiruvannamalai,1121,74,124,1,1070,50464,74,398,0,50936,49242,624
14-07-2021,thiruvarur,377,27,39,2,363,37267,27,38,0,37332,36609,360
14-07-2021,thoothukudi,469,38,58,1,448,54451,38,275,0,54764,53932,384
14-07-2021,tirunelveli,238,23,34,3,224,47031,23,427,0,47481,46836,421
14-07-2021,tiruppur,1577,146,164,2,1557,85887,146,11,0,86044,83679,808
14-07-2021,trichy,1395,94,137,3,1349,71061,94,60,0,71215,68924,942
14-07-2021,vellore,402,39,24,1,416,45844,36,1623,3,47506,46012,1078
14-07-2021,villupuram,602,44,43,0,603,43043,44,174,0,43261,42324,334
14-07-2021,virudhunagar,471,24,48,0,447,45037,24,104,0,45165,44181,537
14-07-2021,airport surveillance (international),4,0,0,0,4,0,0,1007,0,1007,1002,1
14-07-2021,airport surveillance (domestic),0,0,0,0,0,0,0,1075,0,1075,1074,1
14-07-2021,railway surveillance,0,0,0,0,0,0,0,428,0,428,428,0
15-07-2021,ariyalur,381,30,37,2,372,15402,30,20,0,15452,14852,228
15-07-2021,chengalpattu,1183,130,194,3,1116,159812,130,5,0,159947,156451,2380
15-07-2021,chennai,1640,148,148,7,1633,535552,148,47,0,535747,525835,8279
15-07-2021,coimbatore,3635,256,432,6,3453,225844,256,51,0,226151,220576,2122
15-07-2021,cuddalore,918,86,91,0,913,58977,86,203,0,59266,57560,793
15-07-2021,dharmapuri,691,40,83,2,646,25324,40,216,0,25580,24705,229
15-07-2021,dindigul,229,23,21,1,230,31812,23,77,0,31912,31068,614
15-07-2021,erode,2628,159,219,0,2568,91365,159,94,0,91618,88434,616
15-07-2021,kallakurichi,765,72,78,0,759,27827,72,404,0,28303,27347,197
15-07-2021,kancheepuram,457,45,46,1,455,70986,45,4,0,71035,69380,1200
15-07-2021,kanyakumari,528,47,48,2,525,59413,47,124,0,59584,58048,1011
15-07-2021,karur,281,21,26,0,276,22347,21,47,0,22415,21790,349
15-07-2021,krishnagiri,646,38,71,1,612,40616,38,230,0,40884,39958,314
15-07-2021,madurai,543,34,53,0,524,72916,34,171,0,73121,71457,1140
15-07-2021,mayiladuthurai,343,28,32,1,338,20551,28,39,0,20618,20018,262
15-07-2021,nagapattinam,367,27,16,0,378,18161,27,53,0,18241,17579,284
15-07-2021,namakkal,819,74,66,0,827,46091,74,112,0,46277,45016,434
15-07-2021,nilgiris,898,67,52,0,913,29581,67,44,0,29692,28607,172
15-07-2021,perambalur,178,24,12,3,187,11310,24,3,0,11337,10937,213
15-07-2021,pudukottai,480,37,47,0,470,27612,37,35,0,27684,26865,349
15-07-2021,ramanathapuram,145,15,8,1,151,19706,15,135,0,19856,19364,341
15-07-2021,ranipet,447,26,44,0,429,41516,26,49,0,41591,40430,732
15-07-2021,salem,1907,155,236,3,1823,90936,155,436,0,91527,88180,1524
15-07-2021,sivagangai,460,39,51,0,448,18248,39,108,0,18395,17753,194
15-07-2021,tenkasi,176,11,12,0,175,26583,11,58,0,26652,26000,477
15-07-2021,thanjavur,1970,163,121,2,2010,66082,163,22,0,66267,63432,825
15-07-2021,theni,328,24,29,0,323,42653,24,45,0,42722,41891,508
15-07-2021,thirupathur,289,22,15,3,293,27759,22,118,0,27899,27017,589
15-07-2021,thiruvallur,804,60,82,2,780,112262,60,10,0,112332,109821,1731
15-07-2021,thiruvannamalai,1070,73,126,2,1015,50538,73,398,0,51009,49368,626
15-07-2021,thiruvarur,356,29,28,2,355,37287,29,38,0,37354,36637,362
15-07-2021,thoothukudi,448,31,62,0,417,54489,31,275,0,54795,53994,384
15-07-2021,tirunelveli,224,20,31,0,213,47054,20,427,0,47501,46867,421
15-07-2021,tiruppur,1554,143,134,2,1561,86030,143,11,0,86184,83813,810
15-07-2021,trichy,1349,88,142,2,1293,71155,88,60,0,71303,69066,944
15-07-2021,vellore,415,41,21,0,435,45879,40,1626,1,47546,46033,1078
15-07-2021,villupuram,597,46,48,1,594,43081,46,174,0,43301,42372,335
15-07-2021,virudhunagar,447,33,44,0,436,45061,33,104,0,45198,44225,537
15-07-2021,airport surveillance (international),4,0,0,0,4,0,0,1007,0,1007,1002,1
15-07-2021,airport surveillance (domestic),0,0,0,0,0,0,0,1075,0,1075,1074,1
15-07-2021,railway surveillance,0,0,0,0,0,0,0,428,0,428,428,0
16-07-2021,ariyalur,373,25,35,2,361,15433,25,20,0,15478,14887,230
16-07-2021,chengalpattu,1160,127,187,3,1097,159987,127,5,0,160119,156638,2384
16-07-2021,chennai,1644,144,142,7,1639,535711,144,47,0,535902,525977,8286
16-07-2021,coimbatore,3454,252,418,4,3284,226101,252,51,0,226404,220994,2126
16-07-2021,cuddalore,902,83,93,4,888,59052,83,203,0,59338,57653,797
16-07-2021,dharmapuri,646,36,77,1,604,25364,36,216,0,25616,24782,230
16-07-2021,dindigul,229,19,24,0,224,31834,19,77,0,31930,31092,614
16-07-2021,erode,2511,152,231,2,2430,91467,152,94,0,91713,88665,618
16-07-2021,kallakurichi,759,70,83,0,746,27899,70,404,0,28373,27430,197
16-07-2021,kancheepuram,456,42,49,0,449,71032,42,4,0,71078,69429,1200
16-07-2021,kanyakumari,527,43,52,0,518,59461,43,124,0,59628,58100,1010
16-07-2021,karur,273,18,28,0,263,22365,18,47,0,22430,21818,349
16-07-2021,krishnagiri,614,35,67,0,582,40656,35,230,0,40921,40025,314
16-07-2021,madurai,522,29,69,0,482,72948,29,171,0,73148,71526,1140
16-07-2021,mayiladuthurai,342,23,31,1,333,20583,23,39,0,20645,20049,263
16-07-2021,nagapattinam,374,22,19,1,376,18184,22,53,0,18259,17598,285
16-07-2021,namakkal,831,69,69,1,830,46169,69,112,0,46350,45085,435
16-07-2021,nilgiris,913,58,54,0,917,29648,58,44,0,29750,28661,172
16-07-2021,perambalur,187,17,14,1,189,11334,17,3,0,11354,10951,214
16-07-2021,pudukottai,467,34,52,2,447,27646,34,35,0,27715,26917,351
16-07-2021,ramanathapuram,151,13,11,0,153,19721,13,135,0,19869,19375,341
16-07-2021,ranipet,428,21,46,2,401,41541,21,49,0,41611,40476,734
16-07-2021,salem,1827,168,208,0,1787,91095,168,436,0,91699,88388,1524
16-07-2021,sivagangai,448,36,49,0,435,18287,36,108,0,18431,17802,194
16-07-2021,tenkasi,175,10,10,0,175,26594,10,58,0,26662,26010,477
16-07-2021,thanjavur,1983,158,134,1,2006,66218,158,22,0,66398,63566,826
16-07-2021,theni,323,20,32,1,310,42677,20,45,0,42742,41923,509
16-07-2021,thirupathur,291,17,18,1,289,27779,17,118,0,27914,27035,590
16-07-2021,thiruvallur,785,71,76,4,776,112327,71,10,0,112408,109897,1735
16-07-2021,thiruvannamalai,1015,91,119,1,986,50611,91,398,0,51100,49487,627
16-07-2021,thiruvarur,357,35,24,1,367,37318,35,38,0,37391,36661,363
16-07-2021,thoothukudi,417,26,56,0,387,54520,26,275,0,54821,54050,384
16-07-2021,tirunelveli,213,16,27,2,200,47074,16,427,0,47517,46894,423
16-07-2021,tiruppur,1585,138,126,0,1597,86197,138,11,0,86346,83939,810
16-07-2021,trichy,1295,84,133,0,1246,71245,84,60,0,71389,69199,944
16-07-2021,vellore,436,39,23,4,448,45920,36,1627,3,47586,46056,1082
16-07-2021,villupuram,596,44,52,0,588,43129,44,174,0,43347,42424,335
16-07-2021,virudhunagar,437,27,48,0,416,45095,27,104,0,45226,44273,537
16-07-2021,airport surveillance (international),4,0,0,0,4,0,0,1007,0,1007,1002,1
16-07-2021,airport surveillance (domestic),0,0,0,0,0,0,0,1075,0,1075,1074,1
16-07-2021,railway surveillance,0,0,0,0,0,0,0,428,0,428,428,0
17-07-2021,ariyalur,360,21,32,0,349,15457,21,20,0,15498,14919,230
17-07-2021,chengalpattu,1101,124,115,0,1110,160118,124,5,0,160247,156753,2384
17-07-2021,chennai,1632,137,131,6,1632,535848,137,47,0,536032,526108,8292
17-07-2021,coimbatore,3286,241,425,2,3100,226355,241,51,0,226647,221419,2128
17-07-2021,cuddalore,892,76,82,5,881,59138,76,203,0,59417,57735,801
17-07-2021,dharmapuri,604,30,65,0,569,25400,30,216,0,25646,24847,230
17-07-2021,dindigul,222,15,21,1,215,31851,15,77,0,31943,31113,615
17-07-2021,erode,2432,143,224,0,2351,91621,143,94,0,91858,88889,618
17-07-2021,kallakurichi,761,58,72,0,747,27984,58,404,0,28446,27502,197
17-07-2021,kancheepuram,450,38,47,0,441,71075,38,4,0,71117,69476,1200
17-07-2021,kanyakumari,515,37,44,2,506,59501,37,124,0,59662,58144,1012
17-07-2021,karur,264,16,22,1,257,22384,16,47,0,22447,21840,350
17-07-2021,krishnagiri,583,31,55,2,557,40692,31,230,0,40953,40080,316
17-07-2021,madurai,481,25,64,0,442,72976,25,171,0,73172,71590,1140
17-07-2021,mayiladuthurai,334,22,29,1,326,20607,22,39,0,20668,20078,264
17-07-2021,nagapattinam,376,31,17,0,390,18207,31,53,0,18291,17615,286
17-07-2021,namakkal,827,64,62,1,828,46235,64,112,0,46411,45147,436
17-07-2021,nilgiris,917,60,51,0,926,29706,60,44,0,29810,28712,172
17-07-2021,perambalur,189,12,10,0,191,11351,12,3,0,11366,10961,214
17-07-2021,pudukottai,448,32,38,0,442,27681,32,35,0,27748,26955,351
17-07-2021,ramanathapuram,153,18,12,1,158,19734,18,135,0,19887,19387,342
17-07-2021,ranipet,401,30,33,0,398,41562,30,49,0,41641,40509,734
17-07-2021,salem,1790,163,190,1,1762,91266,163,436,0,91865,88578,1525
17-07-2021,sivagangai,435,34,55,0,414,18323,34,108,0,18465,17857,194
17-07-2021,tenkasi,176,14,11,0,179,26605,14,58,0,26677,26021,477
17-07-2021,thanjavur,2003,152,239,3,1913,66373,152,22,0,66547,63805,829
17-07-2021,theni,309,19,33,0,295,42696,19,45,0,42760,41956,509
17-07-2021,thirupathur,287,21,15,3,290,27794,21,118,0,27933,27050,593
17-07-2021,thiruvallur,781,74,64,3,788,112403,74,10,0,112487,109961,1738
17-07-2021,thiruvannamalai,991,88,98,1,980,50707,88,398,0,51193,49585,628
17-07-2021,thiruvarur,369,33,28,0,374,37355,33,38,0,37426,36689,363
17-07-2021,thoothukudi,387,20,36,0,371,54546,20,275,0,54841,54086,384
17-07-2021,tirunelveli,202,14,23,1,192,47092,14,427,0,47533,46917,424
17-07-2021,tiruppur,1595,132,121,1,1605,86333,132,11,0,86476,84060,811
17-07-2021,trichy,1243,79,119,4,1199,71326,79,60,0,71465,69318,948
17-07-2021,vellore,444,36,26,3,451,45952,34,1630,2,47618,46082,1085
17-07-2021,villupuram,569,41,54,1,555,43154,41,174,0,43369,42478,336
17-07-2021,virudhunagar,417,24,39,0,402,45123,24,104,0,45251,44312,537
17-07-2021,airport surveillance (international),4,0,0,0,4,0,0,1007,0,1007,1002,1
17-07-2021,airport surveillance (domestic),0,0,0,0,0,0,0,1075,0,1075,1074,1
17-07-2021,railway surveillance,0,0,0,0,0,0,0,428,0,428,428,0
19-07-2021,ariyalur,332,21,34,0,319,15497,21,20,0,15538,14989,230
19-07-2021,chengalpattu,1227,116,108,1,1234,160486,116,5,0,160607,156987,2386
19-07-2021,chennai,1661,147,122,3,1683,536157,147,47,0,536351,526369,8299
19-07-2021,coimbatore,2928,209,357,3,2777,226819,209,51,0,227079,222167,2135
19-07-2021,cuddalore,887,90,69,1,907,59297,90,203,0,59590,57881,802
19-07-2021,dharmapuri,548,33,58,0,523,25465,33,216,0,25714,24961,230
19-07-2021,dindigul,210,20,18,0,212,31885,20,77,0,31982,31153,617
19-07-2021,erode,2217,122,237,0,2102,91847,122,94,0,92063,89342,619
19-07-2021,kallakurichi,724,52,56,0,720,28087,52,404,0,28543,27626,197
19-07-2021,kancheepuram,447,43,39,0,451,71161,43,4,0,71208,69556,1201
19-07-2021,kanyakumari,498,47,44,0,501,59573,47,124,0,59744,58231,1012
19-07-2021,karur,253,17,26,0,244,22419,17,47,0,22483,21889,350
19-07-2021,krishnagiri,523,22,53,0,492,40748,22,230,0,41000,40190,318
19-07-2021,madurai,407,26,56,0,377,73027,26,171,0,73224,71707,1140
19-07-2021,mayiladuthurai,325,19,32,1,311,20659,19,39,0,20717,20141,265
19-07-2021,nagapattinam,400,35,23,1,411,18270,35,53,0,18358,17660,287
19-07-2021,namakkal,823,57,61,1,818,46361,57,112,0,46530,45275,437
19-07-2021,nilgiris,916,52,72,0,896,29820,52,44,0,29916,28848,172
19-07-2021,perambalur,188,7,10,1,184,11372,7,3,0,11382,10983,215
19-07-2021,pudukottai,421,30,38,2,411,27734,30,35,0,27799,27034,354
19-07-2021,ramanathapuram,155,11,12,2,152,19765,11,135,0,19911,19415,344
19-07-2021,ranipet,381,16,31,2,364,41613,16,49,0,41678,40577,737
19-07-2021,salem,1723,136,153,1,1705,91570,136,436,0,92142,88909,1528
19-07-2021,sivagangai,396,22,31,0,387,18385,22,108,0,18515,17934,194
19-07-2021,tenkasi,175,11,15,0,171,26627,11,58,0,26696,26048,477
19-07-2021,thanjavur,1758,108,178,4,1684,66584,108,22,0,66714,64196,834
19-07-2021,theni,279,10,21,0,268,42725,10,45,0,42780,42001,511
19-07-2021,thirupathur,286,24,14,0,296,27828,24,118,0,27970,27080,594
19-07-2021,thiruvallur,792,66,78,2,778,112553,66,10,0,112629,110110,1741
19-07-2021,thiruvannamalai,960,78,111,0,927,50878,78,398,0,51354,49799,628
19-07-2021,thiruvarur,368,27,35,0,360,37418,27,38,0,37483,36760,363
19-07-2021,thoothukudi,354,15,27,1,341,54583,15,275,0,54873,54146,386
19-07-2021,tirunelveli,198,18,17,0,199,47128,18,427,0,47573,46950,424
19-07-2021,tiruppur,1605,112,102,1,1614,86586,112,11,0,86709,84281,814
19-07-2021,trichy,1172,70,98,1,1143,71484,70,60,0,71614,69522,949
19-07-2021,vellore,449,32,36,0,445,46016,29,1633,3,47681,46149,1087
19-07-2021,villupuram,526,29,47,0,508,43215,29,174,0,43418,42574,336
19-07-2021,virudhunagar,381,20,39,0,362,45170,20,104,0,45294,44395,537
19-07-2021,airport surveillance (international),4,1,0,0,5,0,0,1007,1,1008,1002,1
19-07-2021,airport surveillance (domestic),0,0,0,0,0,0,0,1075,0,1075,1074,1
19-07-2021,railway surveillance,0,0,0,0,0,0,0,428,0,428,428,0
20-07-2021,ariyalur,316,17,29,0,304,15515,17,20,0,15552,15018,230
20-07-2021,chengalpattu,1276,111,112,0,1275,160646,111,5,0,160762,157099,2388
20-07-2021,chennai,1684,141,135,3,1687,536305,141,47,0,536493,526504,8302
20-07-2021,coimbatore,2777,204,328,5,2648,227028,204,51,0,227283,222495,2140
20-07-2021,cuddalore,908,85,62,0,931,59388,85,203,0,59676,57943,802
20-07-2021,dharmapuri,522,29,56,0,495,25497,29,216,0,25742,25017,230
20-07-2021,dindigul,211,16,14,0,213,31904,16,77,0,31997,31167,617
20-07-2021,erode,2099,129,208,4,2016,91966,129,94,0,92189,89550,623
20-07-2021,kallakurichi,720,48,58,0,710,28139,48,404,0,28591,27684,197
20-07-2021,kancheepuram,454,38,42,1,449,71205,38,4,0,71247,69598,1200
20-07-2021,kanyakumari,484,42,48,1,477,59603,42,124,0,59769,58279,1013
20-07-2021,karur,244,13,29,0,228,22436,13,47,0,22496,21918,350
20-07-2021,krishnagiri,493,23,44,0,472,40771,23,230,0,41024,40234,318
20-07-2021,madurai,377,28,47,0,358,73053,28,171,0,73252,71754,1140
20-07-2021,mayiladuthurai,306,20,28,0,298,20674,20,39,0,20733,20169,266
20-07-2021,nagapattinam,411,30,21,0,420,18304,30,53,0,18387,17681,286
20-07-2021,namakkal,820,55,79,0,796,46420,55,112,0,46587,45354,437
20-07-2021,nilgiris,896,45,76,1,864,29872,45,44,0,29961,28924,173
20-07-2021,perambalur,187,13,11,0,189,11382,13,3,0,11398,10994,215
20-07-2021,pudukottai,411,26,34,1,402,27764,26,35,0,27825,27068,355
20-07-2021,ramanathapuram,152,9,9,1,151,19776,9,135,0,19920,19424,345
20-07-2021,ranipet,366,25,28,1,362,41631,25,49,0,41705,40605,738
20-07-2021,salem,1707,133,147,2,1691,91708,133,436,0,92277,89056,1530
20-07-2021,sivagangai,386,29,26,0,389,18406,29,108,0,18543,17960,194
20-07-2021,tenkasi,162,10,17,0,155,26629,10,58,0,26697,26065,477
20-07-2021,thanjavur,1682,102,152,0,1632,66690,102,22,0,66814,64348,834
20-07-2021,theni,268,15,22,0,261,42735,15,45,0,42795,42023,511
20-07-2021,thirupathur,296,21,16,1,300,27852,21,118,0,27991,27096,595
20-07-2021,thiruvallur,774,61,70,0,765,112615,61,10,0,112686,110180,1741
20-07-2021,thiruvannamalai,927,74,97,4,900,50956,74,398,0,51428,49896,632
20-07-2021,thiruvarur,361,24,33,0,352,37446,24,38,0,37508,36793,363
20-07-2021,thoothukudi,341,12,18,0,335,54598,12,275,0,54885,54164,386
20-07-2021,tirunelveli,188,27,13,0,202,47135,27,427,0,47589,46963,424
20-07-2021,tiruppur,1617,106,126,1,1596,86701,106,11,0,86818,84407,815
20-07-2021,trichy,1139,66,93,2,1110,71550,66,60,0,71676,69615,951
20-07-2021,vellore,445,35,41,1,438,46045,32,1636,3,47716,46190,1088
20-07-2021,villupuram,508,24,38,1,493,43244,24,174,0,43442,42612,337
20-07-2021,virudhunagar,362,18,32,0,348,45190,18,104,0,45312,44427,537
20-07-2021,airport surveillance (international),5,0,0,0,5,0,0,1008,0,1008,1002,1
20-07-2021,airport surveillance (domestic),0,0,0,0,0,0,0,1075,0,1075,1074,1
20-07-2021,railway surveillance,0,0,0,0,0,0,0,428,0,428,428,0
21-07-2021,ariyalur,292,18,24,0,286,15520,18,20,0,15558,15042,230
21-07-2021,chengalpattu,1346,102,118,0,1330,160828,102,5,0,160935,157217,2388
21-07-2021,chennai,1679,138,142,2,1673,536438,138,47,0,536623,526646,8304
21-07-2021,coimbatore,2649,183,306,1,2525,227233,183,51,0,227467,222801,2141
21-07-2021,cuddalore,924,79,74,0,929,59466,79,203,0,59748,58017,802
21-07-2021,dharmapuri,496,31,65,1,461,25527,31,216,0,25774,25082,231
21-07-2021,dindigul,217,23,11,0,229,31924,23,77,0,32024,31178,617
21-07-2021,erode,2011,141,213,3,1936,92090,141,94,0,92325,89763,626
21-07-2021,kallakurichi,709,44,54,0,699,28186,44,404,0,28634,27738,197
21-07-2021,kancheepuram,450,45,37,1,457,71244,45,4,0,71293,69635,1201
21-07-2021,kanyakumari,477,36,45,1,467,59645,36,124,0,59805,58324,1014
21-07-2021,karur,221,15,24,0,212,22442,15,47,0,22504,21942,350
21-07-2021,krishnagiri,472,28,48,0,452,40794,28,230,0,41052,40282,318
21-07-2021,madurai,358,30,43,0,345,73081,30,171,0,73282,71797,1140
21-07-2021,mayiladuthurai,306,28,26,0,308,20702,28,39,0,20769,20195,266
21-07-2021,nagapattinam,395,29,24,0,400,18309,29,53,0,18391,17705,286
21-07-2021,namakkal,798,59,83,1,773,46477,59,112,0,46648,45437,438
21-07-2021,nilgiris,864,52,78,0,838,29917,52,44,0,30013,29002,173
21-07-2021,perambalur,181,11,9,0,183,11387,11,3,0,11401,11003,215
21-07-2021,pudukottai,388,20,31,1,376,27776,20,35,0,27831,27099,356
21-07-2021,ramanathapuram,152,12,10,1,153,19786,12,135,0,19933,19434,346
21-07-2021,ranipet,362,27,33,0,356,41656,27,49,0,41732,40638,738
21-07-2021,salem,1692,119,154,4,1653,91842,119,436,0,92397,89210,1534
21-07-2021,sivagangai,387,22,18,1,390,18433,22,108,0,18563,17978,195
21-07-2021,tenkasi,155,12,14,0,153,26639,12,58,0,26709,26079,477
21-07-2021,thanjavur,1629,90,137,0,1582,66789,90,22,0,66901,64485,834
21-07-2021,theni,261,14,17,0,258,42750,14,45,0,42809,42040,511
21-07-2021,thirupathur,300,18,19,2,297,27873,18,118,0,28009,27115,597
21-07-2021,thiruvallur,770,69,76,0,763,112681,69,10,0,112760,110256,1741
21-07-2021,thiruvannamalai,900,65,92,1,872,51030,65,398,0,51493,49988,633
21-07-2021,thiruvarur,356,21,29,0,348,37474,21,38,0,37533,36822,363
21-07-2021,thoothukudi,325,15,14,1,325,54600,15,275,0,54890,54178,387
21-07-2021,tirunelveli,202,32,11,0,223,47162,32,427,0,47621,46974,424
21-07-2021,tiruppur,1597,97,132,0,1562,86808,97,11,0,86916,84539,815
21-07-2021,trichy,1112,71,98,3,1082,71618,71,60,0,71749,69713,954
21-07-2021,vellore,438,38,46,2,428,46077,28,1639,10,47754,46236,1090
21-07-2021,villupuram,493,34,32,0,495,43268,34,174,0,43476,42644,337
21-07-2021,virudhunagar,348,17,36,1,328,45208,17,104,0,45329,44463,538
21-07-2021,airport surveillance (international),5,5,0,0,10,0,0,1008,5,1013,1002,1
21-07-2021,airport surveillance (domestic),0,1,0,0,1,0,0,1075,1,1076,1074,1
21-07-2021,railway surveillance,0,0,0,0,0,0,0,428,0,428,428,0
22-07-2021,ariyalur,286,23,26,0,283,15538,23,20,0,15581,15068,230
22-07-2021,chengalpattu,1330,98,124,1,1303,160930,98,5,0,161033,157341,2389
22-07-2021,chennai,1673,133,147,1,1658,536576,133,47,0,536756,526793,8305
22-07-2021,coimbatore,2526,180,312,6,2388,227417,180,51,0,227648,223113,2147
22-07-2021,cuddalore,930,74,83,0,921,59547,74,203,0,59824,58100,803
22-07-2021,dharmapuri,461,40,61,0,440,25558,40,216,0,25814,25143,231
22-07-2021,dindigul,229,20,14,0,235,31947,20,77,0,32044,31192,617
22-07-2021,erode,1926,137,205,0,1858,92221,137,94,0,92452,89968,626
22-07-2021,kallakurichi,699,43,51,0,691,28230,43,404,0,28677,27789,197
22-07-2021,kancheepuram,458,41,39,0,460,71290,41,4,0,71335,69674,1201
22-07-2021,kanyakumari,459,43,41,0,461,59673,43,124,0,59840,58365,1014
22-07-2021,karur,212,14,22,0,204,22457,14,47,0,22518,21964,350
22-07-2021,krishnagiri,454,22,43,2,431,40824,22,230,0,41076,40325,320
22-07-2021,madurai,342,28,41,0,329,73108,28,171,0,73307,71838,1140
22-07-2021,mayiladuthurai,313,24,25,0,312,20734,24,39,0,20797,20220,265
22-07-2021,nagapattinam,396,32,27,0,401,18334,32,53,0,18419,17732,286
22-07-2021,namakkal,775,52,102,0,725,46538,52,112,0,46702,45539,438
22-07-2021,nilgiris,838,60,82,0,816,29969,60,44,0,30073,29084,173
22-07-2021,perambalur,183,9,13,0,179,11398,9,3,0,11410,11016,215
22-07-2021,pudukottai,378,31,34,1,374,27798,31,35,0,27864,27133,357
22-07-2021,ramanathapuram,154,11,11,2,152,19799,11,135,0,19945,19445,348
22-07-2021,ranipet,357,25,36,1,345,41684,25,49,0,41758,40674,739
22-07-2021,salem,1656,113,142,0,1627,91964,113,436,0,92513,89352,1534
22-07-2021,sivagangai,390,19,21,0,388,18455,19,108,0,18582,17999,195
22-07-2021,tenkasi,154,10,13,1,150,26652,10,58,0,26720,26092,478
22-07-2021,thanjavur,1574,102,134,3,1539,66871,102,22,0,66995,64619,837
22-07-2021,theni,258,12,21,2,247,42764,12,45,0,42821,42061,513
22-07-2021,thirupathur,294,29,17,0,306,27888,29,118,0,28035,27132,597
22-07-2021,thiruvallur,758,61,79,2,738,112745,61,10,0,112816,110335,1743
22-07-2021,thiruvannamalai,872,60,96,2,834,51095,60,398,0,51553,50084,635
22-07-2021,thiruvarur,355,27,27,1,354,37502,27,38,0,37567,36849,364
22-07-2021,thoothukudi,329,17,18,1,327,54619,17,275,0,54911,54196,388
22-07-2021,tirunelveli,226,30,15,0,241,47197,30,427,0,47654,46989,424
22-07-2021,tiruppur,1567,94,126,0,1535,86910,94,11,0,87015,84665,815
22-07-2021,trichy,1083,68,104,2,1045,71690,68,60,0,71818,69817,956
22-07-2021,vellore,429,37,51,1,414,46106,36,1649,1,47792,46287,1091
22-07-2021,villupuram,495,38,38,0,495,43302,38,174,0,43514,42682,337
22-07-2021,virudhunagar,328,15,34,0,309,45225,15,104,0,45344,44497,538
22-07-2021,airport surveillance (international),10,0,0,0,10,0,0,1013,0,1013,1002,1
22-07-2021,airport surveillance (domestic),1,0,0,0,1,0,0,1076,0,1076,1074,1
22-07-2021,railway surveillance,0,0,0,0,0,0,0,428,0,428,428,0
23-07-2021,ariyalur,287,21,29,0,279,15565,21,20,0,15606,15097,230
23-07-2021,chengalpattu,1303,96,131,1,1267,161028,96,5,0,161129,157472,2390
23-07-2021,chennai,1655,130,152,0,1633,536706,130,47,0,536883,526945,8305
23-07-2021,coimbatore,2388,177,268,4,2293,227597,177,51,0,227825,223381,2151
23-07-2021,cuddalore,915,71,94,0,892,59615,71,203,0,59889,58194,803
23-07-2021,dharmapuri,440,39,63,1,415,25598,39,216,0,25853,25206,232
23-07-2021,dindigul,232,19,13,0,238,31964,19,77,0,32060,31205,617
23-07-2021,erode,1849,135,211,0,1773,92349,135,94,0,92578,90179,626
23-07-2021,kallakurichi,691,41,72,0,660,28273,41,404,0,28718,27861,197
23-07-2021,kancheepuram,464,40,48,0,456,71335,40,4,0,71379,69722,1201
23-07-2021,kanyakumari,461,40,36,0,465,59716,40,124,0,59880,58401,1014
23-07-2021,karur,200,12,18,1,193,22467,12,47,0,22526,21982,351
23-07-2021,krishnagiri,431,20,49,1,401,40846,20,230,0,41096,40374,321
23-07-2021,madurai,325,27,33,0,319,73132,27,171,0,73330,71871,1140
23-07-2021,mayiladuthurai,312,25,27,2,308,20758,25,39,0,20822,20247,267
23-07-2021,nagapattinam,405,29,31,1,402,18370,29,53,0,18452,17763,287
23-07-2021,namakkal,728,49,97,1,679,46593,49,112,0,46754,45636,439
23-07-2021,nilgiris,816,58,93,1,780,30029,58,44,0,30131,29177,174
23-07-2021,perambalur,179,8,10,2,175,11407,8,3,0,11418,11026,217
23-07-2021,pudukottai,375,30,31,3,371,27830,30,35,0,27895,27164,360
23-07-2021,ramanathapuram,152,10,12,0,150,19810,10,135,0,19955,19457,348
23-07-2021,ranipet,344,24,31,0,337,41708,24,49,0,41781,40705,739
23-07-2021,salem,1632,110,147,0,1595,92082,110,436,0,92628,89499,1534
23-07-2021,sivagangai,392,21,23,0,390,18478,21,108,0,18607,18022,195
23-07-2021,tenkasi,150,11,11,0,150,26662,11,58,0,26731,26103,478
23-07-2021,thanjavur,1537,98,141,1,1493,66971,98,22,0,67091,64760,838
23-07-2021,theni,248,10,24,0,234,42777,10,45,0,42832,42085,513
23-07-2021,thirupathur,307,27,21,1,312,27918,27,118,0,28063,27153,598
23-07-2021,thiruvallur,736,59,72,1,722,112804,59,10,0,112873,110407,1744
23-07-2021,thiruvannamalai,835,58,87,0,806,51156,58,398,0,51612,50171,635
23-07-2021,thiruvarur,351,25,29,0,347,37526,25,38,0,37589,36878,364
23-07-2021,thoothukudi,327,26,22,1,330,54636,26,275,0,54937,54218,389
23-07-2021,tirunelveli,241,36,12,0,265,47227,36,427,0,47690,47001,424
23-07-2021,tiruppur,1539,92,140,0,1491,87008,92,11,0,87111,84805,815
23-07-2021,trichy,1047,66,113,0,1000,71760,66,60,0,71886,69930,956
23-07-2021,vellore,414,35,49,1,399,46142,34,1650,1,47827,46336,1092
23-07-2021,villupuram,498,37,41,1,493,43343,37,174,0,43554,42723,338
23-07-2021,virudhunagar,309,17,32,0,294,45240,17,104,0,45361,44529,538
23-07-2021,airport surveillance (international),10,0,3,0,7,0,0,1013,0,1013,1005,1
23-07-2021,airport surveillance (domestic),1,1,0,0,2,0,0,1076,1,1077,1074,1
23-07-2021,railway surveillance,0,0,0,0,0,0,0,428,0,428,428,0
24-07-2021,ariyalur,280,19,31,0,268,15587,19,20,0,15626,15128,230
24-07-2021,chengalpattu,1268,95,138,2,1223,161125,95,5,0,161225,157610,2392
24-07-2021,chennai,1635,127,157,1,1604,536839,127,47,0,537013,527102,8307
24-07-2021,coimbatore,2293,175,243,3,2222,227774,175,51,0,228000,223624,2154
24-07-2021,cuddalore,892,68,97,0,863,59686,68,203,0,59957,58291,803
24-07-2021,dharmapuri,415,36,60,0,391,25637,36,216,0,25889,25266,232
24-07-2021,dindigul,238,18,19,1,236,31983,18,77,0,32078,31224,618
24-07-2021,erode,1771,132,217,2,1684,92482,132,94,0,92708,90396,628
24-07-2021,kallakurichi,658,39,79,0,618,28312,39,404,0,28755,27940,197
24-07-2021,kancheepuram,457,39,44,0,452,71376,39,4,0,71419,69766,1201
24-07-2021,kanyakumari,465,35,39,2,459,59756,35,124,0,59915,58440,1016
24-07-2021,karur,194,14,22,0,186,22480,14,47,0,22541,22004,351
24-07-2021,krishnagiri,401,27,53,0,375,40866,27,230,0,41123,40427,321
24-07-2021,madurai,318,26,29,1,314,73158,26,171,0,73355,71900,1141
24-07-2021,mayiladuthurai,317,24,32,0,309,20792,24,39,0,20855,20279,267
24-07-2021,nagapattinam,394,28,38,0,384,18391,28,53,0,18472,17801,287
24-07-2021,namakkal,678,48,91,1,634,46641,48,112,0,46801,45727,440
24-07-2021,nilgiris,780,61,93,3,745,30087,61,44,0,30192,29270,177
24-07-2021,perambalur,176,7,12,0,171,11416,7,3,0,11426,11038,217
24-07-2021,pudukottai,373,38,39,0,372,27862,38,35,0,27935,27203,360
24-07-2021,ramanathapuram,150,12,13,0,149,19820,12,135,0,19967,19470,348
24-07-2021,ranipet,334,28,35,0,327,41729,28,49,0,41806,40740,739
24-07-2021,salem,1597,107,153,3,1548,92194,107,436,0,92737,89652,1537
24-07-2021,sivagangai,387,20,29,0,378,18496,20,108,0,18624,18051,195
24-07-2021,tenkasi,149,9,14,1,143,26672,9,58,0,26739,26117,479
24-07-2021,thanjavur,1486,96,148,1,1433,67062,96,22,0,67180,64908,839
24-07-2021,theni,234,11,26,0,219,42787,11,45,0,42843,42111,513
24-07-2021,thirupathur,312,31,28,0,315,27945,31,118,0,28094,27181,598
24-07-2021,thiruvallur,722,58,66,2,712,112862,58,10,0,112930,110473,1745
24-07-2021,thiruvannamalai,807,56,81,0,782,51215,56,398,0,51669,50252,635
24-07-2021,thiruvarur,351,23,32,0,342,37555,23,38,0,37616,36910,364
24-07-2021,thoothukudi,330,23,34,0,319,54662,23,275,0,54960,54252,389
24-07-2021,tirunelveli,265,33,15,0,283,47263,33,427,0,47723,47016,424
24-07-2021,tiruppur,1492,98,143,0,1447,87101,98,11,0,87210,84948,815
24-07-2021,trichy,1002,64,106,0,960,71828,64,60,0,71952,70036,956
24-07-2021,vellore,399,34,43,2,388,46176,31,1651,3,47861,46379,1094
24-07-2021,villupuram,493,39,48,1,483,43380,39,174,0,43593,42771,339
24-07-2021,virudhunagar,294,21,36,1,278,45257,21,104,0,45382,44565,539
24-07-2021,airport surveillance (international),7,0,0,0,7,0,0,1013,0,1013,1005,1
24-07-2021,airport surveillance (domestic),2,0,0,0,2,0,0,1077,0,1077,1074,1
24-07-2021,railway surveillance,0,0,0,0,0,0,0,428,0,428,428,0
25-07-2021,ariyalur,267,15,35,2,245,15605,15,20,0,15640,15163,232
25-07-2021,chengalpattu,1222,99,122,3,1196,161219,99,5,0,161323,157732,2395
25-07-2021,chennai,1589,126,161,3,1551,536951,126,47,0,537124,527263,8310
25-07-2021,coimbatore,2222,169,254,4,2133,227949,169,51,0,228169,223878,2158
25-07-2021,cuddalore,865,75,92,0,848,59756,75,203,0,60034,58383,803
25-07-2021,dharmapuri,391,32,55,0,368,25673,32,216,0,25921,25321,232
25-07-2021,dindigul,235,22,16,0,241,32000,22,77,0,32099,31240,618
25-07-2021,erode,1679,130,223,0,1586,92609,130,94,0,92833,90619,628
25-07-2021,kallakurichi,619,42,65,0,596,28352,42,404,0,28798,28005,197
25-07-2021,kancheepuram,455,35,41,0,449,71418,35,4,0,71457,69807,1201
25-07-2021,kanyakumari,459,31,32,0,458,59791,31,124,0,59946,58472,1016
25-07-2021,karur,186,12,18,0,180,22494,12,47,0,22553,22022,351
25-07-2021,krishnagiri,373,23,45,0,351,40891,23,230,0,41144,40472,321
25-07-2021,madurai,314,22,23,1,312,73184,22,171,0,73377,71923,1142
25-07-2021,mayiladuthurai,316,20,28,1,307,20822,20,39,0,20881,20307,267
25-07-2021,nagapattinam,377,35,31,0,381,18413,35,53,0,18501,17832,288
25-07-2021,namakkal,636,51,85,0,602,46691,51,112,0,46854,45812,440
25-07-2021,nilgiris,745,54,81,0,718,30148,54,44,0,30246,29351,177
25-07-2021,perambalur,172,6,11,0,167,11424,6,3,0,11433,11049,217
25-07-2021,pudukottai,376,35,33,2,376,27904,35,35,0,27974,27236,362
25-07-2021,ramanathapuram,149,10,15,0,144,19832,10,135,0,19977,19485,348
25-07-2021,ranipet,327,30,26,0,331,41757,30,49,0,41836,40766,739
25-07-2021,salem,1546,105,145,0,1506,92299,105,436,0,92840,89797,1537
25-07-2021,sivagangai,376,23,22,0,377,18514,23,108,0,18645,18073,195
25-07-2021,tenkasi,144,11,11,0,144,26682,11,58,0,26751,26128,479
25-07-2021,thanjavur,1432,98,131,1,1398,67157,98,22,0,67277,65039,840
25-07-2021,theni,219,10,28,1,200,42798,10,45,0,42853,42139,514
25-07-2021,thirupathur,318,29,32,0,315,27979,29,118,0,28126,27213,598
25-07-2021,thiruvallur,714,70,69,3,712,112922,70,10,0,113002,110542,1748
25-07-2021,thiruvannamalai,782,72,75,0,779,51271,72,398,0,51741,50327,635
25-07-2021,thiruvarur,345,21,29,0,337,37581,21,38,0,37640,36939,364
25-07-2021,thoothukudi,318,21,36,0,303,54684,21,275,0,54980,54288,389
25-07-2021,tirunelveli,283,27,12,0,298,47296,27,427,0,47750,47028,424
25-07-2021,tiruppur,1449,93,151,0,1391,87201,93,11,0,87305,85099,815
25-07-2021,trichy,960,62,98,0,924,71892,62,60,0,72014,70134,956
25-07-2021,vellore,390,32,39,0,383,46209,32,1654,0,47895,46418,1094
25-07-2021,villupuram,487,41,42,1,485,43423,41,174,0,43638,42813,340
25-07-2021,virudhunagar,279,18,35,0,262,45279,18,104,0,45401,44600,539
25-07-2021,airport surveillance (international),7,0,0,0,7,0,0,1013,0,1013,1005,1
25-07-2021,airport surveillance (domestic),2,1,0,0,3,0,0,1077,1,1078,1074,1
25-07-2021,railway surveillance,0,0,0,0,0,0,0,428,0,428,428,0
26-07-2021,ariyalur,245,23,28,0,240,15620,23,20,0,15663,15191,232
26-07-2021,chengalpattu,1194,96,135,1,1154,161316,96,5,0,161417,157867,2396
26-07-2021,chennai,1554,122,172,2,1502,537080,122,47,0,537249,527435,8312
26-07-2021,coimbatore,2134,164,266,4,2028,228119,164,51,0,228334,224144,2162
26-07-2021,cuddalore,848,73,84,0,837,59831,73,203,0,60107,58467,803
26-07-2021,dharmapuri,368,29,36,0,361,25705,29,216,0,25950,25357,232
26-07-2021,dindigul,239,20,25,0,234,32020,20,77,0,32117,31265,618
26-07-2021,erode,1578,127,211,0,1494,92731,127,94,0,92952,90830,628
26-07-2021,kallakurichi,597,40,48,0,589,28395,40,404,0,28839,28053,197
26-07-2021,kancheepuram,450,34,37,0,447,71454,34,4,0,71492,69844,1201
26-07-2021,kanyakumari,458,28,36,2,448,59822,28,124,0,59974,58508,1018
26-07-2021,karur,183,11,11,0,183,22509,11,47,0,22567,22033,351
26-07-2021,krishnagiri,351,31,32,0,350,40914,31,230,0,41175,40504,321
26-07-2021,madurai,310,21,21,0,310,73204,21,171,0,73396,71944,1142
26-07-2021,mayiladuthurai,311,18,23,0,306,20846,18,39,0,20903,20330,267
26-07-2021,nagapattinam,376,31,29,0,378,18443,31,53,0,18527,17861,288
26-07-2021,namakkal,607,48,89,0,566,46747,48,112,0,46907,45901,440
26-07-2021,nilgiris,718,58,75,0,701,30202,58,44,0,30304,29426,177
26-07-2021,perambalur,168,5,9,2,162,11431,5,3,0,11439,11058,219
26-07-2021,pudukottai,374,34,28,1,379,27937,34,35,0,28006,27264,363
26-07-2021,ramanathapuram,144,11,8,0,147,19842,11,135,0,19988,19493,348
26-07-2021,ranipet,333,25,27,0,331,41789,25,49,0,41863,40793,739
26-07-2021,salem,1506,102,158,2,1448,92404,102,436,0,92942,89955,1539
26-07-2021,sivagangai,377,20,18,0,379,18537,20,108,0,18665,18091,195
26-07-2021,tenkasi,143,27,13,0,157,26692,27,58,0,26777,26141,479
26-07-2021,thanjavur,1399,103,127,4,1371,67256,103,22,0,67381,65166,844
26-07-2021,theni,200,11,22,0,189,42808,11,45,0,42864,42161,514
26-07-2021,thirupathur,316,26,31,1,310,28009,26,118,0,28153,27244,599
26-07-2021,thiruvallur,708,68,65,1,710,112988,68,10,0,113066,110607,1749
26-07-2021,thiruvannamalai,780,69,71,1,777,51344,69,398,0,51811,50398,636
26-07-2021,thiruvarur,338,22,24,1,335,37603,22,38,0,37663,36963,365
26-07-2021,thoothukudi,303,19,33,1,288,54705,19,275,0,54999,54321,390
26-07-2021,tirunelveli,299,24,18,1,304,47324,24,427,0,47775,47046,425
26-07-2021,tiruppur,1394,90,162,1,1321,87297,90,11,0,87398,85261,816
26-07-2021,trichy,925,63,87,1,900,71955,63,60,0,72078,70221,957
26-07-2021,vellore,379,30,35,0,374,46237,30,1654,0,47921,46453,1094
26-07-2021,villupuram,485,43,38,0,490,43464,43,174,0,43681,42851,340
26-07-2021,virudhunagar,262,19,29,0,252,45297,19,104,0,45420,44629,539
26-07-2021,airport surveillance (international),7,0,0,0,7,0,0,1013,0,1013,1005,1
26-07-2021,airport surveillance (domestic),3,0,0,0,3,0,0,1078,0,1078,1074,1
26-07-2021,railway surveillance,0,0,0,0,0,0,0,428,0,428,428,0
27-07-2021,ariyalur,242,18,29,2,229,15645,18,20,0,15683,15220,234
27-07-2021,chengalpattu,1149,95,121,3,1120,161407,95,5,0,161507,157988,2399
27-07-2021,chennai,1500,139,159,0,1480,537200,139,47,0,537386,527594,8312
27-07-2021,coimbatore,2029,169,248,3,1947,228284,169,51,0,228504,224392,2165
27-07-2021,cuddalore,839,70,89,1,819,59906,70,203,0,60179,58556,804
27-07-2021,dharmapuri,361,36,34,1,362,25734,36,216,0,25986,25391,233
27-07-2021,dindigul,232,14,22,0,224,32038,14,77,0,32129,31287,618
27-07-2021,erode,1488,132,208,2,1410,92852,132,94,0,93078,91038,630
27-07-2021,kallakurichi,590,36,57,0,569,28436,36,404,0,28876,28110,197
27-07-2021,kancheepuram,449,42,41,0,450,71490,42,4,0,71536,69885,1201
27-07-2021,kanyakumari,443,24,32,0,435,59845,24,124,0,59993,58540,1018
27-07-2021,karur,181,14,13,0,182,22518,14,47,0,22579,22046,351
27-07-2021,krishnagiri,350,28,36,0,342,40945,28,230,0,41203,40540,321
27-07-2021,madurai,313,25,23,1,314,73228,25,171,0,73424,71967,1143
27-07-2021,mayiladuthurai,315,25,25,0,315,20873,25,39,0,20937,20356,267
27-07-2021,nagapattinam,371,24,24,0,371,18467,24,53,0,18544,17884,288
27-07-2021,namakkal,568,47,62,2,551,46797,47,112,0,46956,45963,442
27-07-2021,nilgiris,701,50,89,1,661,30260,50,44,0,30354,29515,178
27-07-2021,perambalur,162,6,12,1,155,11436,6,3,0,11445,11070,220
27-07-2021,pudukottai,377,30,25,0,382,27969,30,35,0,28034,27289,363
27-07-2021,ramanathapuram,147,9,10,0,146,19853,9,135,0,19997,19503,348
27-07-2021,ranipet,331,23,31,0,323,41814,23,49,0,41886,40824,739
27-07-2021,salem,1450,98,147,1,1400,92508,98,436,0,93042,90102,1540
27-07-2021,sivagangai,383,27,24,1,385,18561,27,108,0,18696,18115,196
27-07-2021,tenkasi,156,22,18,0,160,26718,22,58,0,26798,26159,479
27-07-2021,thanjavur,1363,102,139,1,1325,67351,102,22,0,67475,65305,845
27-07-2021,theni,190,10,17,0,183,42820,10,45,0,42875,42178,514
27-07-2021,thirupathur,308,23,27,1,303,28033,23,118,0,28174,27271,600
27-07-2021,thiruvallur,711,67,58,2,718,113057,67,10,0,113134,110665,1751
27-07-2021,thiruvannamalai,777,60,74,0,763,51413,60,398,0,51871,50472,636
27-07-2021,thiruvarur,336,27,27,1,335,37626,27,38,0,37691,36990,366
27-07-2021,thoothukudi,290,12,28,1,273,54726,12,275,0,55013,54349,391
27-07-2021,tirunelveli,308,28,14,1,321,47352,28,427,0,47807,47060,426
27-07-2021,tiruppur,1323,87,154,1,1255,87389,87,11,0,87487,85415,817
27-07-2021,trichy,902,59,92,1,868,72020,59,60,0,72139,70313,958
27-07-2021,vellore,375,33,36,0,372,46268,32,1654,1,47955,46489,1094
27-07-2021,villupuram,490,39,42,0,487,43507,39,174,0,43720,42893,340
27-07-2021,virudhunagar,252,17,24,1,244,45316,17,104,0,45437,44653,540
27-07-2021,airport surveillance (international),7,0,1,0,6,0,0,1013,0,1013,1006,1
27-07-2021,airport surveillance (domestic),3,0,0,0,3,0,0,1078,0,1078,1074,1
27-07-2021,railway surveillance,0,0,0,0,0,0,0,428,0,428,428,0
28-07-2021,ariyalur,231,20,27,1,223,15665,20,20,0,15705,15247,235
28-07-2021,chengalpattu,1119,117,114,1,1121,161501,117,5,0,161623,158102,2400
28-07-2021,chennai,1476,164,163,3,1474,537335,164,47,0,537546,527757,8315
28-07-2021,coimbatore,1949,179,207,4,1917,228455,179,51,0,228685,224599,2169
28-07-2021,cuddalore,819,62,86,3,792,59976,62,203,0,60241,58642,807
28-07-2021,dharmapuri,363,31,41,0,353,25771,31,216,0,26018,25432,233
28-07-2021,dindigul,227,17,27,0,217,32055,17,77,0,32149,31314,618
28-07-2021,erode,1399,140,186,2,1351,92973,140,94,0,93207,91224,632
28-07-2021,kallakurichi,569,45,71,1,542,28472,45,404,0,28921,28181,198
28-07-2021,kancheepuram,449,40,45,1,443,71531,40,4,0,71575,69930,1202
28-07-2021,kanyakumari,435,20,38,0,417,59869,20,124,0,60013,58578,1018
28-07-2021,karur,182,19,21,0,180,22532,19,47,0,22598,22067,351
28-07-2021,krishnagiri,343,34,39,1,337,40974,34,230,0,41238,40579,322
28-07-2021,madurai,312,21,28,0,305,73251,21,171,0,73443,71995,1143
28-07-2021,mayiladuthurai,319,22,31,0,310,20902,22,39,0,20963,20386,267
28-07-2021,nagapattinam,369,29,26,0,372,18489,29,53,0,18571,17911,288
28-07-2021,namakkal,552,50,67,1,534,46845,50,112,0,47007,46030,443
28-07-2021,nilgiris,661,45,93,1,612,30310,45,44,0,30399,29608,179
28-07-2021,perambalur,156,7,15,1,147,11443,7,3,0,11453,11085,221
28-07-2021,pudukottai,387,27,32,0,382,28004,27,35,0,28066,27321,363
28-07-2021,ramanathapuram,146,7,13,0,140,19862,7,135,0,20004,19516,348
28-07-2021,ranipet,319,22,37,0,304,41833,22,49,0,41904,40861,739
28-07-2021,salem,1406,92,156,5,1337,92612,92,436,0,93140,90258,1545
28-07-2021,sivagangai,385,23,33,0,375,18588,23,108,0,18719,18148,196
28-07-2021,tenkasi,160,18,21,0,157,26740,18,58,0,26816,26180,479
28-07-2021,thanjavur,1310,78,147,1,1240,67438,78,22,0,67538,65452,846
28-07-2021,theni,183,13,19,0,177,42830,13,45,0,42888,42197,514
28-07-2021,thirupathur,303,21,31,0,293,28056,21,118,0,28195,27302,600
28-07-2021,thiruvallur,723,62,71,0,714,113129,62,10,0,113201,110736,1751
28-07-2021,thiruvannamalai,760,50,72,0,738,51470,50,398,0,51918,50544,636
28-07-2021,thiruvarur,341,25,32,0,334,37659,25,38,0,37722,37022,366
28-07-2021,thoothukudi,273,14,26,0,261,54738,14,275,0,55027,54375,391
28-07-2021,tirunelveli,321,23,18,0,326,47380,23,427,0,47830,47078,426
28-07-2021,tiruppur,1258,80,148,1,1189,87479,80,11,0,87570,85563,818
28-07-2021,trichy,864,55,95,2,822,72075,55,60,0,72190,70408,960
28-07-2021,vellore,376,28,39,0,365,46304,27,1655,1,47987,46528,1094
28-07-2021,villupuram,490,41,53,0,478,43549,41,174,0,43764,42946,340
28-07-2021,virudhunagar,244,15,26,0,233,45333,15,104,0,45452,44679,540
28-07-2021,airport surveillance (international),6,0,0,0,6,0,0,1013,0,1013,1006,1
28-07-2021,airport surveillance (domestic),3,0,0,0,3,0,0,1078,0,1078,1074,1
28-07-2021,railway surveillance,0,0,0,0,0,0,0,428,0,428,428,0
29-07-2021,ariyalur,224,23,25,0,222,15686,23,20,0,15729,15272,235
29-07-2021,chengalpattu,1121,113,109,0,1125,161618,113,5,0,161736,158211,2400
29-07-2021,chennai,1479,181,151,1,1508,537504,181,47,0,537732,527908,8316
29-07-2021,coimbatore,1918,188,198,3,1905,228635,188,51,0,228874,224797,2172
29-07-2021,cuddalore,792,68,82,2,776,60038,68,203,0,60309,58724,809
29-07-2021,dharmapuri,352,30,39,1,342,25802,30,216,0,26048,25471,235
29-07-2021,dindigul,216,12,21,1,206,32071,12,77,0,32160,31335,619
29-07-2021,erode,1347,166,144,1,1368,93109,166,94,0,93369,91368,633
29-07-2021,kallakurichi,541,49,55,0,535,28516,49,404,0,28969,28236,198
29-07-2021,kancheepuram,442,45,40,0,447,71570,45,4,0,71619,69970,1202
29-07-2021,kanyakumari,414,22,32,1,403,59886,22,124,0,60032,58610,1019
29-07-2021,karur,182,18,15,0,185,22553,18,47,0,22618,22082,351
29-07-2021,krishnagiri,336,38,36,0,338,41007,38,230,0,41275,40615,322
29-07-2021,madurai,304,19,22,0,301,73271,19,171,0,73461,72017,1143
29-07-2021,mayiladuthurai,315,20,19,1,315,20929,20,39,0,20988,20405,268
29-07-2021,nagapattinam,368,34,27,1,374,18514,34,53,0,18601,17938,289
29-07-2021,namakkal,532,60,45,1,546,46893,60,112,0,47065,46075,444
29-07-2021,nilgiris,611,40,87,0,564,30354,40,44,0,30438,29695,179
29-07-2021,perambalur,148,6,12,0,142,11451,6,3,0,11460,11097,221
29-07-2021,pudukottai,381,26,28,1,378,28030,26,35,0,28091,27349,364
29-07-2021,ramanathapuram,140,8,9,0,139,19869,8,135,0,20012,19525,348
29-07-2021,ranipet,306,20,34,1,291,41857,20,49,0,41926,40895,740
29-07-2021,salem,1339,95,161,3,1270,92705,95,436,0,93236,90419,1547
29-07-2021,sivagangai,376,27,26,0,377,18612,27,108,0,18747,18174,196
29-07-2021,tenkasi,154,15,15,1,153,26755,15,58,0,26828,26195,480
29-07-2021,thanjavur,1239,102,137,0,1204,67515,102,22,0,67639,65589,846
29-07-2021,theni,177,12,16,0,173,42843,12,45,0,42900,42213,514
29-07-2021,thirupathur,293,18,27,0,284,28077,18,118,0,28213,27329,600
29-07-2021,thiruvallur,712,69,69,0,712,113189,69,10,0,113268,110805,1751
29-07-2021,thiruvannamalai,740,54,64,1,729,51522,54,398,0,51974,50608,637
29-07-2021,thiruvarur,332,22,28,0,326,37682,22,38,0,37742,37050,366
29-07-2021,thoothukudi,263,17,21,2,257,54754,17,275,0,55046,54396,393
29-07-2021,tirunelveli,328,21,14,1,334,47405,21,427,0,47853,47092,427
29-07-2021,tiruppur,1191,78,143,3,1123,87561,78,11,0,87650,85706,821
29-07-2021,trichy,824,70,92,2,800,72132,70,60,0,72262,70500,962
29-07-2021,vellore,363,30,31,0,362,46329,29,1656,1,48015,46559,1094
29-07-2021,villupuram,478,30,49,0,459,43590,30,174,0,43794,42995,340
29-07-2021,virudhunagar,234,13,22,0,225,45349,13,104,0,45466,44701,540
29-07-2021,airport surveillance (international),6,0,0,0,6,0,0,1013,0,1013,1006,1
29-07-2021,airport surveillance (domestic),3,0,0,0,3,0,0,1078,0,1078,1074,1
29-07-2021,railway surveillance,0,0,0,0,0,0,0,428,0,428,428,0
30-07-2021,ariyalur,222,22,22,1,221,15709,22,20,0,15751,15294,236
30-07-2021,chengalpattu,1120,109,120,1,1108,161726,109,5,0,161840,158331,2401
30-07-2021,chennai,1512,215,156,2,1569,537689,215,47,0,537951,528064,8318
30-07-2021,coimbatore,1907,230,216,4,1917,228825,230,51,0,229106,225013,2176
30-07-2021,cuddalore,778,70,78,0,770,60108,70,203,0,60381,58802,809
30-07-2021,dharmapuri,342,28,31,0,339,25832,28,216,0,26076,25502,235
30-07-2021,dindigul,206,21,19,3,205,32083,21,77,0,32181,31354,622
30-07-2021,erode,1360,171,127,0,1404,93267,171,94,0,93532,91495,633
30-07-2021,kallakurichi,535,45,63,0,517,28565,45,404,0,29014,28299,198
30-07-2021,kancheepuram,448,43,46,1,444,71616,43,4,0,71663,70016,1203
30-07-2021,kanyakumari,404,32,36,0,400,59909,32,124,0,60065,58646,1019
30-07-2021,karur,188,12,19,0,181,22574,12,47,0,22633,22101,351
30-07-2021,krishnagiri,340,40,41,0,339,41047,37,230,3,41317,40656,322
30-07-2021,madurai,301,15,25,0,291,73290,15,171,0,73476,72042,1143
30-07-2021,mayiladuthurai,315,15,24,0,306,20949,15,39,0,21003,20429,268
30-07-2021,nagapattinam,375,33,23,0,385,18549,33,53,0,18635,17961,289
30-07-2021,namakkal,550,74,48,1,575,46957,74,112,0,47143,46123,445
30-07-2021,nilgiris,564,41,64,0,541,30394,41,44,0,30479,29759,179
30-07-2021,perambalur,143,8,17,0,134,11458,8,3,0,11469,11114,221
30-07-2021,pudukottai,377,20,33,0,364,28055,20,35,0,28110,27382,364
30-07-2021,ramanathapuram,139,13,12,1,139,19877,13,135,0,20025,19537,349
30-07-2021,ranipet,290,21,31,1,279,41876,21,49,0,41946,40926,741
30-07-2021,salem,1271,84,154,3,1198,92801,84,436,0,93321,90573,1550
30-07-2021,sivagangai,377,20,34,0,363,18639,20,108,0,18767,18208,196
30-07-2021,tenkasi,151,18,18,0,151,26768,18,58,0,26844,26213,480
30-07-2021,thanjavur,1202,105,144,1,1162,67615,105,22,0,67742,65733,847
30-07-2021,theni,173,14,18,0,169,42855,14,45,0,42914,42231,514
30-07-2021,thirupathur,284,13,23,1,273,28095,13,118,0,28226,27352,601
30-07-2021,thiruvallur,712,85,71,0,726,113258,85,10,0,113353,110876,1751
30-07-2021,thiruvannamalai,729,42,76,0,695,51576,42,398,0,52016,50684,637
30-07-2021,thiruvarur,325,28,31,1,321,37703,28,38,0,37769,37081,367
30-07-2021,thoothukudi,257,20,24,1,252,54771,20,275,0,55066,54420,394
30-07-2021,tirunelveli,337,19,16,0,340,47429,19,427,0,47875,47108,427
30-07-2021,tiruppur,1125,71,127,4,1065,87641,71,11,0,87723,85833,825
30-07-2021,trichy,797,85,97,0,785,72199,85,60,0,72344,70597,962
30-07-2021,vellore,358,24,34,0,348,46354,24,1657,0,48035,46593,1094
30-07-2021,villupuram,459,29,56,1,431,43620,29,174,0,43823,43051,341
30-07-2021,virudhunagar,225,12,19,0,218,45362,12,104,0,45478,44720,540
30-07-2021,airport surveillance (international),6,0,0,0,6,0,0,1013,0,1013,1006,1
30-07-2021,airport surveillance (domestic),3,0,0,0,3,0,0,1078,0,1078,1074,1
30-07-2021,railway surveillance,0,0,0,0,0,0,0,428,0,428,428,0
31-07-2021,ariyalur,218,21,26,0,213,15728,21,20,0,15769,15320,236
31-07-2021,chengalpattu,1109,122,115,0,1116,161836,122,5,0,161963,158446,2401
31-07-2021,chennai,1566,204,143,0,1627,537901,204,47,0,538152,528207,8318
31-07-2021,coimbatore,1918,246,223,1,1940,229056,246,51,0,229353,225236,2177
31-07-2021,cuddalore,771,68,81,2,756,60179,68,203,0,60450,58883,811
31-07-2021,dharmapuri,339,29,26,0,342,25860,29,216,0,26105,25528,235
31-07-2021,dindigul,203,13,17,0,199,32102,13,77,0,32192,31371,622
31-07-2021,erode,1401,165,104,0,1462,93435,165,94,0,93694,91599,633
31-07-2021,kallakurichi,517,52,68,0,501,28610,52,404,0,29066,28367,198
31-07-2021,kancheepuram,446,41,49,0,438,71661,41,4,0,71706,70065,1203
31-07-2021,kanyakumari,400,35,42,0,393,59941,35,124,0,60100,58688,1019
31-07-2021,karur,176,14,21,0,169,22581,14,47,0,22642,22122,351
31-07-2021,krishnagiri,339,42,43,0,338,41084,42,233,0,41359,40699,322
31-07-2021,madurai,291,16,23,1,283,73305,16,171,0,73492,72065,1144
31-07-2021,mayiladuthurai,328,16,28,1,315,20986,16,39,0,21041,20457,269
31-07-2021,nagapattinam,364,39,22,0,381,18561,39,53,0,18653,17983,289
31-07-2021,namakkal,577,61,42,3,593,47033,61,112,0,47206,46165,448
31-07-2021,nilgiris,541,45,46,0,540,30435,45,44,0,30524,29805,179
31-07-2021,perambalur,137,9,21,1,124,11469,9,3,0,11481,11135,222
31-07-2021,pudukottai,361,23,38,1,345,28072,23,35,0,28130,27420,365
31-07-2021,ramanathapuram,139,9,9,0,139,19890,9,135,0,20034,19546,349
31-07-2021,ranipet,280,17,29,0,268,41898,17,49,0,41964,40955,741
31-07-2021,salem,1200,73,132,4,1137,92887,73,436,0,93396,90705,1554
31-07-2021,sivagangai,363,22,40,1,344,18659,22,108,0,18789,18248,197
31-07-2021,tenkasi,152,11,10,0,153,26787,11,58,0,26856,26223,480
31-07-2021,thanjavur,1159,124,152,0,1131,67717,124,22,0,67863,65885,847
31-07-2021,theni,169,11,21,0,159,42869,11,45,0,42925,42252,514
31-07-2021,thirupathur,275,17,26,0,266,28110,17,118,0,28245,27378,601
31-07-2021,thiruvallur,724,89,76,1,736,113341,89,10,0,113440,110952,1752
31-07-2021,thiruvannamalai,697,43,74,0,666,51620,43,398,0,52061,50758,637
31-07-2021,thiruvarur,323,53,38,0,338,37733,53,38,0,37824,37119,367
31-07-2021,thoothukudi,249,15,26,0,238,54788,15,275,0,55078,54446,394
31-07-2021,tirunelveli,342,23,22,1,342,47450,23,427,0,47900,47130,428
31-07-2021,tiruppur,1065,78,133,6,1004,87712,78,11,0,87801,85966,831
31-07-2021,trichy,793,70,110,2,751,72292,70,60,0,72422,70707,964
31-07-2021,vellore,344,26,31,1,338,46374,26,1657,0,48057,46624,1095
31-07-2021,villupuram,431,28,47,0,412,43649,28,174,0,43851,43098,341
31-07-2021,virudhunagar,218,16,24,0,210,45374,16,104,0,45494,44744,540
31-07-2021,airport surveillance (international),6,0,0,0,6,0,0,1013,0,1013,1006,1
31-07-2021,airport surveillance (domestic),3,0,0,0,3,0,0,1078,0,1078,1074,1
31-07-2021,railway surveillance,0,0,0,0,0,0,0,428,0,428,428,0
01-08-2021,ariyalur,213,25,23,0,215,15749,25,20,0,15794,15343,236
01-08-2021,chengalpattu,1116,133,104,2,1143,161958,133,5,0,162096,158550,2403
01-08-2021,chennai,1626,175,126,0,1675,538104,175,47,0,538326,528333,8318
01-08-2021,coimbatore,1940,230,208,1,1961,229302,230,51,0,229583,225444,2178
01-08-2021,cuddalore,756,64,73,0,747,60247,64,203,0,60514,58956,811
01-08-2021,dharmapuri,344,30,21,0,353,25891,30,216,0,26137,25549,235
01-08-2021,dindigul,198,15,14,0,199,32114,15,77,0,32206,31385,622
01-08-2021,erode,1461,180,118,0,1523,93599,180,94,0,93873,91717,633
01-08-2021,kallakurichi,501,51,61,0,491,28662,51,404,0,29117,28428,198
01-08-2021,kancheepuram,440,43,47,1,435,71704,43,4,0,71751,70112,1204
01-08-2021,kanyakumari,393,31,54,1,369,59976,31,124,0,60131,58742,1020
01-08-2021,karur,169,13,26,0,156,22595,13,47,0,22655,22148,351
01-08-2021,krishnagiri,338,34,48,0,324,41126,34,233,0,41393,40747,322
01-08-2021,madurai,283,24,29,1,277,73321,24,171,0,73516,72094,1145
01-08-2021,mayiladuthurai,317,15,36,0,296,21004,15,39,0,21058,20493,269
01-08-2021,nagapattinam,381,45,25,0,401,18600,45,53,0,18698,18008,289
01-08-2021,namakkal,593,58,53,3,595,47094,58,112,0,47264,46218,451
01-08-2021,nilgiris,540,49,47,0,542,30480,49,44,0,30573,29852,179
01-08-2021,perambalur,125,8,17,1,115,11479,8,3,0,11490,11152,223
01-08-2021,pudukottai,346,25,35,0,336,28096,25,35,0,28156,27455,365
01-08-2021,ramanathapuram,139,10,11,0,138,19899,10,135,0,20044,19557,349
01-08-2021,ranipet,271,15,26,1,259,41918,15,49,0,41982,40981,742
01-08-2021,salem,1140,79,121,4,1094,92963,79,436,0,93478,90826,1558
01-08-2021,sivagangai,344,23,57,0,310,18681,23,108,0,18812,18305,197
01-08-2021,tenkasi,148,10,8,0,150,26793,10,58,0,26861,26231,480
01-08-2021,thanjavur,1123,126,163,1,1085,67833,126,22,0,67981,66048,848
01-08-2021,theni,159,12,18,0,153,42880,12,45,0,42937,42270,514
01-08-2021,thirupathur,265,18,31,0,252,28126,18,118,0,28262,27409,601
01-08-2021,thiruvallur,736,95,72,1,758,113430,95,10,0,113535,111024,1753
01-08-2021,thiruvannamalai,666,38,79,1,624,51663,38,398,0,52099,50837,638
01-08-2021,thiruvarur,342,50,29,0,363,37790,50,38,0,37878,37148,367
01-08-2021,thoothukudi,241,14,21,1,233,54806,14,275,0,55095,54467,395
01-08-2021,tirunelveli,342,17,27,0,332,47473,17,427,0,47917,47157,428
01-08-2021,tiruppur,1003,95,129,5,964,87789,95,11,0,87895,86095,836
01-08-2021,trichy,751,69,104,2,714,72362,69,60,0,72491,70811,966
01-08-2021,vellore,333,29,29,0,333,46395,27,1657,2,48081,46653,1095
01-08-2021,villupuram,412,27,41,0,398,43677,27,174,0,43878,43139,341
01-08-2021,virudhunagar,212,15,20,0,207,45392,15,104,0,45511,44764,540
01-08-2021,airport surveillance (international),6,0,4,0,2,0,0,1013,0,1013,1010,1
01-08-2021,airport surveillance (domestic),3,0,1,0,2,0,0,1078,0,1078,1075,1
01-08-2021,railway surveillance,0,0,0,0,0,0,0,428,0,428,428,0
02-08-2021,ariyalur,215,23,19,0,219,15774,23,20,0,15817,15362,236
02-08-2021,chengalpattu,1135,127,97,2,1163,162083,127,5,0,162215,158647,2405
02-08-2021,chennai,1681,189,132,3,1735,538285,189,47,0,538521,528465,8321
02-08-2021,coimbatore,1963,219,174,0,2008,229534,219,51,0,229804,225618,2178
02-08-2021,cuddalore,746,60,75,0,731,60310,60,203,0,60573,59031,811
02-08-2021,dharmapuri,353,28,26,0,355,25921,28,216,0,26165,25575,235
02-08-2021,dindigul,197,18,22,1,192,32127,18,77,0,32222,31407,623
02-08-2021,erode,1524,168,124,0,1568,93780,168,94,0,94042,91841,633
02-08-2021,kallakurichi,491,43,53,0,481,28713,43,404,0,29160,28481,198
02-08-2021,kancheepuram,439,42,42,0,439,71751,42,4,0,71797,70154,1204
02-08-2021,kanyakumari,369,27,46,0,350,60007,27,124,0,60158,58788,1020
02-08-2021,karur,154,16,21,0,149,22606,16,47,0,22669,22169,351
02-08-2021,krishnagiri,324,31,40,0,315,41160,31,233,0,41424,40787,322
02-08-2021,madurai,278,23,36,0,265,73346,23,171,0,73540,72130,1145
02-08-2021,mayiladuthurai,310,16,38,0,288,21033,16,39,0,21088,20531,269
02-08-2021,nagapattinam,389,43,35,0,397,18633,43,53,0,18729,18043,289
02-08-2021,namakkal,592,54,65,0,581,47149,54,112,0,47315,46283,451
02-08-2021,nilgiris,542,44,53,1,532,30529,44,44,0,30617,29905,180
02-08-2021,perambalur,115,7,14,0,108,11487,7,3,0,11497,11166,223
02-08-2021,pudukottai,337,23,39,2,319,28122,23,35,0,28180,27494,367
02-08-2021,ramanathapuram,138,8,13,1,132,19909,8,135,0,20052,19570,350
02-08-2021,ranipet,258,17,29,0,246,41932,17,49,0,41998,41010,742
02-08-2021,salem,1096,82,113,4,1061,93044,82,436,0,93562,90939,1562
02-08-2021,sivagangai,310,24,48,0,286,18704,24,108,0,18836,18353,197
02-08-2021,tenkasi,148,9,11,0,146,26801,9,58,0,26868,26242,480
02-08-2021,thanjavur,1083,123,142,0,1064,67957,123,22,0,68102,66190,848
02-08-2021,theni,153,15,15,0,153,42892,15,45,0,42952,42285,514
02-08-2021,thirupathur,255,24,28,0,251,28147,24,118,0,28289,27437,601
02-08-2021,thiruvallur,754,91,68,3,774,113521,91,10,0,113622,111092,1756
02-08-2021,thiruvannamalai,625,40,62,0,603,51702,40,398,0,52140,50899,638
02-08-2021,thiruvarur,363,43,24,3,379,37840,43,38,0,37921,37172,370
02-08-2021,thoothukudi,233,23,27,1,228,54820,23,275,0,55118,54494,396
02-08-2021,tirunelveli,335,15,31,0,319,47493,15,427,0,47935,47188,428
02-08-2021,tiruppur,964,90,116,5,933,87884,90,11,0,87985,86211,841
02-08-2021,trichy,715,75,88,2,700,72432,75,60,0,72567,70899,968
02-08-2021,vellore,331,32,32,0,331,46420,29,1659,3,48111,46685,1095
02-08-2021,villupuram,398,29,44,0,383,43704,29,174,0,43907,43183,341
02-08-2021,virudhunagar,207,14,26,0,195,45407,14,104,0,45525,44790,540
02-08-2021,airport surveillance (international),2,2,0,0,4,0,0,1013,2,1015,1010,1
02-08-2021,airport surveillance (domestic),2,0,0,0,2,0,0,1078,0,1078,1075,1
02-08-2021,railway surveillance,0,0,0,0,0,0,0,428,0,428,428,0
03-08-2021,ariyalur,219,17,15,0,221,15797,17,20,0,15834,15377,236
03-08-2021,chengalpattu,1162,122,99,2,1183,162209,122,5,0,162336,158746,2407
03-08-2021,chennai,1738,203,138,1,1802,538477,203,47,0,538727,528603,8322
03-08-2021,coimbatore,2008,208,169,4,2043,229753,208,51,0,230012,225787,2182
03-08-2021,cuddalore,731,79,68,2,740,60370,79,203,0,60652,59099,813
03-08-2021,dharmapuri,354,24,29,0,349,25948,24,216,0,26188,25604,235
03-08-2021,dindigul,192,13,24,1,180,32145,13,77,0,32235,31431,624
03-08-2021,erode,1562,181,130,1,1612,93942,181,94,0,94217,91971,634
03-08-2021,kallakurichi,481,39,46,0,474,28756,39,404,0,29199,28527,198
03-08-2021,kancheepuram,437,44,34,2,445,71791,44,4,0,71839,70188,1206
03-08-2021,kanyakumari,347,21,47,0,321,60031,21,124,0,60176,58835,1020
03-08-2021,karur,149,22,12,0,159,22622,22,47,0,22691,22181,351
03-08-2021,krishnagiri,312,25,23,0,314,41188,25,233,0,41446,40810,322
03-08-2021,madurai,265,22,28,0,259,73369,22,171,0,73562,72158,1145
03-08-2021,mayiladuthurai,289,27,42,0,274,21050,27,39,0,21116,20573,269
03-08-2021,nagapattinam,398,39,37,0,400,18677,39,53,0,18769,18080,289
03-08-2021,namakkal,582,49,69,0,562,47204,49,112,0,47365,46352,451
03-08-2021,nilgiris,532,40,58,0,514,30573,40,44,0,30657,29963,180
03-08-2021,perambalur,108,10,16,1,101,11494,10,3,0,11507,11182,224
03-08-2021,pudukottai,320,29,35,0,314,28146,29,35,0,28210,27529,367
03-08-2021,ramanathapuram,132,6,14,0,124,19917,6,135,0,20058,19584,350
03-08-2021,ranipet,248,13,26,0,235,41951,13,49,0,42013,41036,742
03-08-2021,salem,1067,75,134,4,1004,93132,75,436,0,93643,91073,1566
03-08-2021,sivagangai,286,26,43,1,268,18728,26,108,0,18862,18396,198
03-08-2021,tenkasi,144,10,8,1,145,26808,10,58,0,26876,26250,481
03-08-2021,thanjavur,1062,118,129,1,1050,68078,118,22,0,68218,66319,849
03-08-2021,theni,152,11,17,0,146,42906,11,45,0,42962,42302,514
03-08-2021,thirupathur,253,19,33,0,239,28173,19,118,0,28310,27470,601
03-08-2021,thiruvallur,775,84,70,1,788,113613,84,10,0,113707,111162,1757
03-08-2021,thiruvannamalai,603,35,66,0,572,51742,35,398,0,52175,50965,638
03-08-2021,thiruvarur,378,32,27,1,382,37882,32,38,0,37952,37199,371
03-08-2021,thoothukudi,229,20,32,1,216,54844,20,275,0,55139,54526,397
03-08-2021,tirunelveli,321,21,36,0,306,47510,21,427,0,47958,47224,428
03-08-2021,tiruppur,935,85,124,5,891,87976,85,11,0,88072,86335,846
03-08-2021,trichy,700,68,76,0,692,72507,68,60,0,72635,70975,968
03-08-2021,vellore,329,27,31,0,325,46447,27,1662,0,48136,46716,1095
03-08-2021,villupuram,383,26,39,0,370,43733,26,174,0,43933,43222,341
03-08-2021,virudhunagar,196,15,22,0,189,45422,15,104,0,45541,44812,540
03-08-2021,airport surveillance (international),4,3,0,0,7,0,0,1015,3,1018,1010,1
03-08-2021,airport surveillance (domestic),2,0,1,0,1,0,0,1078,0,1078,1076,1
03-08-2021,railway surveillance,0,0,0,0,0,0,0,428,0,428,428,0
04-08-2021,ariyalur,221,24,14,0,231,15814,24,20,0,15858,15391,236
04-08-2021,chengalpattu,1182,114,103,2,1191,162330,114,5,0,162449,158849,2409
04-08-2021,chennai,1794,189,142,1,1840,538672,189,47,0,538908,528745,8323
04-08-2021,coimbatore,2046,226,184,3,2085,229964,226,51,0,230241,225971,2185
04-08-2021,cuddalore,741,61,81,2,719,60450,61,203,0,60714,59180,815
04-08-2021,dharmapuri,349,26,32,0,343,25972,26,216,0,26214,25636,235
04-08-2021,dindigul,178,18,21,1,174,32156,18,77,0,32251,31452,625
04-08-2021,erode,1605,154,132,2,1625,94116,154,94,0,94364,92103,636
04-08-2021,kallakurichi,475,45,52,0,468,28796,45,404,0,29245,28579,198
04-08-2021,kancheepuram,446,39,38,1,446,71835,39,4,0,71878,70226,1206
04-08-2021,kanyakumari,321,35,37,1,318,60052,35,124,0,60211,58872,1021
04-08-2021,karur,160,21,11,0,170,22645,21,47,0,22713,22192,351
04-08-2021,krishnagiri,315,27,20,0,322,41214,27,233,0,41474,40830,322
04-08-2021,madurai,261,24,31,0,254,73393,24,171,0,73588,72189,1145
04-08-2021,mayiladuthurai,277,20,41,1,255,21080,20,39,0,21139,20614,270
04-08-2021,nagapattinam,396,33,34,2,393,18712,33,53,0,18798,18114,291
04-08-2021,namakkal,565,53,53,2,563,47256,53,112,0,47421,46405,453
04-08-2021,nilgiris,514,51,61,1,503,30613,51,44,0,30708,30024,181
04-08-2021,perambalur,101,8,10,0,99,11504,8,3,0,11515,11192,224
04-08-2021,pudukottai,314,42,39,1,316,28175,42,35,0,28252,27568,368
04-08-2021,ramanathapuram,125,16,12,0,129,19924,16,135,0,20075,19596,350
04-08-2021,ranipet,235,15,24,1,225,41964,15,49,0,42028,41060,743
04-08-2021,salem,1005,83,131,2,955,93208,83,436,0,93727,91204,1568
04-08-2021,sivagangai,267,19,28,1,257,18753,19,108,0,18880,18424,199
04-08-2021,tenkasi,145,9,9,2,143,26818,9,58,0,26885,26259,483
04-08-2021,thanjavur,1042,110,118,2,1032,68188,110,22,0,68320,66437,851
04-08-2021,theni,144,10,13,0,141,42915,10,45,0,42970,42315,514
04-08-2021,thirupathur,241,15,26,0,230,28194,15,118,0,28327,27496,601
04-08-2021,thiruvallur,790,99,74,5,810,113699,99,10,0,113808,111236,1762
04-08-2021,thiruvannamalai,574,37,69,0,542,51779,37,398,0,52214,51034,638
04-08-2021,thiruvarur,388,47,41,3,391,37920,47,38,0,38005,37240,374
04-08-2021,thoothukudi,217,17,25,1,208,54865,17,275,0,55157,54551,398
04-08-2021,tirunelveli,307,22,46,0,283,47533,22,427,0,47982,47270,429
04-08-2021,tiruppur,888,92,106,1,873,88058,92,11,0,88161,86441,847
04-08-2021,trichy,697,77,63,0,711,72580,77,60,0,72717,71038,968
04-08-2021,vellore,322,26,30,0,318,46471,26,1662,0,48159,46746,1095
04-08-2021,villupuram,372,32,41,0,363,43761,32,174,0,43967,43263,341
04-08-2021,virudhunagar,189,13,19,0,183,45437,13,104,0,45554,44831,540
04-08-2021,airport surveillance (international),7,0,0,0,7,0,0,1018,0,1018,1010,1
04-08-2021,airport surveillance (domestic),1,0,0,0,1,0,0,1078,0,1078,1076,1
04-08-2021,railway surveillance,0,0,0,0,0,0,0,428,0,428,428,0
05-08-2021,ariyalur,229,21,16,0,234,15836,21,20,0,15877,15407,236
05-08-2021,chengalpattu,1196,130,98,0,1228,162449,130,5,0,162584,158947,2409
05-08-2021,chennai,1841,196,146,4,1887,538862,196,47,0,539105,528891,8327
05-08-2021,coimbatore,2087,220,187,3,2117,230192,220,51,0,230463,226158,2188
05-08-2021,cuddalore,720,72,75,0,717,60512,72,203,0,60787,59255,815
05-08-2021,dharmapuri,343,28,36,0,335,25998,28,216,0,26242,25672,235
05-08-2021,dindigul,170,14,14,0,170,32170,14,77,0,32261,31466,625
05-08-2021,erode,1621,161,138,1,1643,94266,161,94,0,94521,92241,637
05-08-2021,kallakurichi,468,42,47,0,463,28841,42,404,0,29287,28626,198
05-08-2021,kancheepuram,446,41,45,1,441,71874,41,4,0,71919,70271,1207
05-08-2021,kanyakumari,318,32,32,1,317,60087,32,124,0,60243,58904,1022
05-08-2021,karur,171,16,16,0,171,22667,16,47,0,22730,22208,351
05-08-2021,krishnagiri,323,22,17,2,326,41242,22,233,0,41497,40847,324
05-08-2021,madurai,255,26,34,1,246,73418,26,171,0,73615,72223,1146
05-08-2021,mayiladuthurai,263,24,33,1,253,21108,24,39,0,21171,20647,271
05-08-2021,nagapattinam,386,37,30,0,393,18738,37,53,0,18828,18144,291
05-08-2021,namakkal,564,47,46,2,563,47310,47,112,0,47469,46451,455
05-08-2021,nilgiris,503,47,59,1,490,30664,47,44,0,30755,30083,182
05-08-2021,perambalur,101,9,8,0,102,11514,9,3,0,11526,11200,224
05-08-2021,pudukottai,318,38,44,2,310,28219,38,35,0,28292,27612,370
05-08-2021,ramanathapuram,129,9,9,0,129,19940,9,135,0,20084,19605,350
05-08-2021,ranipet,225,23,27,0,221,41979,23,49,0,42051,41087,743
05-08-2021,salem,953,79,128,4,900,93289,79,436,0,93804,91332,1572
05-08-2021,sivagangai,257,22,26,0,253,18772,22,108,0,18902,18450,199
05-08-2021,tenkasi,143,8,6,0,145,26827,8,58,0,26893,26265,483
05-08-2021,thanjavur,1027,119,104,3,1039,68293,119,22,0,68434,66541,854
05-08-2021,theni,141,11,10,0,142,42925,11,45,0,42981,42325,514
05-08-2021,thirupathur,233,12,24,0,221,28212,12,118,0,28342,27520,601
05-08-2021,thiruvallur,806,106,71,1,840,113794,106,10,0,113910,111307,1763
05-08-2021,thiruvannamalai,542,64,64,0,542,51816,64,398,0,52278,51098,638
05-08-2021,thiruvarur,393,39,43,0,389,37969,39,38,0,38046,37283,374
05-08-2021,thoothukudi,209,20,23,0,206,54883,20,275,0,55178,54574,398
05-08-2021,tirunelveli,281,15,38,1,257,47553,15,427,0,47995,47308,430
05-08-2021,tiruppur,876,97,94,5,874,88153,97,11,0,88261,86535,852
05-08-2021,trichy,711,78,57,0,732,72657,78,60,0,72795,71095,968
05-08-2021,vellore,314,21,35,0,300,46493,21,1662,0,48176,46781,1095
05-08-2021,villupuram,363,38,42,0,359,43793,38,174,0,44005,43305,341
05-08-2021,virudhunagar,183,11,21,0,173,45450,11,104,0,45565,44852,540
05-08-2021,airport surveillance (international),7,0,0,0,7,0,0,1018,0,1018,1010,1
05-08-2021,airport surveillance (domestic),1,2,0,0,3,0,0,1078,2,1080,1076,1
05-08-2021,railway surveillance,0,0,0,0,0,0,0,428,0,428,428,0
06-08-2021,ariyalur,238,29,19,1,247,15861,29,20,0,15910,15426,237
06-08-2021,chengalpattu,1229,122,126,0,1225,162580,122,5,0,162707,159073,2409
06-08-2021,chennai,1883,189,155,7,1910,539055,189,47,0,539291,529046,8335
06-08-2021,coimbatore,2118,239,192,1,2164,230413,239,51,0,230703,226350,2189
06-08-2021,cuddalore,714,61,71,1,703,60581,61,203,0,60845,59326,816
06-08-2021,dharmapuri,337,32,34,0,335,26028,32,216,0,26276,25706,235
06-08-2021,dindigul,169,10,11,0,168,32183,10,77,0,32270,31477,625
06-08-2021,erode,1643,178,144,0,1677,94427,178,94,0,94699,92385,637
06-08-2021,kallakurichi,463,50,42,0,471,28883,50,404,0,29337,28668,198
06-08-2021,kancheepuram,440,34,44,2,428,71914,34,4,0,71952,70315,1209
06-08-2021,kanyakumari,317,35,36,0,316,60119,35,124,0,60278,58940,1022
06-08-2021,karur,172,18,12,0,178,22684,18,47,0,22749,22220,351
06-08-2021,krishnagiri,327,21,19,0,329,41265,21,233,0,41519,40866,324
06-08-2021,madurai,245,21,21,0,245,73443,21,171,0,73635,72244,1146
06-08-2021,mayiladuthurai,253,28,32,0,249,21132,28,39,0,21199,20679,271
06-08-2021,nagapattinam,394,44,29,0,409,18776,44,53,0,18873,18173,291
06-08-2021,namakkal,561,60,41,0,580,47355,60,112,0,47527,46492,455
06-08-2021,nilgiris,490,50,52,1,487,30711,50,44,0,30805,30135,183
06-08-2021,perambalur,102,7,7,1,101,11523,7,3,0,11533,11207,225
06-08-2021,pudukottai,309,43,45,0,307,28256,43,35,0,28334,27657,370
06-08-2021,ramanathapuram,129,5,8,0,126,19949,5,135,0,20089,19613,350
06-08-2021,ranipet,220,17,22,0,215,42001,17,49,0,42067,41109,743
06-08-2021,salem,901,70,117,5,849,93369,70,436,0,93875,91449,1577
06-08-2021,sivagangai,255,24,24,0,255,18796,24,108,0,18928,18474,199
06-08-2021,tenkasi,144,6,9,0,141,26834,6,58,0,26898,26274,483
06-08-2021,thanjavur,1039,93,110,1,1021,68412,93,22,0,68527,66651,855
06-08-2021,theni,142,8,11,0,139,42936,8,45,0,42989,42336,514
06-08-2021,thirupathur,219,15,23,0,211,28222,15,118,0,28355,27543,601
06-08-2021,thiruvallur,842,98,68,1,871,113901,98,10,0,114009,111375,1763
06-08-2021,thiruvannamalai,543,57,55,1,544,51881,57,398,0,52336,51153,639
06-08-2021,thiruvarur,388,49,37,0,400,38007,49,38,0,38094,37320,374
06-08-2021,thoothukudi,207,18,20,0,205,54904,18,275,0,55197,54594,398
06-08-2021,tirunelveli,257,30,33,0,254,47568,30,427,0,48025,47341,430
06-08-2021,tiruppur,877,90,91,5,871,88253,90,11,0,88354,86626,857
06-08-2021,trichy,733,66,62,2,735,72736,66,60,0,72862,71157,970
06-08-2021,vellore,296,30,31,1,294,46510,30,1662,0,48202,46812,1096
06-08-2021,villupuram,359,30,35,0,354,43831,30,174,0,44035,43340,341
06-08-2021,virudhunagar,173,8,20,0,161,45461,8,104,0,45573,44872,540
06-08-2021,airport surveillance (international),7,0,0,0,7,0,0,1018,0,1018,1010,1
06-08-2021,airport surveillance (domestic),3,0,0,0,3,0,0,1080,0,1080,1076,1
06-08-2021,railway surveillance,0,0,0,0,0,0,0,428,0,428,428,0
07-08-2021,ariyalur,251,25,20,0,256,15894,25,20,0,15939,15446,237
07-08-2021,chengalpattu,1224,115,132,1,1206,162701,115,5,0,162821,159205,2410
07-08-2021,chennai,1912,194,145,2,1959,539246,194,47,0,539487,529191,8337
07-08-2021,coimbatore,2166,223,208,1,2180,230654,223,51,0,230928,226558,2190
07-08-2021,cuddalore,700,79,62,2,715,60639,79,203,0,60921,59388,818
07-08-2021,dharmapuri,335,24,31,1,327,26060,24,216,0,26300,25737,236
07-08-2021,dindigul,167,8,12,1,162,32192,8,77,0,32277,31489,626
07-08-2021,erode,1659,198,138,1,1718,94587,198,94,0,94879,92523,638
07-08-2021,kallakurichi,469,37,40,1,465,28931,37,404,0,29372,28708,199
07-08-2021,kancheepuram,429,40,38,1,430,71949,40,4,0,71993,70353,1210
07-08-2021,kanyakumari,316,42,32,0,326,60154,42,124,0,60320,58972,1022
07-08-2021,karur,178,17,19,0,176,22702,17,47,0,22766,22239,351
07-08-2021,krishnagiri,330,27,23,0,334,41287,27,233,0,41547,40889,324
07-08-2021,madurai,246,19,27,1,237,73465,19,171,0,73655,72271,1147
07-08-2021,mayiladuthurai,249,21,25,0,245,21160,21,39,0,21220,20704,271
07-08-2021,nagapattinam,411,38,34,1,414,18822,38,53,0,18913,18207,292
07-08-2021,namakkal,588,55,55,0,588,47423,55,112,0,47590,46547,455
07-08-2021,nilgiris,487,54,41,2,498,30761,54,44,0,30859,30176,185
07-08-2021,perambalur,103,6,8,0,101,11532,6,3,0,11541,11215,225
07-08-2021,pudukottai,309,45,33,0,321,28301,45,35,0,28381,27690,370
07-08-2021,ramanathapuram,126,2,11,1,116,19954,2,135,0,20091,19624,351
07-08-2021,ranipet,217,18,21,0,214,42020,18,49,0,42087,41130,743
07-08-2021,salem,852,91,103,5,835,93442,91,436,0,93969,91552,1582
07-08-2021,sivagangai,251,20,22,0,249,18816,20,108,0,18944,18496,199
07-08-2021,tenkasi,142,5,14,0,133,26841,5,58,0,26904,26288,483
07-08-2021,thanjavur,1010,110,97,0,1023,68494,110,22,0,68626,66748,855
07-08-2021,theni,139,11,13,0,137,42944,11,45,0,43000,42349,514
07-08-2021,thirupathur,212,10,18,1,203,28238,10,118,0,28366,27561,602
07-08-2021,thiruvallur,872,93,63,2,900,114000,93,10,0,114103,111438,1765
07-08-2021,thiruvannamalai,549,47,51,0,545,51943,47,398,0,52388,51204,639
07-08-2021,thiruvarur,405,40,35,0,410,38061,40,38,0,38139,37355,374
07-08-2021,thoothukudi,203,14,17,0,200,54920,14,275,0,55209,54611,398
07-08-2021,tirunelveli,254,22,24,0,252,47598,22,427,0,48047,47365,430
07-08-2021,tiruppur,874,84,88,3,867,88346,84,11,0,88441,86714,860
07-08-2021,trichy,736,63,60,2,737,72803,63,60,0,72926,71217,972
07-08-2021,vellore,288,31,28,0,291,46534,31,1662,0,48227,46840,1096
07-08-2021,villupuram,355,28,36,0,347,43862,28,174,0,44064,43376,341
07-08-2021,virudhunagar,161,13,15,0,159,45469,13,104,0,45586,44887,540
07-08-2021,airport surveillance (international),7,0,0,0,7,0,0,1018,0,1018,1010,1
07-08-2021,airport surveillance (domestic),3,0,0,0,3,0,0,1080,0,1080,1076,1
07-08-2021,railway surveillance,0,0,0,0,0,0,0,428,0,428,428,0
08-08-2021,ariyalur,256,29,21,0,264,15919,29,20,0,15968,15467,237
08-08-2021,chengalpattu,1204,105,135,1,1173,162814,105,5,0,162924,159340,2411
08-08-2021,chennai,1952,187,157,1,1981,539433,187,47,0,539667,529348,8338
08-08-2021,coimbatore,2181,241,202,3,2217,230878,241,51,0,231170,226760,2193
08-08-2021,cuddalore,715,66,63,1,717,60718,66,203,0,60987,59451,819
08-08-2021,dharmapuri,327,32,28,1,330,26084,32,216,0,26332,25765,237
08-08-2021,dindigul,162,15,11,0,166,32200,15,77,0,32292,31500,626
08-08-2021,erode,1720,185,144,1,1760,94787,185,94,0,95066,92667,639
08-08-2021,kallakurichi,465,32,33,0,464,28968,32,404,0,29404,28741,199
08-08-2021,kancheepuram,431,38,35,1,433,71991,38,4,0,72033,70388,1212
08-08-2021,kanyakumari,326,38,39,0,325,60196,38,124,0,60358,59011,1022
08-08-2021,karur,176,15,17,0,174,22719,15,47,0,22781,22256,351
08-08-2021,krishnagiri,334,24,26,0,332,41314,24,233,0,41571,40915,324
08-08-2021,madurai,237,17,24,0,230,73484,17,171,0,73672,72295,1147
08-08-2021,mayiladuthurai,249,26,22,0,253,21185,26,39,0,21250,20726,271
08-08-2021,nagapattinam,412,46,31,0,427,18858,46,53,0,18957,18238,292
08-08-2021,namakkal,586,53,49,1,589,47476,53,112,0,47641,46596,456
08-08-2021,nilgiris,498,50,46,1,501,30815,50,44,0,30909,30222,186
08-08-2021,perambalur,105,10,7,0,108,11542,10,3,0,11555,11222,225
08-08-2021,pudukottai,323,40,29,1,333,28348,40,35,0,28423,27719,371
08-08-2021,ramanathapuram,117,5,8,0,114,19957,5,135,0,20097,19632,351
08-08-2021,ranipet,215,15,19,1,210,42039,15,49,0,42103,41149,744
08-08-2021,salem,836,89,78,4,843,93534,89,436,0,94059,91630,1586
08-08-2021,sivagangai,249,19,25,0,243,18836,19,108,0,18963,18521,199
08-08-2021,tenkasi,131,6,9,1,127,26844,6,58,0,26908,26297,484
08-08-2021,thanjavur,1012,97,101,1,1007,68593,97,22,0,68712,66849,856
08-08-2021,theni,136,9,14,0,131,42954,9,45,0,43008,42363,514
08-08-2021,thirupathur,206,9,16,0,199,28251,9,118,0,28378,27577,602
08-08-2021,thiruvallur,903,91,68,0,926,114095,91,10,0,114196,111506,1764
08-08-2021,thiruvannamalai,547,45,59,1,532,51992,45,398,0,52435,51263,640
08-08-2021,thiruvarur,413,49,42,1,419,38104,49,38,0,38191,37397,375
08-08-2021,thoothukudi,204,16,15,0,205,54938,16,275,0,55229,54626,398
08-08-2021,tirunelveli,252,35,27,0,260,47620,35,427,0,48082,47392,430
08-08-2021,tiruppur,866,80,79,4,863,88429,80,11,0,88520,86793,864
08-08-2021,trichy,738,69,56,2,749,72867,69,60,0,72996,71273,974
08-08-2021,vellore,285,26,28,0,283,46559,26,1662,0,48247,46868,1096
08-08-2021,villupuram,348,35,32,0,351,43891,35,174,0,44100,43408,341
08-08-2021,virudhunagar,159,12,12,1,158,45482,12,104,0,45598,44899,541
08-08-2021,airport surveillance (international),7,0,0,0,7,0,0,1018,0,1018,1010,1
08-08-2021,airport surveillance (domestic),3,0,0,0,3,0,0,1080,0,1080,1076,1
08-08-2021,railway surveillance,0,0,0,0,0,0,0,428,0,428,428,0
09-08-2021,ariyalur,267,24,35,1,255,15951,24,20,0,15995,15502,238
09-08-2021,chengalpattu,1173,107,124,0,1156,162919,107,5,0,163031,159464,2411
09-08-2021,chennai,1988,182,174,2,1994,539627,182,47,0,539856,529522,8340
09-08-2021,coimbatore,2217,235,223,1,2228,231119,235,51,0,231405,226983,2194
09-08-2021,cuddalore,716,87,66,1,736,60783,87,203,0,61073,59517,820
09-08-2021,dharmapuri,331,30,34,0,327,26117,30,216,0,26363,25799,237
09-08-2021,dindigul,167,12,13,0,166,32216,12,77,0,32305,31513,626
09-08-2021,erode,1761,178,179,0,1760,94973,178,94,0,95245,92846,639
09-08-2021,kallakurichi,465,42,36,0,471,29001,42,404,0,29447,28777,199
09-08-2021,kancheepuram,432,34,31,0,435,72028,34,4,0,72066,70419,1212
09-08-2021,kanyakumari,325,33,25,0,333,60234,33,124,0,60391,59036,1022
09-08-2021,karur,174,19,14,0,179,22734,19,47,0,22800,22270,351
09-08-2021,krishnagiri,331,20,22,0,329,41337,20,233,0,41590,40937,324
09-08-2021,madurai,230,22,20,0,232,73501,22,171,0,73694,72315,1147
09-08-2021,mayiladuthurai,253,23,26,0,250,21211,23,39,0,21273,20752,271
09-08-2021,nagapattinam,426,41,35,0,432,18903,41,53,0,18997,18273,292
09-08-2021,namakkal,585,50,41,1,593,47525,50,112,0,47687,46637,457
09-08-2021,nilgiris,501,47,47,0,501,30865,47,44,0,30956,30269,186
09-08-2021,perambalur,108,8,6,0,110,11552,8,3,0,11563,11228,225
09-08-2021,pudukottai,333,36,32,0,337,28388,36,35,0,28459,27751,371
09-08-2021,ramanathapuram,114,4,9,0,109,19962,4,135,0,20101,19641,351
09-08-2021,ranipet,210,16,17,1,208,42054,16,49,0,42119,41166,745
09-08-2021,salem,844,85,88,5,836,93624,84,436,1,94145,91718,1591
09-08-2021,sivagangai,243,17,24,0,236,18855,17,108,0,18980,18545,199
09-08-2021,tenkasi,128,5,11,0,122,26851,5,58,0,26914,26308,484
09-08-2021,thanjavur,1002,95,97,5,995,68685,95,22,0,68802,66946,861
09-08-2021,theni,131,8,15,0,124,42963,8,45,0,43016,42378,514
09-08-2021,thirupathur,196,12,18,1,189,28257,12,118,0,28387,27595,603
09-08-2021,thiruvallur,922,88,71,0,939,114182,88,10,0,114280,111577,1764
09-08-2021,thiruvannamalai,532,43,54,0,521,52037,43,398,0,52478,51317,640
09-08-2021,thiruvarur,420,52,39,0,433,38154,52,38,0,38244,37436,375
09-08-2021,thoothukudi,206,14,17,0,203,54955,14,275,0,55244,54643,398
09-08-2021,tirunelveli,258,31,28,0,261,47653,31,427,0,48111,47420,430
09-08-2021,tiruppur,862,77,82,5,852,88508,77,11,0,88596,86875,869
09-08-2021,trichy,751,67,65,0,753,72938,67,60,0,73065,71338,974
09-08-2021,vellore,285,38,23,0,300,46587,38,1662,0,48287,46891,1096
09-08-2021,villupuram,352,36,31,0,357,43927,36,174,0,44137,43439,341
09-08-2021,virudhunagar,158,11,14,0,155,45494,11,104,0,45609,44913,541
09-08-2021,airport surveillance (international),7,0,0,0,7,0,0,1018,0,1018,1010,1
09-08-2021,airport surveillance (domestic),3,0,0,0,3,0,0,1080,0,1080,1076,1
09-08-2021,railway surveillance,0,0,0,0,0,0,0,428,0,428,428,0
10-08-2021,ariyalur,257,19,32,1,243,15977,19,20,0,16016,15534,239
10-08-2021,chengalpattu,1155,105,128,2,1130,163025,105,5,0,163135,159592,2413
10-08-2021,chennai,1992,209,194,2,2005,539807,209,47,0,540063,529716,8342
10-08-2021,coimbatore,2232,224,217,5,2234,231358,224,51,0,231633,227200,2199
10-08-2021,cuddalore,734,73,58,1,748,60868,73,203,0,61144,59575,821
10-08-2021,dharmapuri,326,28,29,0,325,26146,28,216,0,26390,25828,237
10-08-2021,dindigul,161,9,10,0,160,32223,9,77,0,32309,31523,626
10-08-2021,erode,1745,169,188,1,1725,95136,169,94,0,95399,93034,640
10-08-2021,kallakurichi,471,43,35,0,479,29043,43,404,0,29490,28812,199
10-08-2021,kancheepuram,436,35,28,0,443,72063,35,4,0,72102,70447,1212
10-08-2021,kanyakumari,334,29,26,0,337,60268,29,124,0,60421,59062,1022
10-08-2021,karur,176,16,15,0,177,22750,16,47,0,22813,22285,351
10-08-2021,krishnagiri,330,21,30,0,321,41358,21,233,0,41612,40967,324
10-08-2021,madurai,232,20,21,0,231,73523,20,171,0,73714,72336,1147
10-08-2021,mayiladuthurai,250,27,19,0,258,21234,27,39,0,21300,20771,271
10-08-2021,nagapattinam,435,39,37,0,437,18947,39,53,0,19039,18310,292
10-08-2021,namakkal,595,45,45,1,594,47577,45,112,0,47734,46682,458
10-08-2021,nilgiris,501,49,49,0,501,30912,49,44,0,31005,30318,186
10-08-2021,perambalur,110,6,7,0,109,11560,6,3,0,11569,11235,225
10-08-2021,pudukottai,340,32,31,1,340,28427,32,35,0,28494,27782,372
10-08-2021,ramanathapuram,109,3,11,0,101,19966,3,135,0,20104,19652,351
10-08-2021,ranipet,214,22,20,0,216,42076,22,49,0,42147,41186,745
10-08-2021,salem,841,92,83,3,847,93713,92,437,0,94242,91801,1594
10-08-2021,sivagangai,238,19,25,0,232,18874,19,108,0,19001,18570,199
10-08-2021,tenkasi,123,4,13,0,114,26857,4,58,0,26919,26321,484
10-08-2021,thanjavur,991,97,85,1,1002,68776,97,22,0,68895,67031,862
10-08-2021,theni,123,10,12,0,121,42970,10,45,0,43025,42390,514
10-08-2021,thirupathur,191,11,14,1,187,28271,11,118,0,28400,27609,604
10-08-2021,thiruvallur,941,79,94,1,925,114272,79,10,0,114361,111671,1765
10-08-2021,thiruvannamalai,527,50,59,0,518,52086,50,398,0,52534,51376,640
10-08-2021,thiruvarur,431,45,45,0,431,38204,45,38,0,38287,37481,375
10-08-2021,thoothukudi,203,12,16,0,199,54969,12,275,0,55256,54659,398
10-08-2021,tirunelveli,260,27,23,0,264,47683,27,427,0,48137,47443,430
10-08-2021,tiruppur,861,71,79,5,848,88594,71,11,0,88676,86954,874
10-08-2021,trichy,755,68,69,2,752,73007,68,60,0,73135,71407,976
10-08-2021,vellore,284,46,33,0,297,46609,46,1662,0,48317,46924,1096
10-08-2021,villupuram,358,30,34,0,354,43964,30,174,0,44168,43473,341
10-08-2021,virudhunagar,155,9,16,0,148,45505,9,104,0,45618,44929,541
10-08-2021,airport surveillance (international),7,0,0,0,7,0,0,1018,0,1018,1010,1
10-08-2021,airport surveillance (domestic),3,0,0,0,3,0,0,1080,0,1080,1076,1
10-08-2021,railway surveillance,0,0,0,0,0,0,0,428,0,428,428,0
11-08-2021,ariyalur,242,22,26,1,237,15995,22,20,0,16037,15560,240
11-08-2021,chengalpattu,1129,140,117,0,1152,163129,140,5,0,163274,159709,2413
11-08-2021,chennai,1999,243,191,3,2048,540010,243,47,0,540300,529907,8345
11-08-2021,coimbatore,2235,229,203,2,2259,231583,229,51,0,231863,227403,2201
11-08-2021,cuddalore,749,75,47,0,777,60942,75,203,0,61220,59622,821
11-08-2021,dharmapuri,325,25,34,0,316,26174,25,216,0,26415,25862,237
11-08-2021,dindigul,162,11,15,1,157,32234,11,77,0,32322,31538,627
11-08-2021,erode,1718,167,174,1,1710,95298,167,94,0,95559,93208,641
11-08-2021,kallakurichi,479,31,42,0,468,29086,31,404,0,29521,28854,199
11-08-2021,kancheepuram,446,39,36,1,448,72101,39,4,0,72144,70483,1213
11-08-2021,kanyakumari,337,30,28,0,339,60297,30,124,0,60451,59090,1022
11-08-2021,karur,177,23,12,0,188,22766,23,47,0,22836,22297,351
11-08-2021,krishnagiri,325,22,37,1,309,41383,22,233,0,41638,41004,325
11-08-2021,madurai,229,17,18,0,228,73541,17,171,0,73729,72354,1147
11-08-2021,mayiladuthurai,260,23,24,0,259,21263,23,39,0,21325,20795,271
11-08-2021,nagapattinam,433,40,43,3,427,18982,40,53,0,19075,18353,295
11-08-2021,namakkal,594,37,57,0,574,47622,37,112,0,47771,46739,458
11-08-2021,nilgiris,501,43,51,0,493,30961,43,44,0,31048,30369,186
11-08-2021,perambalur,111,8,10,0,109,11568,8,3,0,11579,11245,225
11-08-2021,pudukottai,340,39,23,0,356,28459,39,35,0,28533,27805,372
11-08-2021,ramanathapuram,101,6,13,0,94,19969,6,135,0,20110,19665,351
11-08-2021,ranipet,218,20,22,0,216,42100,20,49,0,42169,41208,745
11-08-2021,salem,848,85,87,3,843,93806,85,437,0,94328,91888,1597
11-08-2021,sivagangai,233,20,24,0,229,18894,20,108,0,19022,18594,199
11-08-2021,tenkasi,116,7,11,0,112,26863,7,58,0,26928,26332,484
11-08-2021,thanjavur,1002,77,82,2,995,68873,77,22,0,68972,67113,864
11-08-2021,theni,121,13,14,0,120,42980,13,45,0,43038,42404,514
11-08-2021,thirupathur,185,12,19,0,178,28280,12,118,0,28410,27628,604
11-08-2021,thiruvallur,927,98,83,1,941,114353,98,10,0,114461,111754,1766
11-08-2021,thiruvannamalai,522,48,66,1,503,52140,48,398,0,52586,51442,641
11-08-2021,thiruvarur,431,40,38,1,432,38249,40,38,0,38327,37519,376
11-08-2021,thoothukudi,199,18,21,0,196,54981,18,275,0,55274,54680,398
11-08-2021,tirunelveli,262,16,26,0,252,47708,16,427,0,48151,47469,430
11-08-2021,tiruppur,853,73,67,2,857,88670,73,11,0,88754,87021,876
11-08-2021,trichy,748,78,74,3,749,73071,78,60,0,73209,71481,979
11-08-2021,vellore,291,45,27,1,308,46649,45,1662,0,48356,46951,1097
11-08-2021,villupuram,357,34,33,0,358,43997,34,174,0,44205,43506,341
11-08-2021,virudhunagar,148,10,20,1,137,45514,10,104,0,45628,44949,542
11-08-2021,airport surveillance (international),7,0,2,0,5,0,0,1018,0,1018,1012,1
11-08-2021,airport surveillance (domestic),3,0,0,0,3,0,0,1080,0,1080,1076,1
11-08-2021,railway surveillance,0,0,0,0,0,0,0,428,0,428,428,0
12-08-2021,ariyalur,237,19,29,0,227,16017,19,20,0,16056,15589,240
12-08-2021,chengalpattu,1142,119,102,0,1159,163259,119,5,0,163383,159811,2413
12-08-2021,chennai,2054,217,188,2,2081,540259,217,47,0,540523,530095,8347
12-08-2021,coimbatore,2261,249,196,6,2308,231814,249,51,0,232114,227599,2207
12-08-2021,cuddalore,779,71,54,0,796,61019,71,203,0,61293,59676,821
12-08-2021,dharmapuri,319,28,31,1,315,26202,28,216,0,26446,25893,238
12-08-2021,dindigul,157,10,19,1,147,32245,10,77,0,32332,31557,628
12-08-2021,erode,1694,183,159,0,1718,95449,183,94,0,95726,93367,641
12-08-2021,kallakurichi,468,36,48,0,456,29117,36,404,0,29557,28902,199
12-08-2021,kancheepuram,456,36,46,0,446,72148,36,4,0,72188,70529,1213
12-08-2021,kanyakumari,339,25,32,3,329,60327,25,124,0,60476,59122,1025
12-08-2021,karur,187,17,14,0,190,22788,17,47,0,22852,22311,351
12-08-2021,krishnagiri,306,29,43,1,291,41402,29,233,0,41664,41047,326
12-08-2021,madurai,228,18,15,1,230,73558,18,171,0,73747,72369,1148
12-08-2021,mayiladuthurai,265,18,28,0,255,21292,18,39,0,21349,20823,271
12-08-2021,nagapattinam,424,37,49,0,412,19019,37,53,0,19109,18402,295
12-08-2021,namakkal,580,53,62,1,570,47665,53,112,0,47830,46801,459
12-08-2021,nilgiris,493,46,48,0,491,31004,46,44,0,31094,30417,186
12-08-2021,perambalur,109,7,13,0,103,11576,7,3,0,11586,11258,225
12-08-2021,pudukottai,352,31,27,2,354,28494,31,35,0,28560,27832,374
12-08-2021,ramanathapuram,94,4,17,0,81,19975,4,135,0,20114,19682,351
12-08-2021,ranipet,220,16,26,0,210,42124,16,49,0,42189,41234,745
12-08-2021,salem,848,94,93,5,844,93896,94,437,0,94427,91981,1602
12-08-2021,sivagangai,229,19,26,0,222,18914,19,108,0,19041,18620,199
12-08-2021,tenkasi,113,6,14,0,105,26871,6,58,0,26935,26346,484
12-08-2021,thanjavur,993,102,64,0,1031,68948,102,22,0,69072,67177,864
12-08-2021,theni,117,12,11,0,118,42990,12,45,0,43047,42415,514
12-08-2021,thirupathur,177,11,13,1,174,28291,11,118,0,28420,27641,605
12-08-2021,thiruvallur,936,85,78,1,942,114446,85,10,0,114541,111832,1767
12-08-2021,thiruvannamalai,510,42,64,0,488,52195,42,398,0,52635,51506,641
12-08-2021,thiruvarur,431,46,32,2,443,38288,46,38,0,38372,37551,378
12-08-2021,thoothukudi,196,14,23,0,187,54999,14,275,0,55288,54703,398
12-08-2021,tirunelveli,252,13,18,0,247,47724,13,427,0,48164,47487,430
12-08-2021,tiruppur,861,83,62,4,878,88747,83,11,0,88841,87083,880
12-08-2021,trichy,751,70,65,1,755,73151,70,60,0,73281,71546,980
12-08-2021,vellore,300,38,22,1,315,46686,38,1662,0,48386,46973,1098
12-08-2021,villupuram,359,28,40,0,347,44032,28,174,0,44234,43546,341
12-08-2021,virudhunagar,137,9,21,0,125,45524,9,104,0,45637,44970,542
12-08-2021,airport surveillance (international),5,1,0,0,6,0,0,1018,1,1019,1012,1
12-08-2021,airport surveillance (domestic),3,0,0,0,3,0,0,1080,0,1080,1076,1
12-08-2021,railway surveillance,0,0,0,0,0,0,0,428,0,428,428,0
13-08-2021,ariyalur,227,16,23,1,219,16036,16,20,0,16072,15612,241
13-08-2021,chengalpattu,1159,108,97,1,1169,163378,108,5,0,163491,159908,2414
13-08-2021,chennai,2086,211,194,5,2098,540481,211,47,0,540739,530289,8352
13-08-2021,coimbatore,2309,236,182,5,2358,232064,236,51,0,232351,227781,2212
13-08-2021,cuddalore,795,72,68,1,798,61089,72,203,0,61364,59744,822
13-08-2021,dharmapuri,315,23,34,0,304,26230,23,216,0,26469,25927,238
13-08-2021,dindigul,147,9,20,0,136,32255,9,77,0,32341,31577,628
13-08-2021,erode,1715,177,146,1,1745,95629,177,94,0,95900,93513,642
13-08-2021,kallakurichi,470,32,56,0,446,29167,32,404,0,29603,28958,199
13-08-2021,kancheepuram,446,32,49,2,427,72184,32,4,0,72220,70578,1215
13-08-2021,kanyakumari,325,32,29,0,328,60348,32,124,0,60504,59151,1025
13-08-2021,karur,190,14,13,0,191,22805,14,47,0,22866,22324,351
13-08-2021,krishnagiri,291,22,46,0,267,41431,22,233,0,41686,41093,326
13-08-2021,madurai,230,22,21,0,231,73576,22,171,0,73769,72390,1148
13-08-2021,mayiladuthurai,256,19,26,2,247,21311,19,39,0,21369,20849,273
13-08-2021,nagapattinam,413,31,42,1,401,19057,31,53,0,19141,18444,296
13-08-2021,namakkal,577,47,73,1,550,47725,47,112,0,47884,46874,460
13-08-2021,nilgiris,491,48,54,0,485,31050,48,44,0,31142,30471,186
13-08-2021,perambalur,103,6,16,0,93,11583,6,3,0,11592,11274,225
13-08-2021,pudukottai,354,36,24,1,365,28525,36,35,0,28596,27856,375
13-08-2021,ramanathapuram,82,5,12,0,75,19980,5,135,0,20120,19694,351
13-08-2021,ranipet,210,17,27,0,200,42140,17,49,0,42206,41261,745
13-08-2021,salem,848,120,86,1,881,93994,120,437,0,94551,92067,1603
13-08-2021,sivagangai,222,15,22,0,215,18933,15,108,0,19056,18642,199
13-08-2021,tenkasi,106,8,18,0,96,26878,8,58,0,26944,26364,484
13-08-2021,thanjavur,1034,114,78,3,1067,69053,114,22,0,69189,67255,867
13-08-2021,theni,118,11,14,0,115,43002,11,45,0,43058,42429,514
13-08-2021,thirupathur,175,7,19,0,163,28303,7,118,0,28428,27660,605
13-08-2021,thiruvallur,940,75,76,2,937,114529,75,10,0,114614,111908,1769
13-08-2021,thiruvannamalai,490,43,57,0,476,52239,43,398,0,52680,51563,641
13-08-2021,thiruvarur,439,38,28,2,447,38330,38,38,0,38406,37579,380
13-08-2021,thoothukudi,188,11,21,0,178,55014,11,275,0,55300,54724,398
13-08-2021,tirunelveli,249,15,15,0,249,47739,15,427,0,48181,47502,430
13-08-2021,tiruppur,869,105,65,3,906,88821,105,11,0,88937,87148,883
13-08-2021,trichy,755,77,69,2,761,73221,77,60,0,73358,71615,982
13-08-2021,vellore,311,41,17,0,335,46720,39,1662,2,48423,46990,1098
13-08-2021,villupuram,330,32,36,0,326,44043,32,174,0,44249,43582,341
13-08-2021,virudhunagar,125,6,14,0,117,45533,6,104,0,45643,44984,542
13-08-2021,airport surveillance (international),6,0,0,0,6,0,0,1019,0,1019,1012,1
13-08-2021,airport surveillance (domestic),3,0,0,0,3,0,0,1080,0,1080,1076,1
13-08-2021,railway surveillance,0,0,0,0,0,0,0,428,0,428,428,0
14-08-2021,ariyalur,219,15,21,1,212,16052,15,20,0,16087,15633,242
14-08-2021,chengalpattu,1170,116,93,0,1193,163487,116,5,0,163608,160001,2414
14-08-2021,chennai,2110,219,214,3,2112,540705,219,47,0,540971,530503,8356
14-08-2021,coimbatore,2359,223,197,5,2380,232301,223,51,0,232575,227978,2217
14-08-2021,cuddalore,801,67,84,0,784,61164,67,203,0,61434,59828,822
14-08-2021,dharmapuri,301,20,32,0,289,26250,20,216,0,26486,25959,238
14-08-2021,dindigul,134,11,15,0,130,32262,11,77,0,32350,31592,628
14-08-2021,erode,1747,185,132,0,1800,95808,185,94,0,96087,93645,642
14-08-2021,kallakurichi,445,30,54,0,421,29198,30,404,0,29632,29012,199
14-08-2021,kancheepuram,428,28,51,1,404,72216,28,4,0,72248,70629,1215
14-08-2021,kanyakumari,328,30,23,1,334,60380,30,124,0,60534,59174,1026
14-08-2021,karur,186,24,10,0,200,22814,24,47,0,22885,22334,351
14-08-2021,krishnagiri,269,25,34,1,259,41455,25,233,0,41713,41127,327
14-08-2021,madurai,230,18,26,0,222,73597,18,171,0,73786,72416,1148
14-08-2021,mayiladuthurai,255,22,25,1,251,21338,22,39,0,21399,20874,274
14-08-2021,nagapattinam,391,30,36,0,385,19078,30,53,0,19161,18480,296
14-08-2021,namakkal,542,62,67,1,536,47764,62,112,0,47938,46941,461
14-08-2021,nilgiris,485,47,49,1,482,31098,47,44,0,31189,30520,187
14-08-2021,perambalur,93,5,11,1,86,11589,5,3,0,11597,11285,226
14-08-2021,pudukottai,365,22,19,0,368,28561,22,35,0,28618,27875,375
14-08-2021,ramanathapuram,75,4,9,0,70,19985,4,135,0,20124,19703,351
14-08-2021,ranipet,200,23,22,1,200,42157,23,49,0,42229,41283,746
14-08-2021,salem,888,130,94,2,922,94121,130,437,0,94688,92161,1605
14-08-2021,sivagangai,216,20,18,0,218,18949,20,108,0,19077,18660,199
14-08-2021,tenkasi,91,5,13,0,83,26881,5,58,0,26944,26377,484
14-08-2021,thanjavur,1065,112,97,2,1078,69165,112,22,0,69299,67352,869
14-08-2021,theni,115,12,8,0,119,43013,12,45,0,43070,42437,514
14-08-2021,thirupathur,164,13,16,2,159,28311,13,118,0,28442,27676,607
14-08-2021,thiruvallur,935,72,79,0,928,114602,72,10,0,114684,111987,1769
14-08-2021,thiruvannamalai,479,41,48,2,470,52285,41,398,0,52724,51611,643
14-08-2021,thiruvarur,448,42,26,1,463,38369,42,38,0,38449,37605,381
14-08-2021,thoothukudi,178,6,20,0,164,55025,6,275,0,55306,54744,398
14-08-2021,tirunelveli,248,14,22,0,240,47753,14,427,0,48194,47524,430
14-08-2021,tiruppur,904,94,76,2,920,88924,94,11,0,89029,87224,885
14-08-2021,trichy,763,68,71,1,759,73300,68,60,0,73428,71686,983
14-08-2021,vellore,332,27,14,3,342,46756,27,1664,0,48447,47004,1101
14-08-2021,villupuram,326,31,31,2,324,44075,31,174,0,44280,43613,343
14-08-2021,virudhunagar,117,3,9,0,111,45539,3,104,0,45646,44993,542
14-08-2021,airport surveillance (international),6,0,0,0,6,0,0,1019,0,1019,1012,1
14-08-2021,airport surveillance (domestic),3,0,0,0,3,0,0,1080,0,1080,1076,1
14-08-2021,railway surveillance,0,0,0,0,0,0,0,428,0,428,428,0
15-08-2021,ariyalur,213,14,18,0,209,16068,14,20,0,16102,15651,242
15-08-2021,chengalpattu,1197,115,96,1,1215,163607,115,5,0,163727,160097,2415
15-08-2021,chennai,2119,216,221,3,2111,540931,216,47,0,541194,530724,8359
15-08-2021,coimbatore,2383,225,204,1,2403,232527,225,51,0,232803,228182,2218
15-08-2021,cuddalore,783,62,81,0,764,61230,62,203,0,61495,59909,822
15-08-2021,dharmapuri,289,18,28,0,279,26270,18,216,0,26504,25987,238
15-08-2021,dindigul,129,9,16,0,122,32272,9,77,0,32358,31608,628
15-08-2021,erode,1792,179,146,0,1825,95985,179,94,0,96258,93791,642
15-08-2021,kallakurichi,423,36,51,0,408,29230,36,404,0,29670,29063,199
15-08-2021,kancheepuram,405,30,48,0,387,72245,30,4,0,72279,70677,1215
15-08-2021,kanyakumari,334,28,26,0,336,60410,28,124,0,60562,59200,1026
15-08-2021,karur,200,19,14,0,205,22838,19,47,0,22904,22348,351
15-08-2021,krishnagiri,261,27,31,0,257,41482,27,233,0,41742,41158,327
15-08-2021,madurai,220,13,25,0,208,73613,13,171,0,73797,72441,1148
15-08-2021,mayiladuthurai,265,34,29,0,270,21374,34,39,0,21447,20903,274
15-08-2021,nagapattinam,370,36,32,0,374,19093,36,53,0,19182,18512,296
15-08-2021,namakkal,537,54,74,0,517,47827,54,112,0,47993,47015,461
15-08-2021,nilgiris,482,44,41,0,485,31145,44,44,0,31233,30561,187
15-08-2021,perambalur,86,7,8,0,85,11594,7,3,0,11604,11293,226
15-08-2021,pudukottai,369,25,13,0,381,28584,25,35,0,28644,27888,375
15-08-2021,ramanathapuram,70,5,6,0,69,19989,5,135,0,20129,19709,351
15-08-2021,ranipet,198,25,17,0,206,42178,25,49,0,42252,41300,746
15-08-2021,salem,924,127,97,5,949,94253,127,437,0,94817,92258,1610
15-08-2021,sivagangai,219,24,16,0,227,18970,24,108,0,19102,18676,199
15-08-2021,tenkasi,78,12,11,0,79,26881,12,58,0,26951,26388,484
15-08-2021,thanjavur,1078,106,94,1,1089,69277,106,22,0,69405,67446,870
15-08-2021,theni,118,11,10,0,119,43024,11,45,0,43080,42447,514
15-08-2021,thirupathur,156,8,14,0,150,28321,8,118,0,28447,27690,607
15-08-2021,thiruvallur,929,74,68,1,934,114675,74,10,0,114759,112055,1770
15-08-2021,thiruvannamalai,473,45,37,0,481,52329,45,398,0,52772,51648,643
15-08-2021,thiruvarur,461,38,21,1,477,38409,38,38,0,38485,37626,382
15-08-2021,thoothukudi,164,5,15,0,154,55031,5,275,0,55311,54759,398
15-08-2021,tirunelveli,241,16,19,0,238,47768,16,427,0,48211,47543,430
15-08-2021,tiruppur,922,84,88,5,913,89020,84,11,0,89115,87312,890
15-08-2021,trichy,759,61,78,2,740,73368,61,60,0,73489,71764,985
15-08-2021,vellore,335,22,12,2,343,46776,22,1664,0,48462,47016,1103
15-08-2021,villupuram,325,33,27,1,330,44107,33,174,0,44314,43640,344
15-08-2021,virudhunagar,111,9,7,0,113,45542,9,104,0,45655,45000,542
15-08-2021,airport surveillance (international),6,0,2,0,4,0,0,1019,0,1019,1014,1
15-08-2021,airport surveillance (domestic),3,0,1,0,2,0,0,1080,0,1080,1077,1
15-08-2021,railway surveillance,0,0,0,0,0,0,0,428,0,428,428,0
16-08-2021,ariyalur,212,18,20,1,209,16085,18,20,0,16123,15671,243
16-08-2021,chengalpattu,1210,112,152,1,1169,163717,112,5,0,163834,160249,2416
16-08-2021,chennai,2114,205,235,4,2080,541150,205,47,0,541402,530959,8363
16-08-2021,coimbatore,2405,217,215,1,2406,232754,217,51,0,233022,228397,2219
16-08-2021,cuddalore,762,61,87,3,733,61290,61,203,0,61554,59996,825
16-08-2021,dharmapuri,279,17,22,1,273,26288,17,216,0,26521,26009,239
16-08-2021,dindigul,117,10,10,0,117,32276,10,77,0,32363,31618,628
16-08-2021,erode,1814,170,151,0,1833,96153,170,94,0,96417,93942,642
16-08-2021,kallakurichi,406,33,39,0,400,29264,33,404,0,29701,29102,199
16-08-2021,kancheepuram,393,27,32,1,387,72281,27,4,0,72312,70709,1216
16-08-2021,kanyakumari,336,34,28,1,341,60438,34,124,0,60596,59228,1027
16-08-2021,karur,202,16,15,0,203,22854,16,47,0,22917,22363,351
16-08-2021,krishnagiri,257,28,29,0,256,41509,28,233,0,41770,41187,327
16-08-2021,madurai,208,11,19,0,200,73626,11,171,0,73808,72460,1148
16-08-2021,mayiladuthurai,277,29,25,0,281,21415,29,39,0,21483,20928,274
16-08-2021,nagapattinam,370,34,36,0,368,19125,34,53,0,19212,18548,296
16-08-2021,namakkal,522,51,64,0,509,47886,51,112,0,48049,47079,461
16-08-2021,nilgiris,485,39,42,1,481,31189,39,44,0,31272,30603,188
16-08-2021,perambalur,85,6,11,0,80,11601,6,3,0,11610,11304,226
16-08-2021,pudukottai,382,42,17,1,406,28610,42,35,0,28687,27905,376
16-08-2021,ramanathapuram,69,4,7,1,65,19994,4,135,0,20133,19716,352
16-08-2021,ranipet,207,22,18,0,211,42204,22,49,0,42275,41318,746
16-08-2021,salem,955,123,86,1,991,94386,123,437,0,94946,92344,1611
16-08-2021,sivagangai,225,21,21,0,225,18992,21,108,0,19121,18697,199
16-08-2021,tenkasi,79,9,8,0,80,26893,9,58,0,26960,26396,484
16-08-2021,thanjavur,1085,127,102,2,1108,69379,127,22,0,69528,67548,872
16-08-2021,theni,115,10,13,1,111,43031,10,45,0,43086,42460,515
16-08-2021,thirupathur,148,6,18,0,136,28327,6,118,0,28451,27708,607
16-08-2021,thiruvallur,928,69,71,1,925,114743,69,10,0,114822,112126,1771
16-08-2021,thiruvannamalai,483,41,43,0,481,52376,41,398,0,52815,51691,643
16-08-2021,thiruvarur,478,36,26,0,488,38448,36,38,0,38522,37652,382
16-08-2021,thoothukudi,152,10,14,0,148,55034,10,275,0,55319,54773,398
16-08-2021,tirunelveli,240,14,22,0,232,47786,14,427,0,48227,47565,430
16-08-2021,tiruppur,918,79,81,4,912,89109,79,11,0,89199,87393,894
16-08-2021,trichy,744,57,73,2,726,73433,57,60,0,73550,71837,987
16-08-2021,vellore,343,24,18,0,349,46798,24,1664,0,48486,47034,1103
16-08-2021,villupuram,333,31,31,1,332,44143,31,174,0,44348,43671,345
16-08-2021,virudhunagar,114,7,10,0,111,45552,7,104,0,45663,45010,542
16-08-2021,airport surveillance (international),4,1,0,0,5,0,0,1019,1,1020,1014,1
16-08-2021,airport surveillance (domestic),2,0,0,0,2,0,0,1080,0,1080,1077,1
16-08-2021,railway surveillance,0,0,0,0,0,0,0,428,0,428,428,0
17-08-2021,ariyalur,208,16,16,0,208,16102,16,20,0,16138,15687,243
17-08-2021,chengalpattu,1170,110,146,4,1130,163830,110,5,0,163945,160395,2420
17-08-2021,chennai,2085,209,214,4,2076,541360,209,47,0,541616,531173,8367
17-08-2021,coimbatore,2406,206,229,3,2380,232971,206,51,0,233228,228626,2222
17-08-2021,cuddalore,734,59,76,0,717,61352,59,203,0,61614,60072,825
17-08-2021,dharmapuri,272,20,25,0,267,26304,20,216,0,26540,26034,239
17-08-2021,dindigul,117,9,13,2,111,32286,9,77,0,32372,31631,630
17-08-2021,erode,1841,167,144,0,1864,96331,167,94,0,96592,94086,642
17-08-2021,kallakurichi,400,32,43,0,389,29297,32,404,0,29733,29145,199
17-08-2021,kancheepuram,387,30,38,2,377,72308,30,4,0,72342,70747,1218
17-08-2021,kanyakumari,341,31,24,0,348,60472,31,124,0,60627,59252,1027
17-08-2021,karur,203,14,17,0,200,22870,14,47,0,22931,22380,351
17-08-2021,krishnagiri,256,25,27,0,254,41537,25,233,0,41795,41214,327
17-08-2021,madurai,199,13,18,0,194,73636,13,171,0,73820,72478,1148
17-08-2021,mayiladuthurai,288,27,29,0,286,21451,27,39,0,21517,20957,274
17-08-2021,nagapattinam,363,33,31,2,363,19154,33,53,0,19240,18579,298
17-08-2021,namakkal,509,56,52,0,513,47937,56,112,0,48105,47131,461
17-08-2021,nilgiris,481,35,44,1,471,31228,35,44,0,31307,30647,189
17-08-2021,perambalur,80,7,9,0,78,11607,7,3,0,11617,11313,226
17-08-2021,pudukottai,407,36,28,0,415,28653,36,35,0,28724,27933,376
17-08-2021,ramanathapuram,65,5,8,0,62,19998,5,135,0,20138,19724,352
17-08-2021,ranipet,212,21,20,1,212,42227,21,49,0,42297,41338,747
17-08-2021,salem,993,117,78,2,1030,94511,117,437,0,95065,92422,1613
17-08-2021,sivagangai,225,19,23,0,221,19013,19,108,0,19140,18720,199
17-08-2021,tenkasi,79,6,12,0,73,26901,6,58,0,26965,26408,484
17-08-2021,thanjavur,1102,121,118,1,1104,69500,121,22,0,69643,67666,873
17-08-2021,theni,112,9,11,0,110,43042,9,45,0,43096,42471,515
17-08-2021,thirupathur,129,5,16,1,117,28326,5,118,0,28449,27724,608
17-08-2021,thiruvallur,924,70,87,1,906,114811,70,10,0,114891,112213,1772
17-08-2021,thiruvannamalai,487,40,39,1,487,52423,40,398,0,52861,51730,644
17-08-2021,thiruvarur,489,33,32,2,488,38485,33,38,0,38556,37684,384
17-08-2021,thoothukudi,148,8,18,0,138,55044,8,275,0,55327,54791,398
17-08-2021,tirunelveli,233,20,19,0,234,47801,20,427,0,48248,47584,430
17-08-2021,tiruppur,904,77,88,2,891,89180,77,11,0,89268,87481,896
17-08-2021,trichy,727,56,79,2,702,73491,56,60,0,73607,71916,989
17-08-2021,vellore,344,30,14,1,359,46817,30,1664,0,48511,47048,1104
17-08-2021,villupuram,332,28,26,0,334,44174,28,174,0,44376,43697,345
17-08-2021,virudhunagar,111,4,6,0,109,45559,4,104,0,45667,45016,542
17-08-2021,airport surveillance (international),5,0,0,0,5,0,0,1020,0,1020,1014,1
17-08-2021,airport surveillance (domestic),2,0,0,0,2,0,0,1080,0,1080,1077,1
17-08-2021,railway surveillance,0,0,0,0,0,0,0,428,0,428,428,0
18-08-2021,ariyalur,349,19,36,0,332,15478,19,20,0,15517,14955,230
18-08-2021,chengalpattu,1233,118,126,1,1224,160365,118,5,0,160488,156879,2385
18-08-2021,chennai,1656,150,139,4,1663,536009,150,47,0,536206,526247,8296
18-08-2021,coimbatore,3102,220,391,4,2927,226598,220,51,0,226869,221810,2132
18-08-2021,cuddalore,867,94,77,0,884,59200,94,203,0,59497,57812,801
18-08-2021,dharmapuri,569,35,56,0,548,25430,35,216,0,25681,24903,230
18-08-2021,dindigul,215,24,22,2,215,31866,24,77,0,31967,31135,617
18-08-2021,erode,2309,128,216,1,2220,91722,128,94,0,91944,89105,619
18-08-2021,kallakurichi,746,49,68,0,727,28041,49,404,0,28494,27570,197
18-08-2021,kancheepuram,440,48,41,1,446,71112,48,4,0,71164,69517,1201
18-08-2021,kanyakumari,506,35,43,0,498,59538,35,124,0,59697,58187,1012
18-08-2021,karur,257,18,23,0,252,22400,18,47,0,22465,21863,350
18-08-2021,krishnagiri,558,24,57,2,523,40724,24,230,0,40978,40137,318
18-08-2021,madurai,442,27,61,0,408,73001,27,171,0,73199,71651,1140
18-08-2021,mayiladuthurai,327,20,31,0,316,20630,20,39,0,20689,20109,264
18-08-2021,nagapattinam,390,40,22,0,408,18238,40,53,0,18331,17637,286
18-08-2021,namakkal,828,60,67,0,821,46299,60,112,0,46471,45214,436
18-08-2021,nilgiris,926,54,64,0,916,29766,54,44,0,29864,28776,172
18-08-2021,perambalur,191,9,12,0,188,11363,9,3,0,11375,10973,214
18-08-2021,pudukottai,433,31,41,1,422,27704,31,35,0,27770,26996,352
18-08-2021,ramanathapuram,158,13,16,0,155,19752,13,135,0,19900,19403,342
18-08-2021,ranipet,395,21,37,1,378,41590,21,49,0,41660,40546,736
18-08-2021,salem,1760,142,178,2,1722,91427,142,436,0,92005,88756,1527
18-08-2021,sivagangai,415,27,46,0,396,18358,27,108,0,18493,17903,194
18-08-2021,tenkasi,177,10,12,0,175,26617,10,58,0,26685,26033,477
18-08-2021,thanjavur,1859,120,213,1,1765,66471,120,22,0,66613,64018,830
18-08-2021,theni,290,14,24,2,278,42710,14,45,0,42769,41980,511
18-08-2021,thirupathur,277,28,16,1,288,27802,28,118,0,27948,27066,594
18-08-2021,thiruvallur,793,70,71,1,791,112482,70,10,0,112562,110032,1739
18-08-2021,thiruvannamalai,980,83,103,0,960,50795,83,398,0,51276,49688,628
18-08-2021,thiruvarur,375,28,36,0,367,37389,28,38,0,37455,36725,363
18-08-2021,thoothukudi,371,17,33,1,354,54566,17,275,0,54858,54119,385
18-08-2021,tirunelveli,194,20,16,0,198,47108,20,427,0,47555,46933,424
18-08-2021,tiruppur,1605,121,119,2,1605,86465,121,11,0,86597,84179,813
18-08-2021,trichy,1200,76,106,0,1170,71406,76,60,0,71542,69424,948
18-08-2021,vellore,452,30,31,2,449,45986,29,1632,1,47648,46113,1086
18-08-2021,villupuram,539,34,49,0,524,43179,34,174,0,43387,42527,336
18-08-2021,virudhunagar,402,22,44,0,380,45147,22,104,0,45273,44356,537
18-08-2021,airport surveillance (international),4,0,0,0,4,0,0,1007,0,1007,1002,1
18-08-2021,airport surveillance (domestic),0,0,0,0,0,0,0,1075,0,1075,1074,1
18-08-2021,railway surveillance,0,0,0,0,0,0,0,428,0,428,428,0
19-08-2021,ariyalur,210,18,19,0,209,16133,18,20,0,16171,15719,243
19-08-2021,chengalpattu,1131,98,106,0,1123,164066,98,5,0,164169,160625,2421
19-08-2021,chennai,2069,193,184,4,2074,541770,193,47,0,542010,531563,8373
19-08-2021,coimbatore,2356,198,246,5,2303,233392,198,51,0,233641,229106,2232
19-08-2021,cuddalore,706,50,63,1,692,61466,50,203,0,61719,60200,827
19-08-2021,dharmapuri,264,26,28,1,261,26347,26,216,0,26589,26088,240
19-08-2021,dindigul,114,11,12,0,113,32308,11,77,0,32396,31653,630
19-08-2021,erode,1836,147,163,0,1820,96627,147,94,0,96868,94406,642
19-08-2021,kallakurichi,375,27,38,0,364,29357,27,404,0,29788,29225,199
19-08-2021,kancheepuram,375,35,49,1,360,72382,35,4,0,72421,70840,1221
19-08-2021,kanyakumari,344,23,32,1,334,60527,23,124,0,60674,59312,1028
19-08-2021,karur,197,16,16,0,197,22900,16,47,0,22963,22415,351
19-08-2021,krishnagiri,260,26,26,0,260,41592,26,233,0,41851,41264,327
19-08-2021,madurai,193,12,18,0,187,73665,12,171,0,73848,72512,1149
19-08-2021,mayiladuthurai,289,16,34,0,271,21512,16,39,0,21567,21022,274
19-08-2021,nagapattinam,358,38,22,0,374,19212,38,53,0,19303,18628,301
19-08-2021,namakkal,524,51,51,1,523,48058,51,112,0,48221,47236,462
19-08-2021,nilgiris,464,31,46,0,449,31299,31,44,0,31374,30735,190
19-08-2021,perambalur,73,7,9,0,71,11620,7,3,0,11630,11333,226
19-08-2021,pudukottai,412,31,42,0,401,28723,31,35,0,28789,28012,376
19-08-2021,ramanathapuram,61,3,8,0,56,20009,3,135,0,20147,19739,352
19-08-2021,ranipet,215,21,17,0,219,42274,21,49,0,42344,41378,747
19-08-2021,salem,1050,94,76,1,1067,94736,94,437,0,95267,92582,1618
19-08-2021,sivagangai,215,21,24,1,211,19047,21,108,0,19176,18765,200
19-08-2021,tenkasi,68,10,6,0,72,26911,10,58,0,26979,26423,484
19-08-2021,thanjavur,1088,112,98,0,1102,69711,112,22,0,69845,67870,873
19-08-2021,theni,109,9,7,0,111,43062,9,45,0,43116,42490,515
19-08-2021,thirupathur,110,5,13,2,100,28338,5,118,0,28461,27751,610
19-08-2021,thiruvallur,884,64,93,0,855,114950,64,10,0,115024,112397,1772
19-08-2021,thiruvannamalai,482,37,47,0,472,52503,37,398,0,52938,51820,646
19-08-2021,thiruvarur,487,35,45,3,474,38557,35,38,0,38630,37768,388
19-08-2021,thoothukudi,134,12,14,0,132,55063,12,275,0,55350,54820,398
19-08-2021,tirunelveli,229,17,29,0,217,47840,17,427,0,48284,47637,430
19-08-2021,tiruppur,898,86,92,3,889,89354,86,11,0,89451,87659,903
19-08-2021,trichy,693,55,62,3,683,73607,55,60,0,73722,72045,994
19-08-2021,vellore,358,29,19,1,367,46865,29,1664,0,48558,47085,1106
19-08-2021,villupuram,345,34,27,0,352,44239,34,174,0,44447,43749,346
19-08-2021,virudhunagar,100,4,11,1,92,45568,4,104,0,45676,45041,543
19-08-2021,airport surveillance (international),5,0,0,0,5,0,0,1020,0,1020,1014,1
19-08-2021,airport surveillance (domestic),2,0,0,0,2,0,0,1080,0,1080,1077,1
19-08-2021,railway surveillance,0,0,0,0,0,0,0,428,0,428,428,0
20-08-2021,ariyalur,209,15,25,0,199,16151,15,20,0,16186,15744,243
20-08-2021,chengalpattu,1125,102,94,0,1133,164166,102,5,0,164273,160719,2421
20-08-2021,chennai,2077,185,167,1,2094,541966,185,47,0,542198,531730,8374
20-08-2021,coimbatore,2303,199,234,2,2266,233590,199,51,0,233840,229340,2234
20-08-2021,cuddalore,691,59,68,3,679,61515,59,203,0,61777,60268,830
20-08-2021,dharmapuri,261,23,31,0,253,26373,23,216,0,26612,26119,240
20-08-2021,dindigul,113,9,13,0,109,32319,9,77,0,32405,31666,630
20-08-2021,erode,1810,158,168,0,1800,96764,158,94,0,97016,94574,642
20-08-2021,kallakurichi,364,26,36,0,354,29384,26,404,0,29814,29261,199
20-08-2021,kancheepuram,358,33,48,0,343,72415,33,4,0,72452,70888,1221
20-08-2021,kanyakumari,334,27,34,0,327,60550,27,124,0,60701,59346,1028
20-08-2021,karur,196,12,18,0,190,22915,12,47,0,22974,22433,351
20-08-2021,krishnagiri,260,22,20,1,261,41618,22,233,0,41873,41284,328
20-08-2021,madurai,188,11,21,0,178,73678,11,171,0,73860,72533,1149
20-08-2021,mayiladuthurai,280,13,32,0,261,21537,13,39,0,21589,21054,274
20-08-2021,nagapattinam,366,36,26,2,374,19242,36,53,0,19331,18654,303
20-08-2021,namakkal,533,52,53,1,531,48119,52,112,0,48283,47289,463
20-08-2021,nilgiris,449,39,49,1,438,31330,39,44,0,31413,30784,191
20-08-2021,perambalur,71,4,8,0,67,11627,4,3,0,11634,11341,226
20-08-2021,pudukottai,401,30,51,0,380,28754,30,35,0,28819,28063,376
20-08-2021,ramanathapuram,56,4,6,0,54,20012,4,135,0,20151,19745,352
20-08-2021,ranipet,219,22,12,1,228,42295,22,49,0,42366,41390,748
20-08-2021,salem,1067,85,64,0,1088,94830,85,437,0,95352,92646,1618
20-08-2021,sivagangai,210,20,28,0,202,19067,20,108,0,19195,18793,200
20-08-2021,tenkasi,72,9,7,0,74,26921,9,58,0,26988,26430,484
20-08-2021,thanjavur,1096,98,96,0,1098,69817,98,22,0,69937,67966,873
20-08-2021,theni,111,6,9,0,108,43071,6,45,0,43122,42499,515
20-08-2021,thirupathur,101,7,10,0,98,28344,7,118,0,28469,27761,610
20-08-2021,thiruvallur,856,57,88,1,824,115015,57,10,0,115082,112485,1773
20-08-2021,thiruvannamalai,475,32,54,0,453,52543,32,398,0,52973,51874,646
20-08-2021,thiruvarur,476,31,44,2,461,38594,31,38,0,38663,37812,390
20-08-2021,thoothukudi,132,10,17,0,125,55075,10,275,0,55360,54837,398
20-08-2021,tirunelveli,217,26,24,0,219,47857,26,427,0,48310,47661,430
20-08-2021,tiruppur,886,80,98,5,863,89437,80,11,0,89528,87757,908
20-08-2021,trichy,686,54,67,3,670,73665,54,60,0,73779,72112,997
20-08-2021,vellore,364,31,22,0,373,46891,31,1664,0,48586,47107,1106
20-08-2021,villupuram,352,32,30,1,353,44273,32,174,0,44479,43779,347
20-08-2021,virudhunagar,92,8,14,0,86,45572,8,104,0,45684,45055,543
20-08-2021,airport surveillance (international),5,0,1,0,4,0,0,1020,0,1020,1015,1
20-08-2021,airport surveillance (domestic),2,1,0,0,3,0,0,1080,1,1081,1077,1
20-08-2021,railway surveillance,0,0,0,0,0,0,0,428,0,428,428,0
21-08-2021,ariyalur,200,16,26,0,190,16167,16,20,0,16203,15770,243
21-08-2021,chengalpattu,1134,99,98,0,1135,164269,99,5,0,164373,160817,2421
21-08-2021,chennai,2091,183,153,1,2120,542148,183,47,0,542378,531883,8375
21-08-2021,coimbatore,2267,205,226,2,2244,233790,205,51,0,234046,229566,2236
21-08-2021,cuddalore,678,57,72,0,663,61573,57,203,0,61833,60340,830
21-08-2021,dharmapuri,253,21,33,0,241,26396,21,216,0,26633,26152,240
21-08-2021,dindigul,109,8,11,0,106,32328,8,77,0,32413,31677,630
21-08-2021,erode,1790,152,174,0,1768,96912,152,94,0,97158,94748,642
21-08-2021,kallakurichi,354,24,39,0,339,29410,24,404,0,29838,29300,199
21-08-2021,kancheepuram,343,31,46,0,328,72448,31,4,0,72483,70934,1221
21-08-2021,kanyakumari,327,25,36,1,315,60577,25,124,0,60726,59382,1029
21-08-2021,karur,190,13,15,0,188,22927,13,47,0,22987,22448,351
21-08-2021,krishnagiri,261,20,22,0,259,41640,20,233,0,41893,41306,328
21-08-2021,madurai,176,14,17,0,173,73687,14,171,0,73872,72550,1149
21-08-2021,mayiladuthurai,270,14,28,0,256,21559,14,39,0,21612,21082,274
21-08-2021,nagapattinam,365,48,29,1,383,19269,48,53,0,19370,18683,304
21-08-2021,namakkal,530,50,57,2,521,48170,50,112,0,48332,47346,465
21-08-2021,nilgiris,439,36,51,1,423,31370,36,44,0,31450,30835,192
21-08-2021,perambalur,68,5,6,0,67,11632,5,3,0,11640,11347,226
21-08-2021,pudukottai,380,25,54,3,348,28784,25,35,0,28844,28117,379
21-08-2021,ramanathapuram,54,3,7,0,50,20016,3,135,0,20154,19752,352
21-08-2021,ranipet,229,20,18,1,230,42318,20,49,0,42387,41408,749
21-08-2021,salem,1096,79,61,3,1111,94923,79,437,0,95439,92707,1621
21-08-2021,sivagangai,203,21,23,0,201,19088,21,108,0,19217,18816,200
21-08-2021,tenkasi,74,8,9,0,73,26930,8,58,0,26996,26439,484
21-08-2021,thanjavur,1093,95,88,1,1099,69910,95,22,0,70027,68054,874
21-08-2021,theni,108,5,5,0,108,43077,5,45,0,43127,42504,515
21-08-2021,thirupathur,97,15,12,2,98,28350,15,118,0,28483,27773,612
21-08-2021,thiruvallur,826,58,81,0,803,115074,58,10,0,115142,112566,1773
21-08-2021,thiruvannamalai,454,31,48,1,436,52576,31,398,0,53005,51922,647
21-08-2021,thiruvarur,465,39,46,0,458,38629,39,38,0,38706,37858,390
21-08-2021,thoothukudi,125,13,15,0,123,55085,13,275,0,55373,54852,398
21-08-2021,tirunelveli,219,15,30,0,204,47883,15,427,0,48325,47691,430
21-08-2021,tiruppur,865,76,87,3,851,89519,76,11,0,89606,87844,911
21-08-2021,trichy,672,52,65,1,658,73721,52,60,0,73833,72177,998
21-08-2021,vellore,370,27,25,0,372,46919,27,1664,0,48610,47132,1106
21-08-2021,villupuram,353,43,34,0,362,44305,43,174,0,44522,43813,347
21-08-2021,virudhunagar,86,6,12,0,80,45580,6,104,0,45690,45067,543
21-08-2021,airport surveillance (international),4,0,0,0,4,0,0,1020,0,1020,1015,1
21-08-2021,airport surveillance (domestic),3,0,0,0,3,0,0,1081,0,1081,1077,1
21-08-2021,railway surveillance,0,0,0,0,0,0,0,428,0,428,428,0
22-08-2021,ariyalur,190,14,23,1,180,16183,14,20,0,16217,15793,244
22-08-2021,chengalpattu,1135,96,103,1,1127,164368,96,5,0,164469,160920,2422
22-08-2021,chennai,2120,177,164,4,2129,542331,177,47,0,542555,532047,8379
22-08-2021,coimbatore,2244,198,212,1,2229,233995,198,51,0,234244,229778,2237
22-08-2021,cuddalore,663,54,76,0,641,61630,54,203,0,61887,60416,830
22-08-2021,dharmapuri,241,23,31,0,233,26417,23,216,0,26656,26183,240
22-08-2021,dindigul,106,7,11,1,101,32336,7,77,0,32420,31688,631
22-08-2021,erode,1768,146,186,0,1728,97064,146,94,0,97304,94934,642
22-08-2021,kallakurichi,339,22,36,0,325,29434,22,404,0,29860,29336,199
22-08-2021,kancheepuram,328,36,34,0,330,72479,36,4,0,72519,70968,1221
22-08-2021,kanyakumari,315,27,32,0,310,60602,27,124,0,60753,59414,1029
22-08-2021,karur,188,15,16,0,187,22940,15,47,0,23002,22464,351
22-08-2021,krishnagiri,259,18,14,0,263,41660,18,233,0,41911,41320,328
22-08-2021,madurai,173,12,21,0,164,73701,12,171,0,73884,72571,1149
22-08-2021,mayiladuthurai,256,21,27,1,249,21573,21,39,0,21633,21109,275
22-08-2021,nagapattinam,383,45,24,0,404,19317,45,53,0,19415,18707,304
22-08-2021,namakkal,521,47,41,0,527,48220,47,112,0,48379,47387,465
22-08-2021,nilgiris,423,33,48,1,407,31406,33,44,0,31483,30883,193
22-08-2021,perambalur,67,4,5,1,65,11637,4,3,0,11644,11352,227
22-08-2021,pudukottai,348,26,42,1,331,28809,26,35,0,28870,28159,380
22-08-2021,ramanathapuram,50,2,4,0,48,20019,2,135,0,20156,19756,352
22-08-2021,ranipet,230,18,15,0,233,42338,18,49,0,42405,41423,749
22-08-2021,salem,1111,82,64,1,1128,95002,82,437,0,95521,92771,1622
22-08-2021,sivagangai,201,19,19,0,201,19109,19,108,0,19236,18835,200
22-08-2021,tenkasi,73,6,6,0,73,26938,6,58,0,27002,26445,484
22-08-2021,thanjavur,1099,108,83,2,1122,70005,108,22,0,70135,68137,876
22-08-2021,theni,108,9,7,0,110,43082,9,45,0,43136,42511,515
22-08-2021,thirupathur,98,11,13,0,96,28365,11,118,0,28494,27786,612
22-08-2021,thiruvallur,803,65,95,3,770,115132,65,10,0,115207,112661,1776
22-08-2021,thiruvannamalai,436,42,46,0,432,52607,42,398,0,53047,51968,647
22-08-2021,thiruvarur,458,37,51,1,443,38668,37,38,0,38743,37909,391
22-08-2021,thoothukudi,123,11,18,1,115,55098,11,275,0,55384,54870,399
22-08-2021,tirunelveli,204,13,25,0,192,47898,13,427,0,48338,47716,430
22-08-2021,tiruppur,851,70,72,2,847,89595,70,11,0,89676,87916,913
22-08-2021,trichy,658,51,68,1,640,73773,51,60,0,73884,72245,999
22-08-2021,vellore,372,26,39,0,359,46946,26,1664,0,48636,47171,1106
22-08-2021,villupuram,362,34,44,0,352,44348,34,174,0,44556,43857,347
22-08-2021,virudhunagar,80,5,10,0,75,45586,5,104,0,45695,45077,543
22-08-2021,airport surveillance (international),4,0,0,0,4,0,0,1020,0,1020,1015,1
22-08-2021,airport surveillance (domestic),3,0,2,0,1,0,0,1081,0,1081,1079,1
22-08-2021,railway surveillance,0,0,0,0,0,0,0,428,0,428,428,0
23-08-2021,ariyalur,179,13,20,2,170,16196,13,20,0,16229,15813,246
23-08-2021,chengalpattu,1128,94,105,0,1117,164465,94,5,0,164564,161025,2422
23-08-2021,chennai,2131,172,204,4,2095,542510,172,47,0,542729,532251,8383
23-08-2021,coimbatore,2234,195,210,4,2215,234198,195,51,0,234444,229988,2241
23-08-2021,cuddalore,642,51,79,0,614,61685,51,203,0,61939,60495,830
23-08-2021,dharmapuri,233,22,36,0,219,26440,22,216,0,26678,26219,240
23-08-2021,dindigul,96,13,5,0,104,32338,13,77,0,32428,31693,631
23-08-2021,erode,1719,143,189,0,1673,97201,143,94,0,97438,95123,642
23-08-2021,kallakurichi,325,20,25,0,320,29456,20,404,0,29880,29361,199
23-08-2021,kancheepuram,330,34,32,2,330,72515,34,4,0,72553,71000,1223
23-08-2021,kanyakumari,310,26,37,0,299,60629,26,124,0,60779,59451,1029
23-08-2021,karur,186,16,11,0,191,22954,16,47,0,23017,22475,351
23-08-2021,krishnagiri,264,16,23,0,257,41679,16,233,0,41928,41343,328
23-08-2021,madurai,163,11,17,1,156,73712,10,171,1,73894,72588,1150
23-08-2021,mayiladuthurai,250,20,22,2,246,21595,20,39,0,21654,21131,277
23-08-2021,nagapattinam,406,41,32,0,415,19364,41,53,0,19458,18739,304
23-08-2021,namakkal,525,46,48,0,523,48265,46,112,0,48423,47435,465
23-08-2021,nilgiris,407,32,42,0,397,31439,32,44,0,31515,30925,193
23-08-2021,perambalur,67,3,3,0,67,11643,3,3,0,11649,11355,227
23-08-2021,pudukottai,334,24,38,1,319,28838,24,35,0,28897,28197,381
23-08-2021,ramanathapuram,48,3,2,0,49,20021,3,135,0,20159,19758,352
23-08-2021,ranipet,236,21,21,0,236,42359,21,49,0,42429,41444,749
23-08-2021,salem,1133,80,86,0,1127,95089,80,437,0,95606,92857,1622
23-08-2021,sivagangai,201,18,19,0,200,19128,18,108,0,19254,18854,200
23-08-2021,tenkasi,68,7,4,0,71,26939,7,58,0,27004,26449,484
23-08-2021,thanjavur,1121,104,100,4,1121,70112,104,22,0,70238,68237,880
23-08-2021,theni,106,8,10,0,104,43087,8,45,0,43140,42521,515
23-08-2021,thirupathur,96,10,8,0,98,28376,10,118,0,28504,27794,612
23-08-2021,thiruvallur,772,63,83,1,751,115200,63,10,0,115273,112744,1778
23-08-2021,thiruvannamalai,433,39,47,1,424,52650,39,398,0,53087,52015,648
23-08-2021,thiruvarur,445,36,49,0,432,38707,36,38,0,38781,37958,391
23-08-2021,thoothukudi,117,12,13,0,116,55110,12,275,0,55397,54883,398
23-08-2021,tirunelveli,193,11,25,0,179,47912,11,427,0,48350,47741,430
23-08-2021,tiruppur,853,68,68,2,851,89671,68,11,0,89750,87984,915
23-08-2021,trichy,633,48,64,1,616,73817,48,60,0,73925,72309,1000
23-08-2021,vellore,354,45,30,0,369,46967,45,1664,0,48676,47201,1106
23-08-2021,villupuram,352,31,49,0,334,44382,31,174,0,44587,43906,347
23-08-2021,virudhunagar,76,8,7,0,77,45592,8,104,0,45704,45084,543
23-08-2021,airport surveillance (international),4,0,0,0,4,0,0,1020,0,1020,1015,1
23-08-2021,airport surveillance (domestic),1,0,0,0,1,0,0,1081,0,1081,1079,1
23-08-2021,railway surveillance,0,0,0,0,0,0,0,428,0,428,428,0
24-08-2021,ariyalur,171,11,17,0,165,16210,11,20,0,16241,15830,246
24-08-2021,chengalpattu,1109,92,98,2,1101,164551,92,5,0,164648,161123,2424
24-08-2021,chennai,2103,165,216,3,2049,542690,165,47,0,542902,532467,8386
24-08-2021,coimbatore,2218,190,223,4,2181,234396,190,51,0,234637,230211,2245
24-08-2021,cuddalore,614,69,65,2,616,61736,69,203,0,62008,60560,832
24-08-2021,dharmapuri,220,19,24,2,213,26463,19,216,0,26698,26243,242
24-08-2021,dindigul,101,15,7,0,109,32348,15,77,0,32440,31700,631
24-08-2021,erode,1669,138,168,1,1638,97340,138,94,0,97572,95291,643
24-08-2021,kallakurichi,319,38,31,0,326,29475,38,404,0,29917,29392,199
24-08-2021,kancheepuram,335,31,36,0,330,72554,31,4,0,72589,71036,1223
24-08-2021,kanyakumari,299,24,34,0,289,60655,24,124,0,60803,59485,1029
24-08-2021,karur,191,13,18,0,186,22970,13,47,0,23030,22493,351
24-08-2021,krishnagiri,254,15,21,0,248,41692,15,233,0,41940,41364,328
24-08-2021,madurai,156,14,14,0,156,73722,14,172,0,73908,72602,1150
24-08-2021,mayiladuthurai,250,19,25,0,244,21619,19,39,0,21677,21156,277
24-08-2021,nagapattinam,414,36,39,0,411,19404,36,53,0,19493,18778,304
24-08-2021,namakkal,523,44,41,0,526,48311,44,112,0,48467,47476,465
24-08-2021,nilgiris,397,30,38,0,389,31471,30,44,0,31545,30963,193
24-08-2021,perambalur,67,7,4,2,68,11646,7,3,0,11656,11359,229
24-08-2021,pudukottai,319,25,32,0,312,28862,25,35,0,28922,28229,381
24-08-2021,ramanathapuram,49,2,5,0,46,20024,2,135,0,20161,19763,352
24-08-2021,ranipet,235,19,19,0,235,42379,19,49,0,42447,41463,749
24-08-2021,salem,1130,79,108,2,1099,95172,79,437,0,95688,92965,1624
24-08-2021,sivagangai,200,16,12,0,204,19146,16,108,0,19270,18866,200
24-08-2021,tenkasi,71,5,4,0,72,26946,5,58,0,27009,26453,484
24-08-2021,thanjavur,1113,98,95,1,1115,70208,98,22,0,70328,68332,881
24-08-2021,theni,105,13,11,0,107,43096,13,45,0,43154,42532,515
24-08-2021,thirupathur,99,18,7,0,110,28387,18,118,0,28523,27801,612
24-08-2021,thiruvallur,752,60,79,1,732,115264,60,10,0,115334,112823,1779
24-08-2021,thiruvannamalai,426,37,45,1,417,52691,37,398,0,53126,52060,649
24-08-2021,thiruvarur,432,34,51,1,414,38743,34,38,0,38815,38009,392
24-08-2021,thoothukudi,116,10,16,0,110,55122,10,275,0,55407,54899,398
24-08-2021,tirunelveli,179,10,22,0,167,47923,10,427,0,48360,47763,430
24-08-2021,tiruppur,851,65,73,5,838,89739,65,11,0,89815,88057,920
24-08-2021,trichy,617,46,58,0,605,73866,46,60,0,73972,72367,1000
24-08-2021,vellore,367,42,42,0,367,47010,42,1664,0,48716,47243,1106
24-08-2021,villupuram,334,29,33,0,330,44413,29,174,0,44616,43939,347
24-08-2021,virudhunagar,77,6,10,0,73,45600,6,104,0,45710,45094,543
24-08-2021,airport surveillance (international),4,0,1,0,3,0,0,1020,0,1020,1016,1
24-08-2021,airport surveillance (domestic),1,1,0,0,2,0,0,1081,1,1082,1079,1
24-08-2021,railway surveillance,0,0,0,0,0,0,0,428,0,428,428,0
25-08-2021,ariyalur,166,16,16,1,165,16222,16,20,0,16258,15846,247
25-08-2021,chengalpattu,1102,90,87,2,1103,164645,90,5,0,164740,161210,2427
25-08-2021,chennai,2044,170,209,3,2002,542848,170,47,0,543065,532676,8387
25-08-2021,coimbatore,2183,181,228,4,2132,234588,181,51,0,234820,230439,2249
25-08-2021,cuddalore,616,54,71,0,599,61805,54,203,0,62062,60631,832
25-08-2021,dharmapuri,213,16,20,0,209,26482,16,216,0,26714,26263,242
25-08-2021,dindigul,111,10,9,0,112,32365,10,77,0,32452,31709,631
25-08-2021,erode,1643,130,157,0,1616,97483,130,94,0,97707,95448,643
25-08-2021,kallakurichi,327,35,34,0,328,29514,35,404,0,29953,29426,199
25-08-2021,kancheepuram,331,33,32,1,331,72586,33,4,0,72623,71068,1224
25-08-2021,kanyakumari,289,26,28,2,285,60679,26,124,0,60829,59513,1031
25-08-2021,karur,185,18,21,1,181,22982,18,47,0,23047,22514,352
25-08-2021,krishnagiri,249,31,23,1,256,41708,31,233,0,41972,41387,329
25-08-2021,madurai,153,12,18,1,146,73733,12,172,0,73917,72620,1151
25-08-2021,mayiladuthurai,247,24,27,0,244,21641,24,39,0,21704,21183,277
25-08-2021,nagapattinam,412,27,42,0,397,19441,27,53,0,19521,18820,304
25-08-2021,namakkal,524,52,38,0,538,48353,52,112,0,48517,47514,465
25-08-2021,nilgiris,389,37,44,0,382,31501,37,44,0,31582,31007,193
25-08-2021,perambalur,68,5,6,0,67,11653,5,3,0,11661,11365,229
25-08-2021,pudukottai,312,29,26,0,315,28887,29,35,0,28951,28255,381
25-08-2021,ramanathapuram,46,7,4,0,49,20026,7,135,0,20168,19767,352
25-08-2021,ranipet,238,17,22,1,232,42401,17,49,0,42467,41485,750
25-08-2021,salem,1101,73,103,0,1071,95253,72,437,1,95763,93068,1624
25-08-2021,sivagangai,204,22,14,2,210,19162,22,108,0,19292,18880,202
25-08-2021,tenkasi,72,9,5,0,76,26951,9,58,0,27018,26458,484
25-08-2021,thanjavur,1115,84,97,0,1102,70306,84,22,0,70412,68429,881
25-08-2021,theni,107,14,12,0,109,43109,14,45,0,43168,42544,515
25-08-2021,thirupathur,102,11,10,0,103,28397,11,118,0,28526,27811,612
25-08-2021,thiruvallur,729,71,83,1,716,115322,71,10,0,115403,112906,1781
25-08-2021,thiruvannamalai,419,30,43,1,405,52730,30,398,0,53158,52103,650
25-08-2021,thiruvarur,414,28,48,0,394,38777,28,38,0,38843,38057,392
25-08-2021,thoothukudi,111,14,11,1,113,55133,14,275,0,55422,54910,399
25-08-2021,tirunelveli,166,7,13,0,160,47932,7,427,0,48366,47776,430
25-08-2021,tiruppur,831,72,65,2,836,89797,72,11,0,89880,88122,922
25-08-2021,trichy,607,45,52,3,597,73914,45,60,0,74019,72419,1003
25-08-2021,vellore,369,34,47,0,356,47054,34,1664,0,48752,47290,1106
25-08-2021,villupuram,330,32,24,0,338,44442,32,174,0,44648,43963,347
25-08-2021,virudhunagar,73,7,8,0,72,45606,7,104,0,45717,45102,543
25-08-2021,airport surveillance (international),3,0,0,0,3,0,0,1020,0,1020,1016,1
25-08-2021,airport surveillance (domestic),2,0,0,0,2,0,0,1082,0,1082,1079,1
25-08-2021,railway surveillance,0,0,0,0,0,0,0,428,0,428,428,0
26-08-2021,ariyalur,165,12,13,0,164,16238,12,20,0,16270,15859,247
26-08-2021,chengalpattu,1104,113,95,1,1121,164736,113,5,0,164854,161305,2428
26-08-2021,chennai,2011,175,211,0,1975,543027,175,47,0,543249,532887,8387
26-08-2021,coimbatore,2137,216,232,3,2118,234774,216,51,0,235041,230671,2252
26-08-2021,cuddalore,597,42,68,0,571,61857,42,203,0,62102,60699,832
26-08-2021,dharmapuri,212,14,17,0,209,26501,14,216,0,26731,26280,242
26-08-2021,dindigul,109,9,11,0,107,32372,9,77,0,32458,31720,631
26-08-2021,erode,1591,115,146,3,1557,97588,115,94,0,97797,95594,646
26-08-2021,kallakurichi,328,33,37,0,324,29549,33,404,0,29986,29463,199
26-08-2021,kancheepuram,329,36,26,3,336,72617,36,4,0,72657,71094,1227
26-08-2021,kanyakumari,285,25,31,0,279,60705,25,124,0,60854,59544,1031
26-08-2021,karur,177,11,23,0,165,22996,11,47,0,23054,22537,352
26-08-2021,krishnagiri,255,27,25,0,257,41738,27,233,0,41998,41412,329
26-08-2021,madurai,147,14,15,1,145,73746,14,172,0,73932,72635,1152
26-08-2021,mayiladuthurai,248,29,29,0,248,21669,29,39,0,21737,21212,277
26-08-2021,nagapattinam,394,22,36,0,380,19465,22,53,0,19540,18856,304
26-08-2021,namakkal,550,47,42,1,554,48417,47,112,0,48576,47556,466
26-08-2021,nilgiris,382,38,44,1,375,31538,38,44,0,31620,31051,194
26-08-2021,perambalur,67,9,8,0,68,11659,9,3,0,11671,11373,230
26-08-2021,pudukottai,319,23,30,2,310,28921,23,35,0,28979,28285,384
26-08-2021,ramanathapuram,49,2,5,0,46,20033,2,135,0,20170,19772,352
26-08-2021,ranipet,233,14,28,1,218,42419,14,49,0,42482,41513,751
26-08-2021,salem,1078,65,107,2,1034,95332,65,438,0,95835,93175,1626
26-08-2021,sivagangai,204,23,18,0,209,19177,23,108,0,19308,18898,201
26-08-2021,tenkasi,78,8,6,0,80,26962,8,58,0,27028,26464,484
26-08-2021,thanjavur,1104,59,104,3,1056,70392,59,22,0,70473,68533,884
26-08-2021,theni,110,8,16,0,102,43124,8,45,0,43177,42560,515
26-08-2021,thirupathur,105,18,10,1,112,28410,18,118,0,28546,27821,613
26-08-2021,thiruvallur,712,77,85,1,703,115389,77,10,0,115476,112991,1782
26-08-2021,thiruvannamalai,406,32,46,0,392,52761,32,398,0,53191,52149,650
26-08-2021,thiruvarur,394,20,40,0,374,38805,20,38,0,38863,38097,392
26-08-2021,thoothukudi,113,17,7,0,123,55147,17,275,0,55439,54917,399
26-08-2021,tirunelveli,158,18,12,0,164,47937,18,427,0,48382,47788,430
26-08-2021,tiruppur,840,73,69,2,842,89873,73,11,0,89957,88191,924
26-08-2021,trichy,594,48,54,1,587,73955,48,60,0,74063,72473,1003
26-08-2021,vellore,352,27,36,0,343,47084,27,1664,0,48775,47326,1106
26-08-2021,villupuram,338,30,25,0,343,44474,30,174,0,44678,43988,347
26-08-2021,virudhunagar,72,10,9,0,73,45613,10,104,0,45727,45111,543
26-08-2021,airport surveillance (international),3,0,0,0,3,0,0,1020,0,1020,1016,1
26-08-2021,airport surveillance (domestic),2,0,0,0,2,0,0,1082,0,1082,1079,1
26-08-2021,railway surveillance,0,0,0,0,0,0,0,428,0,428,428,0
27-08-2021,ariyalur,165,17,15,0,167,16251,17,20,0,16288,15874,247
27-08-2021,chengalpattu,1117,126,101,1,1141,164845,126,5,0,164976,161406,2429
27-08-2021,chennai,1971,162,208,3,1922,543199,162,47,0,543408,533095,8391
27-08-2021,coimbatore,2119,231,238,5,2107,234991,231,51,0,235273,230909,2257
27-08-2021,cuddalore,570,41,60,0,551,61898,41,203,0,62142,60759,832
27-08-2021,dharmapuri,211,22,18,0,215,26517,22,216,0,26755,26298,242
27-08-2021,dindigul,106,6,10,0,102,32380,6,77,0,32463,31730,631
27-08-2021,erode,1553,122,152,2,1521,97699,122,94,0,97915,95746,648
27-08-2021,kallakurichi,323,25,30,0,318,29581,25,404,0,30010,29493,199
27-08-2021,kancheepuram,337,34,32,2,337,72654,34,4,0,72692,71126,1229
27-08-2021,kanyakumari,279,32,21,0,290,60730,32,124,0,60886,59565,1031
27-08-2021,karur,166,8,18,0,156,23008,8,47,0,23063,22555,352
27-08-2021,krishnagiri,259,17,26,0,250,41767,17,233,0,42017,41438,329
27-08-2021,madurai,146,13,12,1,146,73761,13,172,0,73946,72647,1153
27-08-2021,mayiladuthurai,251,33,27,0,257,21701,33,39,0,21773,21239,277
27-08-2021,nagapattinam,376,30,31,0,375,19483,30,53,0,19566,18887,304
27-08-2021,namakkal,556,48,45,1,558,48466,48,112,0,48626,47601,467
27-08-2021,nilgiris,374,31,39,0,366,31575,31,44,0,31650,31090,194
27-08-2021,perambalur,69,5,5,0,69,11669,5,3,0,11677,11378,230
27-08-2021,pudukottai,312,25,28,0,309,28946,25,35,0,29006,28313,384
27-08-2021,ramanathapuram,46,5,4,0,47,20035,5,135,0,20175,19776,352
27-08-2021,ranipet,219,15,19,1,214,42434,15,49,0,42498,41532,752
27-08-2021,salem,1037,67,110,0,994,95400,67,438,0,95905,93285,1626
27-08-2021,sivagangai,206,20,14,0,212,19197,20,108,0,19325,18912,201
27-08-2021,tenkasi,80,11,10,0,81,26970,11,58,0,27039,26474,484
27-08-2021,thanjavur,1057,58,98,0,1017,70452,58,22,0,70532,68631,884
27-08-2021,theni,102,7,13,0,96,43132,7,45,0,43184,42573,515
27-08-2021,thirupathur,112,13,11,0,114,28428,13,118,0,28559,27832,613
27-08-2021,thiruvallur,706,70,79,1,696,115468,70,10,0,115548,113070,1782
27-08-2021,thiruvannamalai,394,25,38,0,381,52795,25,398,0,53218,52187,650
27-08-2021,thiruvarur,374,28,34,0,368,38825,28,38,0,38891,38131,392
27-08-2021,thoothukudi,124,12,13,0,123,55165,12,275,0,55452,54930,399
27-08-2021,tirunelveli,163,16,18,0,161,47954,16,427,0,48397,47806,430
27-08-2021,tiruppur,842,64,74,3,829,89946,64,11,0,90021,88265,927
27-08-2021,trichy,587,45,60,0,572,74003,45,60,0,74108,72533,1003
27-08-2021,vellore,338,19,41,1,315,47106,19,1664,0,48789,47367,1107
27-08-2021,villupuram,343,32,35,0,340,44504,32,174,0,44710,44023,347
27-08-2021,virudhunagar,74,6,6,0,74,45624,6,104,0,45734,45117,543
27-08-2021,airport surveillance (international),3,1,0,0,4,0,0,1020,1,1021,1016,1
27-08-2021,airport surveillance (domestic),2,0,0,0,2,0,0,1082,0,1082,1079,1
27-08-2021,railway surveillance,0,0,0,0,0,0,0,428,0,428,428,0
28-08-2021,ariyalur,167,16,12,0,171,16268,16,20,0,16304,15886,247
28-08-2021,chengalpattu,1138,122,109,0,1151,164968,122,5,0,165095,161515,2429
28-08-2021,chennai,1931,182,203,4,1906,543370,182,47,0,543599,533298,8395
28-08-2021,coimbatore,2108,230,247,0,2091,235223,230,51,0,235504,231156,2257
28-08-2021,cuddalore,549,39,52,0,536,61937,39,203,0,62179,60811,832
28-08-2021,dharmapuri,214,25,17,0,222,26538,25,216,0,26779,26315,242
28-08-2021,dindigul,98,7,7,0,98,32382,7,77,0,32466,31737,631
28-08-2021,erode,1515,115,153,3,1474,97815,115,94,0,98024,95899,651
28-08-2021,kallakurichi,318,19,33,1,303,29606,19,404,0,30029,29526,200
28-08-2021,kancheepuram,338,31,21,1,347,72689,31,4,0,72724,71147,1230
28-08-2021,kanyakumari,285,30,25,0,290,60757,30,124,0,60911,59590,1031
28-08-2021,karur,154,17,11,0,160,23014,17,47,0,23078,22566,352
28-08-2021,krishnagiri,251,20,23,1,247,41785,20,233,0,42038,41461,330
28-08-2021,madurai,148,9,14,1,142,73776,9,172,0,73957,72661,1154
28-08-2021,mayiladuthurai,265,25,32,0,258,21742,25,39,0,21806,21271,277
28-08-2021,nagapattinam,366,31,24,0,373,19504,31,53,0,19588,18911,304
28-08-2021,namakkal,564,45,53,2,554,48520,45,112,0,48677,47654,469
28-08-2021,nilgiris,366,26,36,0,356,31606,26,44,0,31676,31126,194
28-08-2021,perambalur,69,6,7,0,68,11674,6,3,0,11683,11385,230
28-08-2021,pudukottai,309,28,31,2,304,28971,28,35,0,29034,28344,386
28-08-2021,ramanathapuram,47,4,6,0,45,20040,4,135,0,20179,19782,352
28-08-2021,ranipet,215,17,22,1,209,42450,17,49,0,42516,41554,753
28-08-2021,salem,994,62,105,3,948,95467,62,438,0,95967,93390,1629
28-08-2021,sivagangai,210,18,13,0,215,19215,18,108,0,19341,18925,201
28-08-2021,tenkasi,81,10,9,0,82,26981,10,58,0,27049,26483,484
28-08-2021,thanjavur,1015,77,87,0,1005,70508,77,22,0,70607,68718,884
28-08-2021,theni,96,8,10,0,94,43139,8,45,0,43192,42583,515
28-08-2021,thirupathur,109,9,8,0,110,28436,9,118,0,28563,27840,613
28-08-2021,thiruvallur,697,72,83,0,686,115539,72,10,0,115621,113153,1782
28-08-2021,thiruvannamalai,384,32,41,1,374,52823,32,398,0,53253,52228,651
28-08-2021,thiruvarur,368,37,37,0,368,38853,37,38,0,38928,38168,392
28-08-2021,thoothukudi,124,7,13,0,118,55178,7,275,0,55460,54943,399
28-08-2021,tirunelveli,163,12,15,0,160,47972,12,427,0,48411,47821,430
28-08-2021,tiruppur,832,61,79,0,814,90013,61,11,0,90085,88344,927
28-08-2021,trichy,574,55,63,0,566,74050,55,60,0,74165,72596,1003
28-08-2021,vellore,315,15,28,1,301,47125,15,1664,0,48804,47395,1108
28-08-2021,villupuram,340,28,30,0,338,44536,28,174,0,44738,44053,347
28-08-2021,virudhunagar,74,4,8,0,70,45630,4,104,0,45738,45125,543
28-08-2021,airport surveillance (international),4,0,1,0,3,0,0,1021,0,1021,1017,1
28-08-2021,airport surveillance (domestic),2,0,0,0,2,0,0,1082,0,1082,1079,1
28-08-2021,railway surveillance,0,0,0,0,0,0,0,428,0,428,428,0
29-08-2021,ariyalur,171,17,14,0,174,16284,17,20,0,16321,15900,247
29-08-2021,chengalpattu,1151,108,116,0,1143,165090,108,5,0,165203,161631,2429
29-08-2021,chennai,1904,189,218,2,1873,543550,189,47,0,543786,533516,8397
29-08-2021,coimbatore,2091,209,239,3,2058,235453,209,51,0,235713,231395,2260
29-08-2021,cuddalore,537,37,43,2,529,61977,37,203,0,62217,60854,834
29-08-2021,dharmapuri,223,23,15,1,230,26564,23,216,0,26803,26330,243
29-08-2021,dindigul,97,5,5,0,97,32388,5,77,0,32470,31742,631
29-08-2021,erode,1471,132,148,2,1453,97927,132,94,0,98153,96047,653
29-08-2021,kallakurichi,303,20,30,0,293,29625,20,404,0,30049,29556,200
29-08-2021,kancheepuram,347,34,19,0,362,72720,34,4,0,72758,71166,1230
29-08-2021,kanyakumari,290,23,22,2,289,60787,23,124,0,60934,59612,1033
29-08-2021,karur,160,11,13,0,158,23031,11,47,0,23089,22579,352
29-08-2021,krishnagiri,246,18,28,1,235,41804,18,233,0,42055,41489,331
29-08-2021,madurai,140,14,11,0,143,73783,14,172,0,73969,72672,1154
29-08-2021,mayiladuthurai,265,22,37,0,250,21774,22,39,0,21835,21308,277
29-08-2021,nagapattinam,370,24,21,0,373,19532,24,53,0,19609,18932,304
29-08-2021,namakkal,556,51,59,0,548,48567,51,112,0,48730,47713,469
29-08-2021,nilgiris,356,29,34,0,351,31632,29,44,0,31705,31160,194
29-08-2021,perambalur,68,10,8,0,70,11680,10,3,0,11693,11393,230
29-08-2021,pudukottai,304,26,36,0,294,28999,26,35,0,29060,28380,386
29-08-2021,ramanathapuram,45,5,4,0,46,20044,5,135,0,20184,19786,352
29-08-2021,ranipet,211,13,18,1,205,42469,13,49,0,42531,41572,754
29-08-2021,salem,949,56,113,1,891,95530,56,438,0,96024,93503,1630
29-08-2021,sivagangai,215,15,10,0,220,19233,15,108,0,19356,18935,201
29-08-2021,tenkasi,82,19,6,0,95,26991,19,58,0,27068,26489,484
29-08-2021,thanjavur,1008,76,94,1,989,70588,76,22,0,70686,68812,885
29-08-2021,theni,94,6,7,0,93,43147,6,45,0,43198,42590,515
29-08-2021,thirupathur,113,15,5,0,123,28448,15,118,0,28581,27845,613
29-08-2021,thiruvallur,685,67,73,0,679,115610,67,10,0,115687,113226,1782
29-08-2021,thiruvannamalai,374,25,44,0,355,52855,25,398,0,53278,52272,651
29-08-2021,thiruvarur,361,39,39,0,361,38883,39,38,0,38960,38207,392
29-08-2021,thoothukudi,118,10,9,0,119,55185,10,275,0,55470,54952,399
29-08-2021,tirunelveli,160,13,14,0,159,47984,13,427,0,48424,47835,430
29-08-2021,tiruppur,818,75,82,1,810,90078,75,11,0,90164,88426,928
29-08-2021,trichy,566,57,67,2,554,74105,57,60,0,74222,72663,1005
29-08-2021,vellore,297,13,17,0,293,47136,13,1664,0,48813,47412,1108
29-08-2021,villupuram,338,27,29,2,334,44564,27,174,0,44765,44082,349
29-08-2021,virudhunagar,70,5,6,1,68,45634,5,104,0,45743,45131,544
29-08-2021,airport surveillance (international),3,0,0,0,3,0,0,1021,0,1021,1017,1
29-08-2021,airport surveillance (domestic),2,0,0,0,2,0,0,1082,0,1082,1079,1
29-08-2021,railway surveillance,0,0,0,0,0,0,0,428,0,428,428,0
30-08-2021,ariyalur,170,16,16,0,170,16297,16,20,0,16333,15916,247
30-08-2021,chengalpattu,1143,92,119,2,1114,165198,92,5,0,165295,161750,2431
30-08-2021,chennai,1872,183,227,1,1827,543738,183,47,0,543968,533743,8398
30-08-2021,coimbatore,2060,188,203,3,2042,235664,188,51,0,235903,231598,2263
30-08-2021,cuddalore,529,34,47,1,515,62014,34,203,0,62251,60901,835
30-08-2021,dharmapuri,230,25,18,0,237,26587,25,216,0,26828,26348,243
30-08-2021,dindigul,97,6,6,0,97,32393,6,77,0,32476,31748,631
30-08-2021,erode,1451,129,159,3,1418,98057,129,94,0,98280,96206,656
30-08-2021,kallakurichi,293,24,32,0,285,29645,24,404,0,30073,29588,200
30-08-2021,kancheepuram,362,32,22,0,372,72754,32,4,0,72790,71188,1230
30-08-2021,kanyakumari,289,30,26,0,293,60810,30,124,0,60964,59638,1033
30-08-2021,karur,157,13,17,0,153,23041,13,47,0,23101,22596,352
30-08-2021,krishnagiri,235,14,25,0,224,41822,14,233,0,42069,41514,331
30-08-2021,madurai,143,17,13,0,147,73797,17,172,0,73986,72685,1154
30-08-2021,mayiladuthurai,255,20,33,1,241,21801,20,39,0,21860,21341,278
30-08-2021,nagapattinam,373,40,28,0,385,19556,40,53,0,19649,18960,304
30-08-2021,namakkal,550,48,64,1,533,48620,48,112,0,48780,47777,470
30-08-2021,nilgiris,351,28,36,0,343,31661,28,44,0,31733,31196,194
30-08-2021,perambalur,72,3,7,0,68,11692,3,3,0,11698,11400,230
30-08-2021,pudukottai,295,25,30,2,288,29026,25,35,0,29086,28410,388
30-08-2021,ramanathapuram,46,2,5,0,43,20049,2,135,0,20186,19791,352
30-08-2021,ranipet,206,14,21,1,198,42483,14,49,0,42546,41593,755
30-08-2021,salem,891,54,92,0,853,95586,54,438,0,96078,93595,1630
30-08-2021,sivagangai,219,12,12,0,219,19247,12,108,0,19367,18947,201
30-08-2021,tenkasi,95,13,8,0,100,27010,13,58,0,27081,26497,484
30-08-2021,thanjavur,992,78,107,1,962,70667,78,22,0,70767,68919,886
30-08-2021,theni,93,2,9,0,86,43153,2,45,0,43200,42599,515
30-08-2021,thirupathur,123,12,7,1,127,28463,12,118,0,28593,27852,614
30-08-2021,thiruvallur,680,63,69,0,674,115678,63,10,0,115751,113295,1782
30-08-2021,thiruvannamalai,358,44,31,0,371,52883,44,398,0,53325,52303,651
30-08-2021,thiruvarur,354,41,34,0,361,38915,41,38,0,38994,38241,392
30-08-2021,thoothukudi,119,15,6,0,128,55195,15,275,0,55485,54958,399
30-08-2021,tirunelveli,159,14,15,0,158,47997,14,427,0,48438,47850,430
30-08-2021,tiruppur,809,73,94,1,787,90152,73,11,0,90236,88520,929
30-08-2021,trichy,555,65,65,1,554,74163,65,60,0,74288,72728,1006
30-08-2021,vellore,289,19,10,1,297,47145,19,1664,0,48828,47422,1109
30-08-2021,villupuram,334,31,23,1,341,44591,31,174,0,44796,44105,350
30-08-2021,virudhunagar,68,4,3,0,69,45639,4,104,0,45747,45134,544
30-08-2021,airport surveillance (international),3,0,0,0,3,0,0,1021,0,1021,1017,1
30-08-2021,airport surveillance (domestic),2,0,0,0,2,0,0,1082,0,1082,1079,1
30-08-2021,railway surveillance,0,0,0,0,0,0,0,428,0,428,428,0
31-08-2021,ariyalur,170,13,20,0,163,16313,13,20,0,16346,15936,247
31-08-2021,chengalpattu,1111,95,110,0,1096,165287,95,5,0,165387,161860,2431
31-08-2021,chennai,1823,189,218,2,1792,543917,189,47,0,544153,533961,8400
31-08-2021,coimbatore,2043,173,185,3,2028,235853,173,51,0,236077,231783,2266
31-08-2021,cuddalore,515,39,40,0,514,62048,39,203,0,62290,60941,835
31-08-2021,dharmapuri,238,19,22,1,234,26613,19,216,0,26848,26370,244
31-08-2021,dindigul,95,5,11,0,89,32397,5,77,0,32479,31759,631
31-08-2021,erode,1413,141,148,1,1405,98181,141,94,0,98416,96354,657
31-08-2021,kallakurichi,285,28,30,0,283,29669,28,404,0,30101,29618,200
31-08-2021,kancheepuram,375,37,39,1,372,72789,37,4,0,72830,71227,1231
31-08-2021,kanyakumari,293,28,28,0,293,60840,28,124,0,60992,59666,1033
31-08-2021,karur,153,11,12,0,152,23054,11,47,0,23112,22608,352
31-08-2021,krishnagiri,224,16,26,0,214,41836,16,233,0,42085,41540,331
31-08-2021,madurai,149,15,12,0,152,73816,15,172,0,74003,72697,1154
31-08-2021,mayiladuthurai,247,29,32,1,243,21827,29,39,0,21895,21373,279
31-08-2021,nagapattinam,380,24,35,0,369,19591,24,53,0,19668,18995,304
31-08-2021,namakkal,536,57,55,0,538,48671,57,112,0,48840,47832,470
31-08-2021,nilgiris,343,25,34,1,333,31689,25,44,0,31758,31230,195
31-08-2021,perambalur,68,9,5,0,72,11695,9,3,0,11707,11405,230
31-08-2021,pudukottai,287,23,28,0,282,29050,23,35,0,29108,28438,388
31-08-2021,ramanathapuram,44,1,4,0,41,20052,1,135,0,20188,19795,352
31-08-2021,ranipet,201,11,18,0,194,42500,11,49,0,42560,41611,755
31-08-2021,salem,852,52,85,1,818,95639,52,438,0,96129,93680,1631
31-08-2021,sivagangai,220,11,15,0,216,19260,11,108,0,19379,18962,201
31-08-2021,tenkasi,99,14,9,0,104,27022,14,58,0,27094,26506,484
31-08-2021,thanjavur,961,98,112,3,944,70744,98,22,0,70864,69031,889
31-08-2021,theni,86,5,8,0,83,43155,5,45,0,43205,42607,515
31-08-2021,thirupathur,126,7,10,0,123,28474,7,118,0,28599,27862,614
31-08-2021,thiruvallur,673,64,67,3,667,115740,64,10,0,115814,113362,1785
31-08-2021,thiruvannamalai,373,29,36,0,366,52929,29,398,0,53356,52339,651
31-08-2021,thiruvarur,362,33,35,1,359,38957,33,38,0,39028,38276,393
31-08-2021,thoothukudi,129,6,13,0,122,55211,6,275,0,55492,54971,399
31-08-2021,tirunelveli,157,12,14,0,155,48010,12,427,0,48449,47864,430
31-08-2021,tiruppur,789,67,87,2,767,90227,67,11,0,90305,88607,931
31-08-2021,trichy,554,66,69,1,550,74228,66,60,0,74354,72797,1007
31-08-2021,vellore,294,30,17,0,307,47161,30,1664,0,48855,47439,1109
31-08-2021,villupuram,341,27,29,1,338,44622,27,174,0,44823,44134,351
31-08-2021,virudhunagar,71,3,7,0,67,45645,3,104,0,45752,45141,544
31-08-2021,airport surveillance (international),3,0,0,0,3,0,0,1021,0,1021,1017,1
31-08-2021,airport surveillance (domestic),2,0,0,0,2,0,0,1082,0,1082,1079,1
31-08-2021,railway surveillance,0,0,0,0,0,0,0,428,0,428,428,0
01-09-2021,ariyalur,159,14,16,0,157,16340,14,20,0,16374,15970,247
01-09-2021,chengalpattu,1083,103,121,0,1065,165484,103,5,0,165592,162095,2432
01-09-2021,chennai,1755,166,185,2,1734,544276,166,47,0,544489,534351,8404
01-09-2021,coimbatore,2047,215,173,5,2084,236215,215,51,0,236481,232124,2273
01-09-2021,cuddalore,503,43,54,0,492,62127,43,203,0,62373,61042,839
01-09-2021,dharmapuri,236,27,21,2,240,26658,27,216,0,26901,26415,246
01-09-2021,dindigul,90,11,5,0,96,32410,11,77,0,32498,31771,631
01-09-2021,erode,1378,132,152,0,1358,98451,132,94,0,98677,96662,657
01-09-2021,kallakurichi,291,16,18,0,289,29728,16,404,0,30148,29659,200
01-09-2021,kancheepuram,375,39,47,0,367,72872,39,4,0,72915,71317,1231
01-09-2021,kanyakumari,286,25,24,0,287,60891,25,124,0,61040,59720,1033
01-09-2021,karur,145,18,15,0,148,23071,18,47,0,23136,22636,352
01-09-2021,krishnagiri,210,13,19,0,204,41870,13,233,0,42116,41581,331
01-09-2021,madurai,155,9,14,1,149,73844,9,172,0,74025,72721,1155
01-09-2021,mayiladuthurai,253,28,23,0,258,21889,28,39,0,21956,21417,281
01-09-2021,nagapattinam,361,33,41,0,353,19646,33,53,0,19732,19074,305
01-09-2021,namakkal,531,47,67,2,509,48783,47,112,0,48942,47961,472
01-09-2021,nilgiris,326,25,29,0,322,31738,25,44,0,31807,31290,195
01-09-2021,perambalur,71,7,7,0,71,11711,7,3,0,11721,11420,230
01-09-2021,pudukottai,272,21,28,0,265,29097,21,35,0,29153,28498,390
01-09-2021,ramanathapuram,46,2,5,0,43,20061,2,135,0,20198,19803,352
01-09-2021,ranipet,196,12,22,0,186,42529,12,49,0,42590,41649,755
01-09-2021,salem,787,61,96,1,751,95750,61,438,0,96249,93865,1633
01-09-2021,sivagangai,214,16,20,0,210,19283,16,108,0,19407,18996,201
01-09-2021,tenkasi,109,7,4,0,112,27047,7,58,0,27112,26516,484
01-09-2021,thanjavur,887,110,112,0,885,70905,110,22,0,71037,69262,890
01-09-2021,theni,82,3,6,0,79,43164,3,45,0,43212,42618,515
01-09-2021,thirupathur,121,9,3,0,127,28486,9,118,0,28613,27872,614
01-09-2021,thiruvallur,669,76,46,2,697,115859,76,10,0,115945,113460,1788
01-09-2021,thiruvannamalai,367,32,35,1,363,53000,32,398,0,53430,52415,652
01-09-2021,thiruvarur,350,33,27,1,355,39020,33,38,0,39091,38342,394
01-09-2021,thoothukudi,119,10,7,1,121,55222,10,275,0,55507,54986,400
01-09-2021,tirunelveli,148,7,17,0,138,48034,7,427,0,48468,47900,430
01-09-2021,tiruppur,749,90,95,0,744,90369,90,11,0,90470,88794,932
01-09-2021,trichy,552,59,66,0,545,74371,59,60,0,74490,72936,1009
01-09-2021,vellore,299,20,26,2,291,47208,20,1664,0,48892,47490,1111
01-09-2021,villupuram,326,16,30,0,312,44670,16,174,0,44860,44197,351
01-09-2021,virudhunagar,66,6,8,0,64,45653,6,104,0,45763,45155,544
01-09-2021,airport surveillance (international),4,1,0,0,5,0,0,1022,1,1023,1017,1
01-09-2021,airport surveillance (domestic),2,0,0,0,2,0,0,1082,0,1082,1079,1
01-09-2021,railway surveillance,0,0,0,0,0,0,0,428,0,428,428,0
02-09-2021,ariyalur,155,11,11,1,154,16352,11,20,0,16383,15981,248
02-09-2021,chengalpattu,1063,88,114,0,1037,165585,88,5,0,165678,162209,2432
02-09-2021,chennai,1731,162,172,1,1720,544439,162,47,0,544648,534523,8405
02-09-2021,coimbatore,2085,239,187,3,2134,236431,239,51,0,236721,232311,2276
02-09-2021,cuddalore,493,55,57,0,491,62171,55,203,0,62429,61099,839
02-09-2021,dharmapuri,240,22,23,0,239,26685,22,216,0,26923,26438,246
02-09-2021,dindigul,94,9,8,0,95,32419,9,77,0,32505,31779,631
02-09-2021,erode,1343,125,148,1,1319,98568,125,94,0,98787,96810,658
02-09-2021,kallakurichi,289,23,15,1,296,29744,23,404,0,30171,29674,201
02-09-2021,kancheepuram,369,36,41,0,364,72913,36,4,0,72953,71358,1231
02-09-2021,kanyakumari,287,19,17,1,288,60916,19,124,0,61059,59737,1034
02-09-2021,karur,143,12,9,0,146,23084,12,47,0,23143,22645,352
02-09-2021,krishnagiri,205,18,10,0,213,41884,18,233,0,42135,41591,331
02-09-2021,madurai,148,11,13,0,146,73852,11,172,0,74035,72734,1155
02-09-2021,mayiladuthurai,279,25,21,0,283,21938,25,39,0,22002,21438,281
02-09-2021,nagapattinam,333,27,43,0,317,19659,27,53,0,19739,19117,305
02-09-2021,namakkal,525,62,53,1,533,48846,62,112,0,49020,48014,473
02-09-2021,nilgiris,322,27,34,0,315,31763,27,44,0,31834,31324,195
02-09-2021,perambalur,73,6,4,0,75,11720,6,3,0,11729,11424,230
02-09-2021,pudukottai,268,18,22,1,263,29121,18,35,0,29174,28520,391
02-09-2021,ramanathapuram,43,3,3,0,43,20063,3,135,0,20201,19806,352
02-09-2021,ranipet,187,10,25,1,171,42542,10,49,0,42601,41674,756
02-09-2021,salem,752,58,102,1,707,95812,58,438,0,96308,93967,1634
02-09-2021,sivagangai,208,13,24,0,197,19297,13,108,0,19418,19020,201
02-09-2021,tenkasi,113,4,6,0,111,27055,4,58,0,27117,26522,484
02-09-2021,thanjavur,874,108,129,1,852,71004,108,22,0,71134,69391,891
02-09-2021,theni,79,9,7,0,81,43167,9,45,0,43221,42625,515
02-09-2021,thirupathur,129,7,6,0,130,28497,7,118,0,28622,27878,614
02-09-2021,thiruvallur,698,65,51,4,708,115936,65,10,0,116011,113511,1792
02-09-2021,thiruvannamalai,363,38,36,2,363,53032,38,398,0,53468,52451,654
02-09-2021,thiruvarur,361,30,32,0,359,39059,30,38,0,39127,38374,394
02-09-2021,thoothukudi,121,15,8,0,128,55232,15,275,0,55522,54994,400
02-09-2021,tirunelveli,138,14,12,0,140,48041,14,427,0,48482,47912,430
02-09-2021,tiruppur,746,98,88,0,756,90461,98,11,0,90570,88882,932
02-09-2021,trichy,549,58,62,0,545,74434,53,60,5,74552,72998,1009
02-09-2021,vellore,287,15,31,0,271,47224,15,1664,0,48903,47521,1111
02-09-2021,villupuram,314,25,26,0,313,44688,25,174,0,44887,44223,351
02-09-2021,virudhunagar,64,3,5,0,62,45659,3,104,0,45766,45160,544
02-09-2021,airport surveillance (international),5,0,1,0,4,0,0,1023,0,1023,1018,1
02-09-2021,airport surveillance (domestic),2,0,1,0,1,0,0,1082,0,1082,1080,1
02-09-2021,railway surveillance,0,0,0,0,0,0,0,428,0,428,428,0
03-09-2021,ariyalur,155,11,11,1,154,16352,11,20,0,16383,15981,248
03-09-2021,chengalpattu,1063,88,114,0,1037,165585,88,5,0,165678,162209,2432
03-09-2021,chennai,1731,162,172,1,1720,544439,162,47,0,544648,534523,8405
03-09-2021,coimbatore,2085,239,187,3,2134,236431,239,51,0,236721,232311,2276
03-09-2021,cuddalore,493,55,57,0,491,62171,55,203,0,62429,61099,839
03-09-2021,dharmapuri,240,22,23,0,239,26685,22,216,0,26923,26438,246
03-09-2021,dindigul,94,9,8,0,95,32419,9,77,0,32505,31779,631
03-09-2021,erode,1343,125,148,1,1319,98568,125,94,0,98787,96810,658
03-09-2021,kallakurichi,289,23,15,1,296,29744,23,404,0,30171,29674,201
03-09-2021,kancheepuram,369,36,41,0,364,72913,36,4,0,72953,71358,1231
03-09-2021,kanyakumari,287,19,17,1,288,60916,19,124,0,61059,59737,1034
03-09-2021,karur,143,12,9,0,146,23084,12,47,0,23143,22645,352
03-09-2021,krishnagiri,205,18,10,0,213,41884,18,233,0,42135,41591,331
03-09-2021,madurai,148,11,13,0,146,73852,11,172,0,74035,72734,1155
03-09-2021,mayiladuthurai,279,25,21,0,283,21938,25,39,0,22002,21438,281
03-09-2021,nagapattinam,333,27,43,0,317,19659,27,53,0,19739,19117,305
03-09-2021,namakkal,525,62,53,1,533,48846,62,112,0,49020,48014,473
03-09-2021,nilgiris,322,27,34,0,315,31763,27,44,0,31834,31324,195
03-09-2021,perambalur,73,6,4,0,75,11720,6,3,0,11729,11424,230
03-09-2021,pudukottai,268,18,22,1,263,29121,18,35,0,29174,28520,391
03-09-2021,ramanathapuram,43,3,3,0,43,20063,3,135,0,20201,19806,352
03-09-2021,ranipet,187,10,25,1,171,42542,10,49,0,42601,41674,756
03-09-2021,salem,752,58,102,1,707,95812,58,438,0,96308,93967,1634
03-09-2021,sivagangai,208,13,24,0,197,19297,13,108,0,19418,19020,201
03-09-2021,tenkasi,113,4,6,0,111,27055,4,58,0,27117,26522,484
03-09-2021,thanjavur,874,108,129,1,852,71004,108,22,0,71134,69391,891
03-09-2021,theni,79,9,7,0,81,43167,9,45,0,43221,42625,515
03-09-2021,thirupathur,129,7,6,0,130,28497,7,118,0,28622,27878,614
03-09-2021,thiruvallur,698,65,51,4,708,115936,65,10,0,116011,113511,1792
03-09-2021,thiruvannamalai,363,38,36,2,363,53032,38,398,0,53468,52451,654
03-09-2021,thiruvarur,361,30,32,0,359,39059,30,38,0,39127,38374,394
03-09-2021,thoothukudi,121,15,8,0,128,55232,15,275,0,55522,54994,400
03-09-2021,tirunelveli,138,14,12,0,140,48041,14,427,0,48482,47912,430
03-09-2021,tiruppur,746,98,88,0,756,90461,98,11,0,90570,88882,932
03-09-2021,trichy,549,58,62,0,545,74434,53,60,5,74552,72998,1009
03-09-2021,vellore,287,15,31,0,271,47224,15,1664,0,48903,47521,1111
03-09-2021,villupuram,314,25,26,0,313,44688,25,174,0,44887,44223,351
03-09-2021,virudhunagar,64,3,5,0,62,45659,3,104,0,45766,45160,544
03-09-2021,airport surveillance (international),5,0,1,0,4,0,0,1023,0,1023,1018,1
03-09-2021,airport surveillance (domestic),2,0,1,0,1,0,0,1082,0,1082,1080,1
03-09-2021,railway surveillance,0,0,0,0,0,0,0,428,0,428,428,0
04-09-2021,ariyalur,154,14,13,1,154,16363,14,20,0,16397,15994,249
04-09-2021,chengalpattu,1037,99,98,1,1037,165673,99,5,0,165777,162307,2433
04-09-2021,chennai,1720,167,157,3,1727,544601,167,47,0,544815,534680,8408
04-09-2021,coimbatore,2134,244,194,4,2180,236670,244,51,0,236965,232505,2280
04-09-2021,cuddalore,491,54,63,0,482,62226,54,203,0,62483,61162,839
04-09-2021,dharmapuri,239,21,26,0,234,26707,21,216,0,26944,26464,246
04-09-2021,dindigul,95,12,7,0,100,32428,12,77,0,32517,31786,631
04-09-2021,erode,1319,109,134,2,1292,98693,109,94,0,98896,96944,660
04-09-2021,kallakurichi,296,20,24,0,292,29767,20,404,0,30191,29698,201
04-09-2021,kancheepuram,364,34,37,0,361,72949,34,4,0,72987,71395,1231
04-09-2021,kanyakumari,288,24,22,0,290,60935,24,124,0,61083,59759,1034
04-09-2021,karur,146,20,11,0,155,23096,20,47,0,23163,22656,352
04-09-2021,krishnagiri,213,12,13,0,212,41902,12,233,0,42147,41604,331
04-09-2021,madurai,146,15,16,0,145,73863,15,172,0,74050,72750,1155
04-09-2021,mayiladuthurai,283,27,24,1,285,21963,27,39,0,22029,21462,282
04-09-2021,nagapattinam,317,29,35,0,311,19686,29,53,0,19768,19152,305
04-09-2021,namakkal,533,65,58,0,540,48908,65,112,0,49085,48072,473
04-09-2021,nilgiris,315,28,29,0,314,31790,28,44,0,31862,31353,195
04-09-2021,perambalur,75,5,5,0,75,11726,5,3,0,11734,11429,230
04-09-2021,pudukottai,263,20,19,1,263,29139,20,35,0,29194,28539,392
04-09-2021,ramanathapuram,43,4,4,0,43,20066,4,135,0,20205,19810,352
04-09-2021,ranipet,171,13,23,0,161,42552,13,49,0,42614,41697,756
04-09-2021,salem,707,59,88,2,676,95870,59,438,0,96367,94055,1636
04-09-2021,sivagangai,197,22,21,0,198,19310,22,108,0,19440,19041,201
04-09-2021,tenkasi,111,3,5,0,109,27059,3,58,0,27120,26527,484
04-09-2021,thanjavur,852,92,114,0,830,71112,92,22,0,71226,69505,891
04-09-2021,theni,81,8,9,0,80,43176,8,45,0,43229,42634,515
04-09-2021,thirupathur,130,4,12,0,122,28504,4,118,0,28626,27890,614
04-09-2021,thiruvallur,708,79,53,2,732,116001,79,10,0,116090,113564,1794
04-09-2021,thiruvannamalai,363,28,34,0,357,53070,28,398,0,53496,52485,654
04-09-2021,thiruvarur,359,36,36,0,359,39089,36,38,0,39163,38410,394
04-09-2021,thoothukudi,128,9,10,0,127,55247,9,275,0,55531,55004,400
04-09-2021,tirunelveli,140,10,14,0,136,48055,10,427,0,48492,47926,430
04-09-2021,tiruppur,756,87,91,0,752,90559,87,11,0,90657,88973,932
04-09-2021,trichy,545,47,47,3,542,74487,47,65,0,74599,73045,1012
04-09-2021,vellore,271,16,28,0,259,47239,16,1664,0,48919,47549,1111
04-09-2021,villupuram,313,27,30,0,310,44713,27,174,0,44914,44253,351
04-09-2021,virudhunagar,62,12,6,0,68,45662,12,104,0,45778,45166,544
04-09-2021,airport surveillance (international),4,0,0,0,4,0,0,1023,0,1023,1018,1
04-09-2021,airport surveillance (domestic),1,0,0,0,1,0,0,1082,0,1082,1080,1
04-09-2021,railway surveillance,0,0,0,0,0,0,0,428,0,428,428,0
05-09-2021,ariyalur,156,15,15,1,155,16379,15,20,0,16414,16009,250
05-09-2021,chengalpattu,1037,127,84,0,1080,165772,127,5,0,165904,162391,2433
05-09-2021,chennai,1729,165,148,1,1745,544771,165,47,0,544983,534828,8410
05-09-2021,coimbatore,2189,229,207,0,2211,236923,229,51,0,237203,232712,2280
05-09-2021,cuddalore,474,45,56,1,462,62272,45,203,0,62520,61218,840
05-09-2021,dharmapuri,234,20,21,2,231,26728,20,216,0,26964,26485,248
05-09-2021,dindigul,98,9,13,1,93,32438,9,77,0,32524,31799,632
05-09-2021,erode,1287,104,124,0,1267,98797,104,94,0,98995,97068,660
05-09-2021,kallakurichi,292,21,38,0,275,29787,21,404,0,30212,29736,201
05-09-2021,kancheepuram,363,33,30,0,366,72984,33,4,0,73021,71425,1230
05-09-2021,kanyakumari,288,18,28,1,277,60957,18,124,0,61099,59787,1035
05-09-2021,karur,149,19,14,0,154,23110,19,47,0,23176,22670,352
05-09-2021,krishnagiri,213,18,18,0,213,41915,18,233,0,42166,41622,331
05-09-2021,madurai,146,18,19,2,143,73879,18,172,0,74069,72769,1157
05-09-2021,mayiladuthurai,309,34,31,0,312,22014,34,39,0,22087,21493,282
05-09-2021,nagapattinam,293,46,24,0,315,19697,46,53,0,19796,19176,305
05-09-2021,namakkal,543,62,54,1,550,48976,62,112,0,49150,48126,474
05-09-2021,nilgiris,314,29,36,0,307,31818,29,44,0,31891,31389,195
05-09-2021,perambalur,75,8,6,0,77,11731,8,3,0,11742,11435,230
05-09-2021,pudukottai,264,23,23,2,262,29160,23,35,0,29218,28562,394
05-09-2021,ramanathapuram,43,7,5,0,45,20070,7,135,0,20212,19815,352
05-09-2021,ranipet,163,16,17,0,162,42567,16,49,0,42632,41714,756
05-09-2021,salem,674,58,97,0,635,95927,58,438,0,96423,94152,1636
05-09-2021,sivagangai,197,15,24,0,188,19331,15,108,0,19454,19065,201
05-09-2021,tenkasi,108,10,7,0,111,27061,10,58,0,27129,26534,484
05-09-2021,thanjavur,824,70,102,2,790,71198,70,22,0,71290,69607,893
05-09-2021,theni,81,7,13,0,75,43185,7,45,0,43237,42647,515
05-09-2021,thirupathur,124,6,10,0,120,28510,6,118,0,28634,27900,614
05-09-2021,thiruvallur,727,84,58,1,752,116075,84,10,0,116169,113622,1795
05-09-2021,thiruvannamalai,360,32,36,2,354,53101,32,398,0,53531,52521,656
05-09-2021,thiruvarur,359,39,32,0,366,39125,39,38,0,39202,38442,394
05-09-2021,thoothukudi,126,12,12,0,126,55255,12,275,0,55542,55016,400
05-09-2021,tirunelveli,138,11,9,0,140,48067,11,427,0,48505,47935,430
05-09-2021,tiruppur,755,81,82,0,754,90649,81,11,0,90741,89055,932
05-09-2021,trichy,544,56,39,1,560,74536,56,65,0,74657,73084,1013
05-09-2021,vellore,254,14,35,0,233,47250,14,1664,0,48928,47584,1111
05-09-2021,villupuram,311,22,33,0,300,44741,22,174,0,44937,44286,351
05-09-2021,virudhunagar,69,9,7,0,71,45675,9,104,0,45788,45173,544
05-09-2021,airport surveillance (international),4,0,0,0,4,0,0,1023,0,1023,1018,1
05-09-2021,airport surveillance (domestic),1,0,0,0,1,0,0,1082,0,1082,1080,1
05-09-2021,railway surveillance,0,0,0,0,0,0,0,428,0,428,428,0
06-09-2021,ariyalur,156,16,12,0,160,16395,16,20,0,16431,16021,250
06-09-2021,chengalpattu,1083,110,97,2,1094,165902,110,5,0,166017,162488,2435
06-09-2021,chennai,1751,169,145,3,1772,544942,169,47,0,545158,534973,8413
06-09-2021,coimbatore,2212,206,219,1,2198,237153,206,51,0,237410,232931,2281
06-09-2021,cuddalore,461,42,54,1,448,62316,42,203,0,62561,61272,841
06-09-2021,dharmapuri,232,17,18,0,231,26749,17,216,0,26982,26503,248
06-09-2021,dindigul,92,11,11,0,92,32446,11,77,0,32534,31810,632
06-09-2021,erode,1261,96,118,1,1238,98895,96,94,0,99085,97186,661
06-09-2021,kallakurichi,276,26,42,0,260,29809,26,404,0,30239,29778,201
06-09-2021,kancheepuram,366,32,28,0,370,73017,32,4,0,73053,71453,1230
06-09-2021,kanyakumari,277,20,22,1,274,60975,20,124,0,61119,59809,1036
06-09-2021,karur,154,18,13,0,159,23129,18,47,0,23194,22683,352
06-09-2021,krishnagiri,213,17,24,1,205,41933,17,233,0,42183,41646,332
06-09-2021,madurai,143,20,15,0,148,73897,20,172,0,74089,72784,1157
06-09-2021,mayiladuthurai,322,21,29,0,314,22059,21,39,0,22119,21522,283
06-09-2021,nagapattinam,311,28,25,0,314,19739,28,53,0,19820,19201,305
06-09-2021,namakkal,551,60,52,1,558,49039,60,112,0,49211,48178,475
06-09-2021,nilgiris,307,33,31,0,309,31847,33,44,0,31924,31420,195
06-09-2021,perambalur,78,10,7,0,81,11740,10,3,0,11753,11442,230
06-09-2021,pudukottai,259,22,21,0,260,29180,22,35,0,29237,28583,394
06-09-2021,ramanathapuram,45,9,6,0,48,20077,9,135,0,20221,19821,352
06-09-2021,ranipet,166,15,19,0,162,42587,15,49,0,42651,41733,756
06-09-2021,salem,635,59,84,2,608,95985,59,438,0,96482,94236,1638
06-09-2021,sivagangai,188,10,27,0,171,19346,10,108,0,19464,19092,201
06-09-2021,tenkasi,110,11,8,0,113,27070,11,58,0,27139,26542,484
06-09-2021,thanjavur,784,104,91,3,794,71261,104,22,0,71387,69698,895
06-09-2021,theni,75,3,9,0,69,43192,3,45,0,43240,42656,515
06-09-2021,thirupathur,120,12,7,0,125,28516,12,118,0,28646,27907,614
06-09-2021,thiruvallur,746,73,53,1,765,116153,73,10,0,116236,113675,1796
06-09-2021,thiruvannamalai,354,35,30,0,359,53133,35,398,0,53566,52551,656
06-09-2021,thiruvarur,362,46,33,0,375,39160,46,38,0,39244,38475,394
06-09-2021,thoothukudi,126,13,17,0,122,55267,13,275,0,55555,55033,400
06-09-2021,tirunelveli,140,9,14,0,135,48078,9,427,0,48514,47949,430
06-09-2021,tiruppur,759,82,71,1,769,90735,82,11,0,90828,89126,933
06-09-2021,trichy,562,58,31,0,589,74594,58,65,0,74717,73115,1013
06-09-2021,vellore,228,15,37,0,206,47259,15,1664,0,48938,47621,1111
06-09-2021,villupuram,301,21,34,0,288,44764,21,174,0,44959,44320,351
06-09-2021,virudhunagar,71,7,10,0,68,45684,7,104,0,45795,45183,544
06-09-2021,airport surveillance (international),4,0,0,0,4,0,0,1023,0,1023,1018,1
06-09-2021,airport surveillance (domestic),1,0,0,0,1,0,0,1082,0,1082,1080,1
06-09-2021,railway surveillance,0,0,0,0,0,0,0,428,0,428,428,0
07-09-2021,ariyalur,162,11,17,0,156,16413,11,20,0,16444,16038,250
07-09-2021,chengalpattu,1094,112,103,3,1100,166012,112,5,0,166129,162591,2438
07-09-2021,chennai,1772,194,147,3,1816,545111,194,47,0,545352,535120,8416
07-09-2021,coimbatore,2200,217,224,2,2191,237361,217,51,0,237629,233155,2283
07-09-2021,cuddalore,445,38,51,1,431,62355,38,203,0,62596,61323,842
07-09-2021,dharmapuri,230,22,16,0,236,26765,22,216,0,27003,26519,248
07-09-2021,dindigul,91,8,13,0,86,32456,8,77,0,32541,31823,632
07-09-2021,erode,1235,115,104,0,1246,98988,115,94,0,99197,97290,661
07-09-2021,kallakurichi,260,47,39,0,268,29835,47,404,0,30286,29817,201
07-09-2021,kancheepuram,372,38,25,0,385,73051,38,4,0,73093,71478,1230
07-09-2021,kanyakumari,274,22,24,0,272,60995,22,124,0,61141,59833,1036
07-09-2021,karur,154,15,14,0,155,23142,15,47,0,23204,22697,352
07-09-2021,krishnagiri,206,14,27,0,193,41951,14,233,0,42198,41673,332
07-09-2021,madurai,145,24,14,0,155,73914,24,172,0,74110,72798,1157
07-09-2021,mayiladuthurai,322,33,37,0,318,22088,33,39,0,22160,21559,283
07-09-2021,nagapattinam,315,21,29,0,307,19768,21,53,0,19842,19230,305
07-09-2021,namakkal,564,65,55,2,572,49105,65,112,0,49282,48233,477
07-09-2021,nilgiris,309,32,34,0,307,31880,32,44,0,31956,31454,195
07-09-2021,perambalur,82,9,11,0,80,11751,9,3,0,11763,11453,230
07-09-2021,pudukottai,265,17,25,0,257,29207,17,35,0,29259,28608,394
07-09-2021,ramanathapuram,48,3,8,0,43,20086,3,135,0,20224,19829,352
07-09-2021,ranipet,164,16,21,0,159,42604,16,49,0,42669,41754,756
07-09-2021,salem,611,57,79,1,588,96047,57,438,0,96542,94315,1639
07-09-2021,sivagangai,171,20,28,0,163,19356,20,108,0,19484,19120,201
07-09-2021,tenkasi,113,5,11,0,107,27081,5,58,0,27144,26553,484
07-09-2021,thanjavur,788,53,78,0,763,71359,53,22,0,71434,69776,895
07-09-2021,theni,69,4,7,0,66,43195,4,45,0,43244,42663,515
07-09-2021,thirupathur,128,5,15,1,117,28531,5,118,0,28654,27922,615
07-09-2021,thiruvallur,766,69,61,1,773,116227,69,10,0,116306,113736,1797
07-09-2021,thiruvannamalai,359,32,33,0,358,53168,32,398,0,53598,52584,656
07-09-2021,thiruvarur,371,33,32,1,371,39202,33,38,0,39273,38507,395
07-09-2021,thoothukudi,122,9,19,0,112,55280,9,275,0,55564,55052,400
07-09-2021,tirunelveli,135,11,18,1,127,48087,11,427,0,48525,47967,431
07-09-2021,tiruppur,771,70,62,1,778,90819,70,11,0,90900,89188,934
07-09-2021,trichy,579,56,23,1,611,74642,56,65,0,74763,73138,1014
07-09-2021,vellore,201,22,28,1,194,47269,22,1664,0,48955,47649,1112
07-09-2021,villupuram,288,19,35,0,272,44785,19,174,0,44978,44355,351
07-09-2021,virudhunagar,70,6,9,0,67,45693,6,104,0,45803,45192,544
07-09-2021,airport surveillance (international),4,0,0,0,4,0,0,1023,0,1023,1018,1
07-09-2021,airport surveillance (domestic),1,0,0,0,1,0,0,1082,0,1082,1080,1
07-09-2021,railway surveillance,0,0,0,0,0,0,0,428,0,428,428,0
08-09-2021,ariyalur,157,12,18,1,150,16425,12,20,0,16457,16056,251
08-09-2021,chengalpattu,1098,115,109,2,1102,166122,115,5,0,166242,162700,2440
08-09-2021,chennai,1811,179,153,2,1835,545300,179,47,0,545526,535273,8418
08-09-2021,coimbatore,2193,232,231,0,2194,237580,232,51,0,237863,233386,2283
08-09-2021,cuddalore,430,40,49,1,420,62392,40,203,0,62635,61372,843
08-09-2021,dharmapuri,236,19,19,1,235,26787,19,216,0,27022,26538,249
08-09-2021,dindigul,86,9,9,0,86,32464,9,77,0,32550,31832,632
08-09-2021,erode,1244,117,107,0,1254,99101,117,94,0,99312,97397,661
08-09-2021,kallakurichi,268,44,41,0,271,29882,44,404,0,30330,29858,201
08-09-2021,kancheepuram,387,34,22,1,398,73091,34,4,0,73129,71500,1231
08-09-2021,kanyakumari,273,19,25,0,267,61018,19,124,0,61161,59858,1036
08-09-2021,karur,155,17,13,0,159,23157,17,47,0,23221,22710,352
08-09-2021,krishnagiri,193,36,28,0,201,41965,36,233,0,42234,41701,332
08-09-2021,madurai,156,16,11,1,160,73939,16,172,0,74127,72809,1158
08-09-2021,mayiladuthurai,321,29,42,2,306,22124,29,39,0,22192,21601,285
08-09-2021,nagapattinam,308,27,24,0,311,19790,27,53,0,19870,19254,305
08-09-2021,namakkal,573,66,52,0,587,49171,66,112,0,49349,48285,477
08-09-2021,nilgiris,307,30,37,0,300,31912,30,44,0,31986,31491,195
08-09-2021,perambalur,81,8,10,0,79,11761,8,3,0,11772,11463,230
08-09-2021,pudukottai,256,21,26,0,251,29223,21,35,0,29279,28634,394
08-09-2021,ramanathapuram,44,5,7,0,42,20090,5,135,0,20230,19836,352
08-09-2021,ranipet,161,12,23,1,149,42622,12,49,0,42683,41777,757
08-09-2021,salem,588,54,81,2,559,96104,54,438,0,96596,94396,1641
08-09-2021,sivagangai,162,19,31,0,150,19375,19,108,0,19502,19151,201
08-09-2021,tenkasi,106,7,12,0,101,27085,7,58,0,27150,26565,484
08-09-2021,thanjavur,756,85,58,1,782,71405,85,22,0,71512,69834,896
08-09-2021,theni,66,3,8,0,61,43199,3,45,0,43247,42671,515
08-09-2021,thirupathur,117,15,17,1,114,28536,15,118,0,28669,27939,616
08-09-2021,thiruvallur,773,51,67,1,756,116296,51,10,0,116357,113803,1798
08-09-2021,thiruvannamalai,360,29,36,0,353,53202,29,398,0,53629,52620,656
08-09-2021,thiruvarur,373,39,35,0,377,39237,39,38,0,39314,38542,395
08-09-2021,thoothukudi,113,12,15,0,110,55290,12,275,0,55577,55067,400
08-09-2021,tirunelveli,126,10,21,0,115,48097,10,427,0,48534,47988,431
08-09-2021,tiruppur,779,81,51,1,808,90890,81,11,0,90982,89239,935
08-09-2021,trichy,614,48,27,0,635,74701,48,65,0,74814,73165,1014
08-09-2021,vellore,190,18,26,0,182,47287,18,1664,0,48969,47675,1112
08-09-2021,villupuram,273,22,43,0,252,44805,22,174,0,45001,44398,351
08-09-2021,virudhunagar,66,7,10,0,63,45698,7,104,0,45809,45202,544
08-09-2021,airport surveillance (international),4,0,0,0,4,0,0,1023,0,1023,1018,1
08-09-2021,airport surveillance (domestic),1,0,0,0,1,0,0,1082,0,1082,1080,1
08-09-2021,railway surveillance,0,0,0,0,0,0,0,428,0,428,428,0
09-09-2021,ariyalur,150,13,16,0,147,16437,13,20,0,16470,16072,251
09-09-2021,chengalpattu,1106,108,104,0,1110,166241,108,5,0,166354,162804,2440
09-09-2021,chennai,1831,186,182,1,1834,545475,186,47,0,545708,535455,8419
09-09-2021,coimbatore,2194,224,248,5,2165,237812,224,51,0,238087,233634,2288
09-09-2021,cuddalore,421,39,39,2,419,62433,39,203,0,62675,61411,845
09-09-2021,dharmapuri,234,20,16,1,237,26805,20,216,0,27041,26554,250
09-09-2021,dindigul,86,11,5,0,92,32473,11,77,0,32561,31837,632
09-09-2021,erode,1253,130,126,1,1256,99217,130,94,0,99441,97523,662
09-09-2021,kallakurichi,271,32,30,1,272,29926,32,404,0,30362,29888,202
09-09-2021,kancheepuram,397,30,32,0,395,73124,30,4,0,73158,71532,1231
09-09-2021,kanyakumari,267,27,27,0,267,61037,27,124,0,61188,59885,1036
09-09-2021,karur,160,18,8,0,170,23175,18,47,0,23240,22718,352
09-09-2021,krishnagiri,201,27,26,0,202,42001,27,233,0,42261,41727,332
09-09-2021,madurai,160,5,14,0,151,73955,5,172,0,74132,72823,1158
09-09-2021,mayiladuthurai,306,30,37,0,299,22153,30,39,0,22222,21638,285
09-09-2021,nagapattinam,314,36,19,0,331,19820,36,53,0,19909,19273,305
09-09-2021,namakkal,588,61,48,0,601,49238,61,112,0,49411,48333,477
09-09-2021,nilgiris,300,32,29,0,303,31942,32,44,0,32018,31520,195
09-09-2021,perambalur,79,10,7,0,82,11769,10,3,0,11782,11470,230
09-09-2021,pudukottai,253,22,35,0,240,29246,22,35,0,29303,28669,394
09-09-2021,ramanathapuram,42,4,4,0,42,20095,4,135,0,20234,19840,352
09-09-2021,ranipet,147,22,18,1,150,42632,22,49,0,42703,41795,758
09-09-2021,salem,560,58,63,1,554,96159,58,438,0,96655,94459,1642
09-09-2021,sivagangai,146,14,24,0,136,19390,14,108,0,19512,19175,201
09-09-2021,tenkasi,101,5,13,0,93,27092,5,58,0,27155,26578,484
09-09-2021,thanjavur,779,92,52,2,817,71487,92,22,0,71601,69886,898
09-09-2021,theni,61,8,7,0,62,43202,8,45,0,43255,42678,515
09-09-2021,thirupathur,114,13,21,0,106,28551,13,118,0,28682,27960,616
09-09-2021,thiruvallur,756,49,72,1,732,116347,49,10,0,116406,113875,1799
09-09-2021,thiruvannamalai,353,31,28,1,355,53231,31,398,0,53660,52648,657
09-09-2021,thiruvarur,375,40,31,2,382,39274,40,38,0,39352,38573,397
09-09-2021,thoothukudi,110,7,10,0,107,55302,7,275,0,55584,55077,400
09-09-2021,tirunelveli,115,9,12,0,112,48107,9,427,0,48543,48000,431
09-09-2021,tiruppur,808,87,42,0,853,90971,87,11,0,91069,89281,935
09-09-2021,trichy,637,49,34,1,651,74751,49,65,0,74865,73199,1015
09-09-2021,vellore,184,17,17,0,184,47307,17,1664,0,48988,47692,1112
09-09-2021,villupuram,253,21,28,0,246,44828,21,174,0,45023,44426,351
09-09-2021,virudhunagar,63,9,8,1,63,45705,9,104,0,45818,45210,545
09-09-2021,airport surveillance (international),4,0,1,0,3,0,0,1023,0,1023,1019,1
09-09-2021,airport surveillance (domestic),1,0,1,0,0,0,0,1082,0,1082,1081,1
09-09-2021,railway surveillance,0,0,0,0,0,0,0,428,0,428,428,0
10-09-2021,ariyalur,150,12,19,0,143,16453,12,20,0,16485,16091,251
10-09-2021,chengalpattu,1105,133,120,2,1116,166344,133,5,0,166482,162924,2442
10-09-2021,chennai,1834,174,208,2,1798,545661,174,47,0,545882,535663,8421
10-09-2021,coimbatore,2168,235,226,5,2172,238039,235,51,0,238325,233860,2293
10-09-2021,cuddalore,416,29,24,1,420,62469,29,203,0,62701,61435,846
10-09-2021,dharmapuri,237,17,21,0,233,26825,17,216,0,27058,26575,250
10-09-2021,dindigul,89,14,6,0,97,32481,14,77,0,32572,31843,632
10-09-2021,erode,1232,137,124,0,1245,99323,137,94,0,99554,97647,662
10-09-2021,kallakurichi,272,34,26,2,278,29958,34,404,0,30396,29914,204
10-09-2021,kancheepuram,398,28,35,1,390,73157,28,4,0,73189,71567,1232
10-09-2021,kanyakumari,267,26,31,0,262,61064,26,124,0,61214,59916,1036
10-09-2021,karur,166,13,7,0,172,23189,13,47,0,23249,22725,352
10-09-2021,krishnagiri,202,23,23,1,201,42028,23,233,0,42284,41750,333
10-09-2021,madurai,153,15,9,1,158,73962,15,172,0,74149,72832,1159
10-09-2021,mayiladuthurai,325,29,43,2,309,22209,29,39,0,22277,21681,287
10-09-2021,nagapattinam,316,38,15,1,338,19841,38,53,0,19932,19288,306
10-09-2021,namakkal,604,53,46,0,611,49302,53,112,0,49467,48379,477
10-09-2021,nilgiris,303,30,32,1,300,31974,30,44,0,32048,31552,196
10-09-2021,perambalur,82,7,4,0,85,11779,7,3,0,11789,11474,230
10-09-2021,pudukottai,240,20,38,0,222,29268,20,35,0,29323,28707,394
10-09-2021,ramanathapuram,42,2,3,1,40,20099,2,135,0,20236,19843,353
10-09-2021,ranipet,151,18,16,0,153,42655,18,49,0,42722,41811,758
10-09-2021,salem,569,54,53,1,569,96232,54,438,0,96724,94512,1643
10-09-2021,sivagangai,136,16,17,0,135,19404,16,108,0,19528,19192,201
10-09-2021,tenkasi,91,6,11,0,86,27095,6,58,0,27159,26589,484
10-09-2021,thanjavur,799,87,48,0,838,71561,87,22,0,71670,69934,898
10-09-2021,theni,62,6,5,0,63,43210,6,45,0,43261,42683,515
10-09-2021,thirupathur,106,12,18,0,100,28564,12,118,0,28694,27978,616
10-09-2021,thiruvallur,729,61,62,1,727,116393,61,10,0,116464,113937,1800
10-09-2021,thiruvannamalai,355,32,25,0,362,53262,32,398,0,53692,52673,657
10-09-2021,thiruvarur,386,43,27,1,401,39318,43,38,0,39399,38600,398
10-09-2021,thoothukudi,110,9,8,0,111,55312,9,275,0,55596,55085,400
10-09-2021,tirunelveli,112,8,10,0,110,48116,8,427,0,48551,48010,431
10-09-2021,tiruppur,860,113,56,1,916,91065,113,11,0,91189,89337,936
10-09-2021,trichy,658,45,52,1,650,74807,45,65,0,74917,73251,1016
10-09-2021,vellore,184,19,14,0,189,47324,19,1664,0,49007,47706,1112
10-09-2021,villupuram,246,24,34,0,236,44849,24,174,0,45047,44460,351
10-09-2021,virudhunagar,63,8,7,0,64,45714,8,104,0,45826,45217,545
10-09-2021,airport surveillance (international),3,1,0,0,4,0,0,1023,1,1024,1019,1
10-09-2021,airport surveillance (domestic),0,0,0,0,0,0,0,1082,0,1082,1081,1
10-09-2021,railway surveillance,0,0,0,0,0,0,0,428,0,428,428,0
11-09-2021,ariyalur,143,13,13,1,142,16465,13,20,0,16498,16104,252
11-09-2021,chengalpattu,1116,120,114,3,1119,166477,120,5,0,166602,163038,2445
11-09-2021,chennai,1798,170,203,1,1764,545835,170,47,0,546052,535866,8422
11-09-2021,coimbatore,2173,224,218,2,2177,238275,224,51,0,238550,234078,2295
11-09-2021,cuddalore,420,30,19,1,430,62498,30,203,0,62731,61454,847
11-09-2021,dharmapuri,233,16,20,0,229,26842,16,216,0,27074,26595,250
11-09-2021,dindigul,97,22,4,0,115,32495,22,77,0,32594,31847,632
11-09-2021,erode,1237,151,128,2,1258,99452,151,94,0,99697,97775,664
11-09-2021,kallakurichi,278,33,23,0,288,29992,33,404,0,30429,29937,204
11-09-2021,kancheepuram,392,30,41,2,379,73187,30,4,0,73221,71608,1234
11-09-2021,kanyakumari,262,31,34,1,258,61090,31,124,0,61245,59950,1037
11-09-2021,karur,170,17,11,1,175,23200,17,47,0,23264,22736,353
11-09-2021,krishnagiri,201,21,18,0,204,42051,21,233,0,42305,41768,333
11-09-2021,madurai,158,20,8,0,170,73977,20,172,0,74169,72840,1159
11-09-2021,mayiladuthurai,310,24,38,2,294,22239,24,39,0,22302,21719,289
11-09-2021,nagapattinam,338,26,22,1,341,19879,26,53,0,19958,19310,307
11-09-2021,namakkal,613,52,43,1,621,49357,52,112,0,49521,48422,478
11-09-2021,nilgiris,300,32,26,0,306,32004,32,44,0,32080,31578,196
11-09-2021,perambalur,85,5,6,0,84,11786,5,3,0,11794,11480,230
11-09-2021,pudukottai,222,18,30,1,209,29288,18,35,0,29341,28737,395
11-09-2021,ramanathapuram,40,6,3,0,43,20101,6,135,0,20242,19846,353
11-09-2021,ranipet,153,19,10,0,162,42673,19,49,0,42741,41821,758
11-09-2021,salem,571,55,46,2,578,96288,55,438,0,96781,94558,1645
11-09-2021,sivagangai,135,29,12,0,152,19420,29,108,0,19557,19204,201
11-09-2021,tenkasi,86,8,15,0,79,27101,8,58,0,27167,26604,484
11-09-2021,thanjavur,834,117,44,0,907,71644,117,22,0,71783,69978,898
11-09-2021,theni,63,7,7,0,63,43216,7,45,0,43268,42690,515
11-09-2021,thirupathur,99,6,14,0,91,28575,6,118,0,28699,27992,616
11-09-2021,thiruvallur,726,58,78,0,706,116453,58,10,0,116521,114015,1800
11-09-2021,thiruvannamalai,362,35,29,0,368,53294,35,398,0,53727,52702,657
11-09-2021,thiruvarur,404,39,33,1,409,39364,39,38,0,39441,38633,399
11-09-2021,thoothukudi,111,10,7,0,114,55321,10,275,0,55606,55092,400
11-09-2021,tirunelveli,110,9,9,0,110,48124,9,427,0,48560,48019,431
11-09-2021,tiruppur,921,91,72,1,939,91183,91,11,0,91285,89409,937
11-09-2021,trichy,651,47,74,2,622,74853,47,65,0,74965,73325,1018
11-09-2021,vellore,188,22,12,2,196,47342,22,1664,0,49028,47718,1114
11-09-2021,villupuram,236,19,28,0,227,44873,19,174,0,45066,44488,351
11-09-2021,virudhunagar,64,7,5,0,66,45722,7,104,0,45833,45222,545
11-09-2021,airport surveillance (international),4,0,0,0,4,0,0,1024,0,1024,1019,1
11-09-2021,airport surveillance (domestic),0,0,0,0,0,0,0,1082,0,1082,1081,1
11-09-2021,railway surveillance,0,0,0,0,0,0,0,428,0,428,428,0
12-09-2021,ariyalur,142,11,11,0,142,16478,11,20,0,16509,16115,252
12-09-2021,chengalpattu,1115,113,106,3,1119,166593,113,5,0,166711,163144,2448
12-09-2021,chennai,1768,197,194,5,1766,546009,197,47,0,546253,536060,8427
12-09-2021,coimbatore,2181,212,207,2,2184,238503,212,51,0,238766,234285,2297
12-09-2021,cuddalore,429,25,22,0,432,62527,25,203,0,62755,61476,847
12-09-2021,dharmapuri,229,18,25,0,222,26858,18,216,0,27092,26620,250
12-09-2021,dindigul,113,11,6,0,118,32515,11,77,0,32603,31853,632
12-09-2021,erode,1243,160,124,0,1279,99588,160,94,0,99842,97899,664
12-09-2021,kallakurichi,288,27,21,0,294,30025,27,404,0,30456,29958,204
12-09-2021,kancheepuram,377,31,38,0,370,73215,31,4,0,73250,71646,1234
12-09-2021,kanyakumari,258,32,27,1,262,61121,32,124,0,61277,59977,1038
12-09-2021,karur,177,16,10,0,183,23219,16,47,0,23282,22746,353
12-09-2021,krishnagiri,204,18,15,0,207,42072,18,233,0,42323,41783,333
12-09-2021,madurai,170,13,17,0,166,73997,13,172,0,74182,72857,1159
12-09-2021,mayiladuthurai,305,22,32,0,295,22274,22,39,0,22335,21751,289
12-09-2021,nagapattinam,331,27,24,1,333,19895,27,53,0,19975,19334,308
12-09-2021,namakkal,624,49,37,0,636,49412,49,112,0,49573,48459,478
12-09-2021,nilgiris,306,33,25,0,314,32036,33,44,0,32113,31603,196
12-09-2021,perambalur,84,7,7,0,84,11791,7,3,0,11801,11487,230
12-09-2021,pudukottai,211,16,23,0,204,29308,16,35,0,29359,28760,395
12-09-2021,ramanathapuram,43,1,2,0,42,20107,1,135,0,20243,19848,353
12-09-2021,ranipet,163,14,10,1,166,42693,14,49,0,42756,41831,759
12-09-2021,salem,582,54,44,1,591,96347,54,438,0,96839,94602,1646
12-09-2021,sivagangai,152,19,14,0,157,19449,19,108,0,19576,19218,201
12-09-2021,tenkasi,79,9,13,0,75,27109,9,58,0,27176,26617,484
12-09-2021,thanjavur,905,115,69,1,950,71759,115,22,0,71896,70047,899
12-09-2021,theni,63,11,5,0,69,43223,11,45,0,43279,42695,515
12-09-2021,thirupathur,92,4,9,0,87,28582,4,118,0,28704,28001,616
12-09-2021,thiruvallur,707,73,67,3,710,116512,73,10,0,116595,114082,1803
12-09-2021,thiruvannamalai,369,28,42,1,354,53330,28,398,0,53756,52744,658
12-09-2021,thiruvarur,409,44,31,0,422,39403,44,38,0,39485,38664,399
12-09-2021,thoothukudi,114,9,8,0,115,55331,9,275,0,55615,55100,400
12-09-2021,tirunelveli,110,18,12,0,116,48133,18,427,0,48578,48031,431
12-09-2021,tiruppur,942,83,83,0,942,91277,83,11,0,91371,89492,937
12-09-2021,trichy,623,46,86,2,581,74901,46,65,0,75012,73411,1020
12-09-2021,vellore,194,18,16,0,196,47362,18,1664,0,49044,47734,1114
12-09-2021,villupuram,227,17,26,1,217,44892,17,174,0,45083,44514,352
12-09-2021,virudhunagar,66,6,4,0,68,45729,6,104,0,45839,45226,545
12-09-2021,airport surveillance (international),4,1,0,0,5,0,0,1024,1,1025,1019,1
12-09-2021,airport surveillance (domestic),0,0,0,0,0,0,0,1082,0,1082,1081,1
12-09-2021,railway surveillance,0,0,0,0,0,0,0,428,0,428,428,0
13-09-2021,ariyalur,142,14,15,0,141,16489,14,20,0,16523,16130,252
13-09-2021,chengalpattu,1121,105,104,2,1120,166708,105,5,0,166818,163248,2450
13-09-2021,chennai,1762,185,189,6,1752,546202,185,47,0,546434,536249,8433
13-09-2021,coimbatore,2190,204,202,0,2192,238721,204,51,0,238976,234487,2297
13-09-2021,cuddalore,433,36,33,0,436,62553,36,203,0,62792,61509,847
13-09-2021,dharmapuri,223,19,30,0,212,26877,19,216,0,27112,26650,250
13-09-2021,dindigul,117,12,5,0,124,32525,12,77,0,32614,31858,632
13-09-2021,erode,1254,137,121,1,1269,99723,137,94,0,99954,98020,665
13-09-2021,kallakurichi,294,25,19,0,300,30052,25,404,0,30481,29977,204
13-09-2021,kancheepuram,371,32,43,1,359,73247,32,4,0,73283,71689,1235
13-09-2021,kanyakumari,262,33,32,0,263,61153,33,124,0,61310,60009,1038
13-09-2021,karur,182,23,17,0,188,23234,23,47,0,23304,22763,353
13-09-2021,krishnagiri,209,17,18,0,208,42092,17,233,0,42342,41801,333
13-09-2021,madurai,166,19,15,2,168,74010,19,172,0,74201,72872,1161
13-09-2021,mayiladuthurai,296,21,24,2,291,22297,21,39,0,22357,21775,291
13-09-2021,nagapattinam,338,25,29,1,333,19927,25,53,0,20005,19363,309
13-09-2021,namakkal,649,50,48,0,651,49474,50,112,0,49636,48507,478
13-09-2021,nilgiris,314,37,23,0,328,32069,37,44,0,32150,31626,196
13-09-2021,perambalur,84,5,6,0,83,11798,5,3,0,11806,11493,230
13-09-2021,pudukottai,204,19,21,0,202,29324,19,35,0,29378,28781,395
13-09-2021,ramanathapuram,42,5,2,0,45,20108,5,135,0,20248,19850,353
13-09-2021,ranipet,166,13,9,0,170,42707,13,49,0,42769,41840,759
13-09-2021,salem,592,55,49,0,598,96402,55,438,0,96895,94651,1646
13-09-2021,sivagangai,156,16,16,0,156,19467,16,108,0,19591,19234,201
13-09-2021,tenkasi,76,14,8,0,82,27119,14,58,0,27191,26625,484
13-09-2021,thanjavur,944,109,74,4,975,71868,109,22,0,71999,70121,903
13-09-2021,theni,69,7,4,0,72,43234,7,45,0,43286,42699,515
13-09-2021,thirupathur,86,13,7,0,92,28585,13,118,0,28716,28008,616
13-09-2021,thiruvallur,708,68,65,0,711,116583,68,10,0,116661,114147,1803
13-09-2021,thiruvannamalai,354,26,39,0,341,53358,26,398,0,53782,52783,658
13-09-2021,thiruvarur,422,35,34,0,423,39447,35,38,0,39520,38698,399
13-09-2021,thoothukudi,116,10,7,0,119,55341,10,275,0,55626,55107,400
13-09-2021,tirunelveli,113,5,11,0,107,48148,5,427,0,48580,48042,431
13-09-2021,tiruppur,949,84,76,2,955,91367,84,11,0,91462,89568,939
13-09-2021,trichy,583,44,68,0,559,74949,44,65,0,75058,73479,1020
13-09-2021,vellore,196,28,20,1,203,47380,28,1664,0,49072,47754,1115
13-09-2021,villupuram,217,21,22,0,216,44909,21,174,0,45104,44536,352
13-09-2021,virudhunagar,68,9,3,0,74,45735,9,104,0,45848,45229,545
13-09-2021,airport surveillance (international),5,0,1,0,4,0,0,1025,0,1025,1020,1
13-09-2021,airport surveillance (domestic),0,0,0,0,0,0,0,1082,0,1082,1081,1
13-09-2021,railway surveillance,0,0,0,0,0,0,0,428,0,428,428,0
14-09-2021,ariyalur,141,12,14,0,139,16503,12,20,0,16535,16144,252
14-09-2021,chengalpattu,1120,116,92,0,1144,166813,116,5,0,166934,163340,2450
14-09-2021,chennai,1752,212,172,2,1790,546387,212,47,0,546646,536421,8435
14-09-2021,coimbatore,2192,201,191,5,2197,238925,201,51,0,239177,234678,2302
14-09-2021,cuddalore,436,35,39,1,431,62589,35,203,0,62827,61548,848
14-09-2021,dharmapuri,212,21,34,0,199,26896,21,216,0,27133,26684,250
14-09-2021,dindigul,124,13,6,0,131,32537,13,77,0,32627,31864,632
14-09-2021,erode,1269,128,119,0,1278,99860,128,94,0,100082,98139,665
14-09-2021,kallakurichi,300,29,15,1,313,30077,29,404,0,30510,29992,205
14-09-2021,kancheepuram,359,38,47,1,349,73279,38,4,0,73321,71736,1236
14-09-2021,kanyakumari,263,26,35,0,254,61186,26,124,0,61336,60044,1038
14-09-2021,karur,188,16,19,0,185,23257,16,47,0,23320,22782,353
14-09-2021,krishnagiri,208,22,17,1,212,42109,22,233,0,42364,41818,334
14-09-2021,madurai,168,26,16,0,178,74029,26,172,0,74227,72888,1161
14-09-2021,mayiladuthurai,291,16,29,0,278,22318,16,39,0,22373,21804,291
14-09-2021,nagapattinam,333,32,31,0,334,19952,32,53,0,20037,19394,309
14-09-2021,namakkal,651,46,56,1,640,49524,46,112,0,49682,48563,479
14-09-2021,nilgiris,328,39,24,0,343,32106,39,44,0,32189,31650,196
14-09-2021,perambalur,83,7,7,0,83,11803,7,3,0,11813,11500,230
14-09-2021,pudukottai,202,17,20,1,198,29343,17,35,0,29395,28801,396
14-09-2021,ramanathapuram,45,2,4,0,43,20113,2,135,0,20250,19854,353
14-09-2021,ranipet,170,12,11,1,170,42720,12,49,0,42781,41851,760
14-09-2021,salem,598,52,52,3,595,96457,52,438,0,96947,94703,1649
14-09-2021,sivagangai,156,19,9,0,166,19483,19,108,0,19610,19243,201
14-09-2021,tenkasi,82,5,7,0,80,27133,5,58,0,27196,26632,484
14-09-2021,thanjavur,975,119,81,3,1010,71977,119,22,0,72118,70202,906
14-09-2021,theni,72,9,5,0,76,43241,9,45,0,43295,42704,515
14-09-2021,thirupathur,92,6,8,0,90,28598,6,118,0,28722,28016,616
14-09-2021,thiruvallur,711,66,67,2,708,116651,66,10,0,116727,114214,1805
14-09-2021,thiruvannamalai,341,20,43,0,318,53384,20,398,0,53802,52826,658
14-09-2021,thiruvarur,423,32,40,0,415,39482,32,38,0,39552,38738,399
14-09-2021,thoothukudi,119,9,10,0,118,55351,9,275,0,55635,55117,400
14-09-2021,tirunelveli,107,13,12,0,108,48153,13,427,0,48593,48054,431
14-09-2021,tiruppur,955,81,83,2,951,91451,81,11,0,91543,89651,941
14-09-2021,trichy,559,43,71,0,531,74993,43,65,0,75101,73550,1020
14-09-2021,vellore,203,27,25,2,203,47408,27,1664,0,49099,47779,1117
14-09-2021,villupuram,216,17,23,0,210,44930,17,174,0,45121,44559,352
14-09-2021,virudhunagar,74,7,3,1,77,45744,7,104,0,45855,45232,546
14-09-2021,airport surveillance (international),4,0,0,0,4,0,0,1025,0,1025,1020,1
14-09-2021,airport surveillance (domestic),0,0,0,0,0,0,0,1082,0,1082,1081,1
14-09-2021,railway surveillance,0,0,0,0,0,0,0,428,0,428,428,0
15-09-2021,ariyalur,139,11,11,0,139,16515,11,20,0,16546,16155,252
15-09-2021,chengalpattu,1138,126,89,1,1174,166924,126,5,0,167055,163429,2452
15-09-2021,chennai,1798,226,174,5,1845,546607,226,47,0,546880,536595,8440
15-09-2021,coimbatore,2202,224,197,4,2225,239131,224,51,0,239406,234875,2306
15-09-2021,cuddalore,433,34,54,2,411,62626,34,203,0,62863,61602,850
15-09-2021,dharmapuri,201,32,26,0,207,26919,32,216,0,27167,26710,250
15-09-2021,dindigul,130,12,8,0,134,32549,12,77,0,32638,31872,632
15-09-2021,erode,1280,130,107,1,1302,99990,130,94,0,100214,98246,666
15-09-2021,kallakurichi,313,35,18,0,330,30106,35,404,0,30545,30010,205
15-09-2021,kancheepuram,351,44,49,3,343,73318,44,4,0,73366,71785,1238
15-09-2021,kanyakumari,256,31,27,0,260,61214,31,124,0,61369,60071,1038
15-09-2021,karur,187,18,14,0,191,23275,18,47,0,23340,22796,353
15-09-2021,krishnagiri,213,19,12,0,220,42132,19,233,0,42384,41830,334
15-09-2021,madurai,172,22,13,0,181,74049,22,172,0,74243,72901,1161
15-09-2021,mayiladuthurai,295,23,28,2,288,22351,23,39,0,22413,21832,293
15-09-2021,nagapattinam,323,33,24,3,329,19973,33,53,0,20059,19418,312
15-09-2021,namakkal,639,51,68,0,622,49569,51,112,0,49732,48631,479
15-09-2021,nilgiris,343,31,27,0,347,32145,31,44,0,32220,31677,196
15-09-2021,perambalur,83,5,6,1,81,11810,5,3,0,11818,11506,231
15-09-2021,pudukottai,198,18,15,2,199,29360,18,35,0,29413,28816,398
15-09-2021,ramanathapuram,43,7,3,0,47,20115,7,135,0,20257,19857,353
15-09-2021,ranipet,178,10,15,0,173,42740,10,49,0,42799,41866,760
15-09-2021,salem,598,62,64,0,596,96512,62,438,0,97012,94767,1649
15-09-2021,sivagangai,165,13,8,0,170,19501,13,108,0,19622,19251,201
15-09-2021,tenkasi,80,8,5,0,83,27138,8,58,0,27204,26637,484
15-09-2021,thanjavur,1003,72,92,0,983,72089,72,22,0,72183,70294,906
15-09-2021,theni,73,8,7,1,73,43247,8,45,0,43300,42711,516
15-09-2021,thirupathur,91,11,6,0,96,28605,11,118,0,28734,28022,616
15-09-2021,thiruvallur,704,67,78,1,692,116713,67,10,0,116790,114292,1806
15-09-2021,thiruvannamalai,323,21,36,0,308,53409,21,398,0,53828,52862,658
15-09-2021,thiruvarur,417,37,37,0,417,39516,37,38,0,39591,38775,399
15-09-2021,thoothukudi,117,10,17,0,110,55360,10,275,0,55645,55134,401
15-09-2021,tirunelveli,108,17,10,0,115,48165,17,427,0,48609,48064,430
15-09-2021,tiruppur,946,88,98,2,934,91527,88,11,0,91626,89749,943
15-09-2021,trichy,525,53,59,1,518,75030,53,65,0,75148,73609,1021
15-09-2021,vellore,191,18,16,0,193,47423,18,1664,0,49105,47795,1117
15-09-2021,villupuram,211,19,19,0,211,44948,19,174,0,45141,44578,352
15-09-2021,virudhunagar,78,12,4,0,86,45752,12,104,0,45868,45236,546
15-09-2021,airport surveillance (international),4,0,1,0,3,0,0,1025,0,1025,1021,1
15-09-2021,airport surveillance (domestic),0,0,0,0,0,0,0,1082,0,1082,1081,1
15-09-2021,railway surveillance,0,0,0,0,0,0,0,428,0,428,428,0
18-09-2021,ariyalur,134,15,11,0,138,16549,15,20,0,16584,16193,253
18-09-2021,chengalpattu,1239,101,98,1,1241,167300,101,5,0,167406,163707,2458
18-09-2021,chennai,1901,204,164,0,1941,547227,204,47,0,547478,537090,8447
18-09-2021,coimbatore,2220,201,215,5,2201,239771,201,51,0,240023,235509,2313
18-09-2021,cuddalore,368,35,51,2,350,62730,35,203,0,62968,61765,853
18-09-2021,dharmapuri,221,29,23,0,227,27018,29,216,0,27263,26784,252
18-09-2021,dindigul,138,10,9,0,139,32586,10,77,0,32673,31901,633
18-09-2021,erode,1342,139,104,0,1377,100348,139,94,0,100581,98538,666
18-09-2021,kallakurichi,364,45,28,0,381,30216,45,404,0,30665,30079,205
18-09-2021,kancheepuram,345,37,36,2,344,73433,37,4,0,73474,71891,1239
18-09-2021,kanyakumari,266,31,17,1,279,61293,31,124,0,61448,60129,1040
18-09-2021,karur,183,17,25,0,175,23326,17,47,0,23390,22862,353
18-09-2021,krishnagiri,256,33,18,0,271,42209,33,233,0,42475,41870,334
18-09-2021,madurai,187,15,13,0,189,74107,15,172,0,74294,72943,1162
18-09-2021,mayiladuthurai,281,18,35,0,264,22444,18,39,0,22501,21943,294
18-09-2021,nagapattinam,322,37,24,1,334,20050,37,53,0,20140,19492,314
18-09-2021,namakkal,630,62,86,1,605,49768,62,112,0,49942,48857,480
18-09-2021,nilgiris,366,30,29,0,367,32244,30,44,0,32318,31755,196
18-09-2021,perambalur,84,9,7,0,86,11833,9,3,0,11845,11527,232
18-09-2021,pudukottai,209,15,14,0,210,29418,15,35,0,29468,28859,399
18-09-2021,ramanathapuram,52,7,4,0,55,20137,7,135,0,20279,19870,354
18-09-2021,ranipet,166,13,19,1,159,42779,13,49,0,42841,41921,761
18-09-2021,salem,589,69,72,2,584,96715,69,438,0,97222,94983,1655
18-09-2021,sivagangai,176,16,6,0,186,19531,16,108,0,19655,19267,202
18-09-2021,tenkasi,89,5,8,0,86,27161,5,58,0,27224,26654,484
18-09-2021,thanjavur,1030,91,92,4,1025,72381,91,22,0,72494,70558,911
18-09-2021,theni,78,12,5,0,85,43269,12,45,0,43326,42725,516
18-09-2021,thirupathur,101,10,6,0,105,28635,10,118,0,28763,28040,618
18-09-2021,thiruvallur,655,56,71,1,639,116900,56,10,0,116966,114519,1808
18-09-2021,thiruvannamalai,297,28,32,1,292,53478,28,398,0,53904,52951,661
18-09-2021,thiruvarur,400,38,44,0,394,39625,38,38,0,39701,38907,400
18-09-2021,thoothukudi,100,13,12,0,101,55387,13,275,0,55675,55173,401
18-09-2021,tirunelveli,133,22,10,0,145,48215,22,427,0,48664,48089,430
18-09-2021,tiruppur,915,94,107,0,902,91832,94,11,0,91937,90089,946
18-09-2021,trichy,494,47,56,0,485,75191,47,65,0,75303,73796,1022
18-09-2021,vellore,207,21,9,0,219,47477,21,1664,0,49162,47825,1118
18-09-2021,villupuram,215,20,16,0,219,45008,20,174,0,45202,44631,352
18-09-2021,virudhunagar,87,7,5,0,89,45782,7,104,0,45893,45258,546
18-09-2021,airport surveillance (international),3,0,0,0,3,0,0,1025,0,1025,1021,1
18-09-2021,airport surveillance (domestic),0,1,0,0,1,0,0,1082,1,1083,1081,1
18-09-2021,railway surveillance,0,0,0,0,0,0,0,428,0,428,428,0
19-09-2021,ariyalur,138,11,14,0,135,16564,11,20,0,16595,16207,253
19-09-2021,chengalpattu,1244,114,102,0,1256,167404,114,5,0,167523,163809,2458
19-09-2021,chennai,1936,232,155,2,2011,547426,232,47,0,547705,537245,8449
19-09-2021,coimbatore,2204,215,217,4,2198,239975,215,51,0,240241,235726,2317
19-09-2021,cuddalore,352,40,53,1,338,62767,40,203,0,63010,61818,854
19-09-2021,dharmapuri,227,21,20,1,227,27047,21,216,0,27284,26804,253
19-09-2021,dindigul,139,12,10,0,141,32596,12,77,0,32685,31911,633
19-09-2021,erode,1371,131,99,0,1403,100481,131,94,0,100706,98637,666
19-09-2021,kallakurichi,381,32,29,0,384,30261,32,404,0,30697,30108,205
19-09-2021,kancheepuram,344,46,39,1,350,73470,46,4,0,73520,71930,1240
19-09-2021,kanyakumari,279,20,12,0,287,61324,20,124,0,61468,60141,1040
19-09-2021,karur,176,15,21,0,170,23344,15,47,0,23406,22883,353
19-09-2021,krishnagiri,270,26,23,0,273,42241,25,233,1,42500,41893,334
19-09-2021,madurai,190,14,16,1,187,74123,14,172,0,74309,72959,1163
19-09-2021,mayiladuthurai,270,19,38,2,249,22468,19,39,0,22526,21981,296
19-09-2021,nagapattinam,330,34,25,1,338,20083,34,53,0,20170,19517,315
19-09-2021,namakkal,610,47,81,0,576,49835,47,112,0,49994,48938,480
19-09-2021,nilgiris,367,34,32,0,369,32274,34,44,0,32352,31787,196
19-09-2021,perambalur,86,7,8,1,84,11842,7,3,0,11852,11535,233
19-09-2021,pudukottai,212,20,17,2,213,29435,20,35,0,29490,28876,401
19-09-2021,ramanathapuram,55,3,5,0,53,20144,3,135,0,20282,19875,354
19-09-2021,ranipet,161,17,18,0,160,42794,17,49,0,42860,41939,761
19-09-2021,salem,583,71,65,3,586,96783,71,438,0,97292,95048,1658
19-09-2021,sivagangai,185,14,9,0,190,19546,14,108,0,19668,19276,202
19-09-2021,tenkasi,86,7,11,0,82,27166,7,58,0,27231,26665,484
19-09-2021,thanjavur,1012,103,90,3,1022,72459,103,22,0,72584,70648,914
19-09-2021,theni,86,7,6,0,87,43282,7,45,0,43334,42731,516
19-09-2021,thirupathur,106,11,7,0,110,28646,11,118,0,28775,28047,618
19-09-2021,thiruvallur,639,66,75,3,627,116956,66,10,0,117032,114594,1811
19-09-2021,thiruvannamalai,294,37,36,1,294,53508,37,398,0,53943,52987,662
19-09-2021,thiruvarur,403,40,48,0,395,39672,40,38,0,39750,38955,400
19-09-2021,thoothukudi,101,18,15,0,104,55400,18,275,0,55693,55188,401
19-09-2021,tirunelveli,143,17,13,0,147,48235,17,427,0,48679,48102,430
19-09-2021,tiruppur,903,95,97,1,900,91927,95,11,0,92033,90186,947
19-09-2021,trichy,485,51,54,0,482,75238,51,65,0,75354,73850,1022
19-09-2021,vellore,212,15,7,0,220,47491,15,1664,0,49170,47832,1118
19-09-2021,villupuram,219,27,19,0,227,45028,27,174,0,45229,44650,352
19-09-2021,virudhunagar,90,8,8,0,90,45790,8,104,0,45902,45266,546
19-09-2021,airport surveillance (international),3,0,0,0,3,0,0,1025,0,1025,1021,1
19-09-2021,airport surveillance (domestic),1,0,0,0,1,0,0,1083,0,1083,1081,1
19-09-2021,railway surveillance,0,0,0,0,0,0,0,428,0,428,428,0
20-09-2021,ariyalur,136,10,12,1,133,16576,10,20,0,16606,16219,254
20-09-2021,chengalpattu,1258,111,116,1,1252,167520,111,5,0,167636,163925,2459
20-09-2021,chennai,2001,206,164,0,2043,547648,206,47,0,547901,537409,8449
20-09-2021,coimbatore,2206,211,225,1,2191,240198,211,51,0,240460,235951,2318
20-09-2021,cuddalore,335,32,48,0,319,62804,32,203,0,63039,61866,854
20-09-2021,dharmapuri,226,29,17,1,237,27067,29,216,0,27312,26821,254
20-09-2021,dindigul,138,11,11,1,137,32605,11,77,0,32693,31922,634
20-09-2021,erode,1391,117,103,0,1405,100600,117,94,0,100811,98740,666
20-09-2021,kallakurichi,385,30,36,2,377,30294,30,404,0,30728,30144,207
20-09-2021,kancheepuram,351,42,38,0,355,73517,42,4,0,73563,71968,1240
20-09-2021,kanyakumari,288,30,16,1,301,61345,30,124,0,61499,60157,1041
20-09-2021,karur,168,13,18,0,163,23357,13,47,0,23417,22901,353
20-09-2021,krishnagiri,274,33,32,0,275,42267,33,234,0,42534,41925,334
20-09-2021,madurai,186,27,14,0,199,74136,27,172,0,74335,72973,1163
20-09-2021,mayiladuthurai,249,15,37,0,227,22487,15,39,0,22541,22018,296
20-09-2021,nagapattinam,342,40,31,4,347,20121,40,53,0,20214,19548,319
20-09-2021,namakkal,585,46,73,2,556,49891,46,112,0,50049,49011,482
20-09-2021,nilgiris,369,39,39,0,369,32308,39,44,0,32391,31826,196
20-09-2021,perambalur,84,6,13,1,76,11849,6,3,0,11858,11548,234
20-09-2021,pudukottai,221,31,24,0,228,29463,31,35,0,29529,28900,401
20-09-2021,ramanathapuram,53,5,4,0,54,20147,5,135,0,20287,19879,354
20-09-2021,ranipet,159,15,22,0,152,42810,15,49,0,42874,41961,761
20-09-2021,salem,593,65,59,1,598,96861,65,438,0,97364,95107,1659
20-09-2021,sivagangai,187,11,15,0,183,19557,11,108,0,19676,19291,202
20-09-2021,tenkasi,83,5,8,0,80,27174,5,58,0,27237,26673,484
20-09-2021,thanjavur,1015,90,87,5,1013,72555,90,22,0,72667,70735,919
20-09-2021,theni,88,8,5,0,91,43290,8,45,0,43343,42736,516
20-09-2021,thirupathur,110,20,12,0,118,28657,20,118,0,28795,28059,618
20-09-2021,thiruvallur,624,65,63,1,625,117019,65,10,0,117094,114657,1812
20-09-2021,thiruvannamalai,295,39,41,0,293,53546,39,398,0,53983,53028,662
20-09-2021,thiruvarur,395,36,44,1,386,39712,36,38,0,39786,38999,401
20-09-2021,thoothukudi,105,12,14,0,103,55419,12,275,0,55706,55202,401
20-09-2021,tirunelveli,144,13,9,0,148,48249,13,427,0,48689,48111,430
20-09-2021,tiruppur,901,91,84,0,908,92023,91,11,0,92125,90270,947
20-09-2021,trichy,483,49,52,0,480,75290,49,65,0,75404,73902,1022
20-09-2021,vellore,220,20,8,0,232,47506,20,1664,0,49190,47840,1118
20-09-2021,villupuram,227,22,21,0,228,45055,22,174,0,45251,44671,352
20-09-2021,virudhunagar,90,16,7,0,99,45798,16,104,0,45918,45273,546
20-09-2021,airport surveillance (international),3,0,1,0,2,0,0,1025,0,1025,1022,1
20-09-2021,airport surveillance (domestic),1,0,0,0,1,0,0,1083,0,1083,1081,1
20-09-2021,railway surveillance,0,0,0,0,0,0,0,428,0,428,428,0
21-09-2021,ariyalur,134,9,11,0,132,16587,9,20,0,16616,16230,254
21-09-2021,chengalpattu,1254,109,134,0,1229,167633,109,5,0,167747,164059,2459
21-09-2021,chennai,2042,198,183,2,2055,547852,198,47,0,548097,537592,8450
21-09-2021,coimbatore,2192,218,242,1,2167,240410,218,51,0,240679,236193,2319
21-09-2021,cuddalore,320,29,35,0,314,62837,29,203,0,63069,61901,854
21-09-2021,dharmapuri,237,28,14,1,250,27096,28,216,0,27340,26835,255
21-09-2021,dindigul,136,10,9,0,137,32615,10,77,0,32702,31931,634
21-09-2021,erode,1402,112,119,0,1395,100714,112,94,0,100920,98859,666
21-09-2021,kallakurichi,377,26,47,0,356,30324,26,404,0,30754,30191,207
21-09-2021,kancheepuram,355,44,34,2,363,73559,44,4,0,73607,72002,1242
21-09-2021,kanyakumari,301,27,18,0,310,61375,27,124,0,61526,60175,1041
21-09-2021,karur,162,14,11,0,165,23369,14,47,0,23430,22912,353
21-09-2021,krishnagiri,275,25,37,0,263,42300,24,234,1,42559,41962,334
21-09-2021,madurai,198,28,8,0,218,74162,28,172,0,74362,72981,1163
21-09-2021,mayiladuthurai,238,24,33,1,228,22513,24,39,0,22576,22051,297
21-09-2021,nagapattinam,333,33,27,2,337,20147,33,53,0,20233,19575,321
21-09-2021,namakkal,560,49,62,0,547,49941,49,112,0,50102,49073,482
21-09-2021,nilgiris,369,34,48,0,355,32347,34,44,0,32425,31874,196
21-09-2021,perambalur,77,7,10,0,74,11856,7,3,0,11866,11558,234
21-09-2021,pudukottai,229,25,32,1,221,29495,25,35,0,29555,28932,402
21-09-2021,ramanathapuram,54,3,3,0,54,20152,3,135,0,20290,19882,354
21-09-2021,ranipet,153,20,16,0,157,42826,20,49,0,42895,41977,761
21-09-2021,salem,600,77,53,1,623,96928,77,438,0,97443,95160,1660
21-09-2021,sivagangai,183,20,19,0,184,19568,20,108,0,19696,19310,202
21-09-2021,tenkasi,79,4,5,0,78,27178,4,58,0,27240,26678,484
21-09-2021,thanjavur,1008,79,76,1,1010,72640,79,22,0,72741,70811,920
21-09-2021,theni,91,6,4,0,93,43298,6,45,0,43349,42740,516
21-09-2021,thirupathur,118,16,15,0,119,28677,16,118,0,28811,28074,618
21-09-2021,thiruvallur,624,61,59,2,624,117084,61,10,0,117155,114716,1815
21-09-2021,thiruvannamalai,294,33,38,0,289,53586,33,398,0,54017,53066,662
21-09-2021,thiruvarur,388,37,36,2,387,39750,37,38,0,39825,39035,403
21-09-2021,thoothukudi,103,10,7,0,106,55431,10,275,0,55716,55209,401
21-09-2021,tirunelveli,149,21,6,0,164,48263,21,427,0,48711,48117,430
21-09-2021,tiruppur,906,85,79,3,909,92112,85,11,0,92208,90349,950
21-09-2021,trichy,482,66,44,0,504,75341,66,65,0,75472,73946,1022
21-09-2021,vellore,230,30,11,0,249,47524,30,1664,0,49218,47851,1118
21-09-2021,villupuram,229,20,26,0,223,45078,20,174,0,45272,44697,352
21-09-2021,virudhunagar,99,10,8,0,101,45814,10,104,0,45928,45281,546
21-09-2021,airport surveillance (international),2,0,0,0,2,0,0,1025,0,1025,1022,1
21-09-2021,airport surveillance (domestic),1,0,0,0,1,0,0,1083,0,1083,1081,1
21-09-2021,railway surveillance,0,0,0,0,0,0,0,428,0,428,428,0
22-09-2021,ariyalur,132,12,12,0,132,16596,12,20,0,16628,16242,254
22-09-2021,chengalpattu,1230,110,128,3,1209,167743,110,5,0,167858,164187,2462
22-09-2021,chennai,2053,194,176,3,2068,548048,194,47,0,548289,537768,8453
22-09-2021,coimbatore,2168,235,237,1,2165,240629,235,51,0,240915,236430,2320
22-09-2021,cuddalore,314,37,28,0,323,62866,37,203,0,63106,61929,854
22-09-2021,dharmapuri,250,38,15,0,273,27124,38,216,0,27378,26850,255
22-09-2021,dindigul,137,7,11,1,132,32625,7,77,0,32709,31942,635
22-09-2021,erode,1391,130,134,2,1385,100822,130,94,0,101046,98993,668
22-09-2021,kallakurichi,356,20,43,0,333,30350,20,404,0,30774,30234,207
22-09-2021,kancheepuram,363,41,29,1,374,73603,41,4,0,73648,72031,1243
22-09-2021,kanyakumari,310,24,27,0,307,61402,24,124,0,61550,60202,1041
22-09-2021,karur,165,23,9,0,179,23383,23,47,0,23453,22921,353
22-09-2021,krishnagiri,263,35,34,0,264,42324,35,235,0,42594,41996,334
22-09-2021,madurai,218,23,14,0,227,74190,23,172,0,74385,72995,1163
22-09-2021,mayiladuthurai,228,21,28,0,221,22537,21,39,0,22597,22079,297
22-09-2021,nagapattinam,338,32,24,0,346,20181,32,53,0,20266,19599,321
22-09-2021,namakkal,548,45,64,0,529,49991,45,112,0,50148,49137,482
22-09-2021,nilgiris,356,35,45,0,346,32382,35,44,0,32461,31919,196
22-09-2021,perambalur,74,4,7,0,71,11863,4,3,0,11870,11565,234
22-09-2021,pudukottai,222,24,38,1,207,29521,24,35,0,29580,28970,403
22-09-2021,ramanathapuram,54,2,5,0,51,20155,2,135,0,20292,19887,354
22-09-2021,ranipet,160,13,18,2,153,42849,13,49,0,42911,41995,763
22-09-2021,salem,626,98,56,0,668,97008,98,438,0,97544,95216,1660
22-09-2021,sivagangai,184,16,26,0,174,19588,16,108,0,19712,19336,202
22-09-2021,tenkasi,78,5,3,0,80,27182,5,58,0,27245,26681,484
22-09-2021,thanjavur,1010,60,82,3,985,72719,60,22,0,72801,70893,923
22-09-2021,theni,93,5,6,0,92,43304,5,45,0,43354,42746,516
22-09-2021,thirupathur,120,14,13,0,121,28694,14,118,0,28826,28087,618
22-09-2021,thiruvallur,624,58,52,0,630,117145,58,10,0,117213,114768,1815
22-09-2021,thiruvannamalai,290,41,42,1,288,53620,41,398,0,54059,53108,663
22-09-2021,thiruvarur,385,39,39,2,383,39785,39,38,0,39862,39074,405
22-09-2021,thoothukudi,106,11,4,0,113,55441,11,275,0,55727,55213,401
22-09-2021,tirunelveli,164,16,10,0,170,48284,16,427,0,48727,48127,430
22-09-2021,tiruppur,907,101,71,0,937,92195,101,11,0,92307,90420,950
22-09-2021,trichy,505,62,48,1,518,75408,62,65,0,75535,73994,1023
22-09-2021,vellore,244,25,16,0,253,47549,25,1664,0,49238,47867,1118
22-09-2021,villupuram,223,17,25,0,215,45098,17,174,0,45289,44722,352
22-09-2021,virudhunagar,101,9,8,0,102,45824,9,104,0,45937,45289,546
22-09-2021,airport surveillance (international),2,0,0,0,2,0,0,1025,0,1025,1022,1
22-09-2021,airport surveillance (domestic),1,0,0,0,1,0,0,1083,0,1083,1081,1
22-09-2021,railway surveillance,0,0,0,0,0,0,0,428,0,428,428,0
23-09-2021,ariyalur,130,9,9,0,130,16606,9,20,0,16635,16251,254
23-09-2021,chengalpattu,1201,107,124,1,1183,167845,107,5,0,167957,164311,2463
23-09-2021,chennai,2071,222,183,5,2105,548245,222,47,0,548514,537951,8458
23-09-2021,coimbatore,2167,226,246,2,2145,240866,226,51,0,241143,236676,2322
23-09-2021,cuddalore,321,39,24,1,335,62901,39,203,0,63143,61953,855
23-09-2021,dharmapuri,272,30,19,0,283,27161,30,216,0,27407,26869,255
23-09-2021,dindigul,132,10,15,1,126,32632,10,77,0,32719,31957,636
23-09-2021,erode,1373,116,152,0,1337,100940,116,94,0,101150,99145,668
23-09-2021,kallakurichi,333,23,38,0,318,30370,23,404,0,30797,30272,207
23-09-2021,kancheepuram,377,36,28,1,384,73647,36,4,0,73687,72059,1244
23-09-2021,kanyakumari,310,25,36,0,299,61429,25,124,0,61578,60238,1041
23-09-2021,karur,176,11,8,0,179,23403,11,47,0,23461,22929,353
23-09-2021,krishnagiri,264,37,29,1,271,42359,36,235,1,42631,42025,335
23-09-2021,madurai,226,33,13,0,246,74212,33,172,0,74417,73008,1163
23-09-2021,mayiladuthurai,231,20,27,1,223,22569,20,39,0,22628,22106,299
23-09-2021,nagapattinam,340,30,22,1,347,20207,30,53,0,20290,19621,322
23-09-2021,namakkal,533,52,56,0,529,50040,52,112,0,50204,49193,482
23-09-2021,nilgiris,346,36,40,0,342,32417,36,44,0,32497,31959,196
23-09-2021,perambalur,72,6,6,0,72,11868,6,3,0,11877,11571,234
23-09-2021,pudukottai,208,23,30,0,201,29546,23,35,0,29604,29000,403
23-09-2021,ramanathapuram,52,5,3,0,54,20158,5,135,0,20298,19890,354
23-09-2021,ranipet,154,12,12,2,152,42863,12,49,0,42924,42007,765
23-09-2021,salem,670,88,67,0,691,97108,88,438,0,97634,95283,1660
23-09-2021,sivagangai,172,18,21,0,169,19602,18,108,0,19728,19357,202
23-09-2021,tenkasi,80,6,5,0,81,27187,6,58,0,27251,26686,484
23-09-2021,thanjavur,986,89,78,4,993,72779,89,22,0,72890,70971,926
23-09-2021,theni,91,8,7,0,92,43308,8,45,0,43361,42753,516
23-09-2021,thirupathur,120,16,10,0,126,28707,16,118,0,28841,28097,618
23-09-2021,thiruvallur,629,81,51,3,656,117202,81,10,0,117293,114819,1818
23-09-2021,thiruvannamalai,291,31,39,0,283,53664,31,398,0,54093,53147,663
23-09-2021,thiruvarur,383,47,42,1,387,39824,47,38,0,39909,39116,406
23-09-2021,thoothukudi,114,12,5,0,121,55453,12,275,0,55740,55218,401
23-09-2021,tirunelveli,169,17,8,0,178,48299,17,427,0,48743,48135,430
23-09-2021,tiruppur,942,82,79,1,944,92301,82,11,0,92394,90499,951
23-09-2021,trichy,520,81,53,0,548,75472,81,65,0,75618,74047,1023
23-09-2021,vellore,251,22,14,0,259,47572,22,1664,0,49258,47881,1118
23-09-2021,villupuram,215,26,18,1,222,45115,26,174,0,45315,44740,353
23-09-2021,virudhunagar,102,13,7,1,107,45833,13,104,0,45950,45296,547
23-09-2021,airport surveillance (international),2,0,0,0,2,0,0,1025,0,1025,1022,1
23-09-2021,airport surveillance (domestic),1,0,0,0,1,0,0,1083,0,1083,1081,1
23-09-2021,railway surveillance,0,0,0,0,0,0,0,428,0,428,428,0
24-09-2021,ariyalur,129,10,12,0,127,16614,10,20,0,16644,16263,254
24-09-2021,chengalpattu,1182,122,123,3,1178,167951,122,5,0,168078,164434,2466
24-09-2021,chennai,2111,205,187,2,2127,548473,205,47,0,548725,538138,8460
24-09-2021,coimbatore,2147,210,235,3,2119,241094,210,51,0,241355,236911,2325
24-09-2021,cuddalore,332,36,16,1,351,62937,36,203,0,63176,61969,856
24-09-2021,dharmapuri,284,38,17,0,305,27192,38,216,0,27446,26886,255
24-09-2021,dindigul,125,9,10,1,123,32641,9,77,0,32727,31967,637
24-09-2021,erode,1317,119,148,1,1287,101035,119,94,0,101248,99293,668
24-09-2021,kallakurichi,319,22,32,1,308,30394,22,404,0,30820,30304,208
24-09-2021,kancheepuram,385,32,20,0,397,73684,32,4,0,73720,72079,1244
24-09-2021,kanyakumari,299,26,43,0,282,61454,26,124,0,61604,60281,1041
24-09-2021,karur,180,12,13,0,179,23415,12,47,0,23474,22942,353
24-09-2021,krishnagiri,272,34,25,1,280,42396,34,236,0,42666,42050,336
24-09-2021,madurai,248,26,18,0,256,74247,26,172,0,74445,73026,1163
24-09-2021,mayiladuthurai,232,19,29,1,221,22598,19,39,0,22656,22135,300
24-09-2021,nagapattinam,342,32,22,0,352,20232,32,53,0,20317,19643,322
24-09-2021,namakkal,534,72,54,1,551,50098,72,112,0,50282,49247,484
24-09-2021,nilgiris,343,37,35,2,343,32454,37,44,0,32535,31994,198
24-09-2021,perambalur,74,7,7,0,74,11876,7,3,0,11886,11578,234
24-09-2021,pudukottai,198,16,26,0,188,29566,16,35,0,29617,29026,403
24-09-2021,ramanathapuram,54,4,4,0,54,20163,4,135,0,20302,19894,354
24-09-2021,ranipet,153,10,14,0,149,42876,10,49,0,42935,42021,765
24-09-2021,salem,700,78,63,2,713,97205,78,438,0,97721,95346,1662
24-09-2021,sivagangai,169,20,23,0,166,19620,20,108,0,19748,19380,202
24-09-2021,tenkasi,81,4,9,0,76,27193,4,58,0,27255,26695,484
24-09-2021,thanjavur,990,61,89,1,961,72865,61,22,0,72948,71060,927
24-09-2021,theni,92,7,8,1,90,43316,7,45,0,43368,42761,517
24-09-2021,thirupathur,125,37,11,0,151,28722,37,118,0,28877,28108,618
24-09-2021,thiruvallur,650,73,62,0,661,117277,73,10,0,117360,114881,1818
24-09-2021,thiruvannamalai,284,41,34,0,291,53696,41,398,0,54135,53181,663
24-09-2021,thiruvarur,389,45,45,0,389,39873,45,38,0,39956,39161,406
24-09-2021,thoothukudi,121,13,6,0,128,55465,13,275,0,55753,55224,401
24-09-2021,tirunelveli,178,21,5,0,194,48316,21,427,0,48764,48140,430
24-09-2021,tiruppur,948,98,86,1,959,92387,98,11,0,92496,90585,952
24-09-2021,trichy,546,73,51,3,565,75551,73,65,0,75689,74098,1026
24-09-2021,vellore,255,23,21,1,256,47590,23,1664,0,49277,47902,1119
24-09-2021,villupuram,222,23,19,1,225,45141,23,174,0,45338,44759,354
24-09-2021,virudhunagar,108,18,9,0,117,45847,18,104,0,45969,45305,547
24-09-2021,airport surveillance (international),2,0,0,0,2,0,0,1025,0,1025,1022,1
24-09-2021,airport surveillance (domestic),1,0,0,0,1,0,0,1083,0,1083,1081,1
24-09-2021,railway surveillance,0,0,0,0,0,0,0,428,0,428,428,0
25-09-2021,ariyalur,127,9,13,0,123,16624,9,20,0,16653,16276,254
25-09-2021,chengalpattu,1180,119,135,0,1164,168075,119,5,0,168199,164569,2466
25-09-2021,chennai,2106,194,198,3,2099,548657,194,47,0,548898,538336,8463
25-09-2021,coimbatore,2124,198,223,4,2095,241309,198,51,0,241558,237134,2329
25-09-2021,cuddalore,353,44,22,0,375,62975,44,203,0,63222,61991,856
25-09-2021,dharmapuri,305,37,20,0,322,27230,37,216,0,27483,26906,255
25-09-2021,dindigul,124,12,12,0,124,32651,12,77,0,32740,31979,637
25-09-2021,erode,1278,121,139,2,1258,101145,121,94,0,101360,99432,670
25-09-2021,kallakurichi,307,21,25,0,303,30415,21,404,0,30840,30329,208
25-09-2021,kancheepuram,398,36,22,0,412,73717,36,4,0,73757,72101,1244
25-09-2021,kanyakumari,282,20,37,0,265,61480,20,124,0,61624,60318,1041
25-09-2021,karur,180,20,15,0,185,23428,20,47,0,23495,22957,353
25-09-2021,krishnagiri,280,26,19,2,285,42430,26,236,0,42692,42069,338
25-09-2021,madurai,256,25,27,1,253,74273,25,172,0,74470,73053,1164
25-09-2021,mayiladuthurai,229,18,26,2,219,22625,18,39,0,22682,22161,302
25-09-2021,nagapattinam,346,33,18,0,361,20258,33,53,0,20344,19661,322
25-09-2021,namakkal,558,55,56,1,556,50177,55,112,0,50344,49303,485
25-09-2021,nilgiris,344,29,31,0,342,32492,29,44,0,32565,32025,198
25-09-2021,perambalur,75,10,6,1,78,11884,10,3,0,11897,11584,235
25-09-2021,pudukottai,188,26,17,0,197,29582,26,35,0,29643,29043,403
25-09-2021,ramanathapuram,54,6,3,0,57,20167,6,135,0,20308,19897,354
25-09-2021,ranipet,154,20,16,0,158,42891,20,49,0,42960,42037,765
25-09-2021,salem,714,69,58,0,725,97284,69,438,0,97791,95404,1662
25-09-2021,sivagangai,167,19,21,0,165,19641,19,108,0,19768,19401,202
25-09-2021,tenkasi,77,3,5,0,75,27198,3,58,0,27259,26700,484
25-09-2021,thanjavur,953,73,104,1,921,72918,73,22,0,73013,71164,928
25-09-2021,theni,90,11,6,0,95,43323,11,45,0,43379,42767,517
25-09-2021,thirupathur,153,26,14,0,165,28761,26,118,0,28905,28122,618
25-09-2021,thiruvallur,668,74,71,1,670,117357,74,10,0,117441,114952,1819
25-09-2021,thiruvannamalai,293,38,29,0,302,53739,38,398,0,54175,53210,663
25-09-2021,thiruvarur,393,68,41,2,418,39922,68,38,0,40028,39202,408
25-09-2021,thoothukudi,128,27,4,0,151,55478,27,275,0,55780,55228,401
25-09-2021,tirunelveli,194,22,8,0,208,48337,22,427,0,48786,48148,430
25-09-2021,tiruppur,956,91,92,1,954,92482,91,11,0,92584,90677,953
25-09-2021,trichy,567,63,54,0,576,75626,63,65,0,75754,74152,1026
25-09-2021,vellore,248,25,23,1,249,47605,25,1664,0,49294,47925,1120
25-09-2021,villupuram,227,22,18,0,231,45166,22,174,0,45362,44777,354
25-09-2021,virudhunagar,117,14,7,0,124,45865,14,104,0,45983,45312,547
25-09-2021,airport surveillance (international),2,0,0,0,2,0,0,1025,0,1025,1022,1
25-09-2021,airport surveillance (domestic),1,0,0,0,1,0,0,1083,0,1083,1081,1
25-09-2021,railway surveillance,0,0,0,0,0,0,0,428,0,428,428,0
26-09-2021,ariyalur,123,8,14,0,117,16633,8,20,0,16661,16290,254
26-09-2021,chengalpattu,1164,118,137,2,1143,168194,118,5,0,168317,164706,2468
26-09-2021,chennai,2099,190,201,1,2087,548851,190,47,0,549088,538537,8464
26-09-2021,coimbatore,2095,196,216,1,2074,241507,196,51,0,241754,237350,2330
26-09-2021,cuddalore,375,42,24,1,392,63019,42,203,0,63264,62015,857
26-09-2021,dharmapuri,322,36,22,0,336,27267,36,216,0,27519,26928,255
26-09-2021,dindigul,124,10,13,0,121,32663,10,77,0,32750,31992,637
26-09-2021,erode,1258,118,136,0,1240,101266,118,94,0,101478,99568,670
26-09-2021,kallakurichi,303,19,27,0,295,30436,19,404,0,30859,30356,208
26-09-2021,kancheepuram,412,35,25,0,422,73753,35,4,0,73792,72126,1244
26-09-2021,kanyakumari,265,32,35,0,262,61500,32,124,0,61656,60353,1041
26-09-2021,karur,185,17,16,0,186,23448,17,47,0,23512,22973,353
26-09-2021,krishnagiri,285,36,18,1,302,42456,35,236,1,42728,42087,339
26-09-2021,madurai,253,32,31,0,254,74298,32,172,0,74502,73084,1164
26-09-2021,mayiladuthurai,219,24,28,0,215,22643,24,39,0,22706,22189,302
26-09-2021,nagapattinam,361,30,21,2,368,20291,30,53,0,20374,19682,324
26-09-2021,namakkal,556,49,54,0,551,50232,49,112,0,50393,49357,485
26-09-2021,nilgiris,342,38,32,0,348,32521,38,44,0,32603,32057,198
26-09-2021,perambalur,78,7,7,1,77,11894,7,3,0,11904,11591,236
26-09-2021,pudukottai,197,21,15,2,201,29608,21,35,0,29664,29058,405
26-09-2021,ramanathapuram,57,5,5,0,57,20173,5,135,0,20313,19902,354
26-09-2021,ranipet,158,19,17,0,160,42911,19,49,0,42979,42054,765
26-09-2021,salem,725,68,55,0,738,97353,68,438,0,97859,95459,1662
26-09-2021,sivagangai,165,17,20,0,162,19660,17,108,0,19785,19421,202
26-09-2021,tenkasi,75,4,9,0,70,27201,4,58,0,27263,26709,484
26-09-2021,thanjavur,921,77,109,3,886,72991,77,22,0,73090,71273,931
26-09-2021,theni,95,10,8,0,97,43334,10,45,0,43389,42775,517
26-09-2021,thirupathur,165,15,11,0,169,28787,15,118,0,28920,28133,618
26-09-2021,thiruvallur,670,73,74,0,669,117431,73,10,0,117514,115026,1819
26-09-2021,thiruvannamalai,302,37,23,0,316,53777,37,398,0,54212,53233,663
26-09-2021,thiruvarur,418,71,38,0,451,39990,71,38,0,40099,39240,408
26-09-2021,thoothukudi,151,18,6,0,163,55505,18,275,0,55798,55234,401
26-09-2021,tirunelveli,208,25,12,0,221,48359,25,427,0,48811,48160,430
26-09-2021,tiruppur,954,86,96,0,944,92573,86,11,0,92670,90773,953
26-09-2021,trichy,576,62,51,0,587,75689,62,65,0,75816,74203,1026
26-09-2021,vellore,249,20,26,0,243,47630,20,1664,0,49314,47951,1120
26-09-2021,villupuram,231,16,19,0,228,45188,16,174,0,45378,44796,354
26-09-2021,virudhunagar,124,13,7,0,130,45879,13,104,0,45996,45319,547
26-09-2021,airport surveillance (international),2,0,0,0,2,0,0,1025,0,1025,1022,1
26-09-2021,airport surveillance (domestic),1,0,0,0,1,0,0,1083,0,1083,1081,1
26-09-2021,railway surveillance,0,0,0,0,0,0,0,428,0,428,428,0
28-09-2021,ariyalur,113,8,10,0,111,16649,8,20,0,16677,16312,254
28-09-2021,chengalpattu,1120,117,125,1,1111,168422,117,5,0,168544,164963,2470
28-09-2021,chennai,2064,184,211,6,2031,549229,184,47,0,549460,538956,8473
28-09-2021,coimbatore,2058,183,197,2,2042,241897,183,51,0,242131,237752,2337
28-09-2021,cuddalore,403,32,34,1,400,63101,32,203,0,63336,62078,858
28-09-2021,dharmapuri,348,38,29,0,357,27343,38,216,0,27597,26983,257
28-09-2021,dindigul,118,11,13,0,116,32684,11,77,0,32772,32019,637
28-09-2021,erode,1206,121,121,0,1206,101477,121,94,0,101692,99816,670
28-09-2021,kallakurichi,286,17,26,0,277,30474,17,404,0,30895,30410,208
28-09-2021,kancheepuram,431,38,43,0,426,73831,38,4,0,73873,72202,1245
28-09-2021,kanyakumari,259,27,27,0,259,61560,27,124,0,61711,60411,1041
28-09-2021,karur,186,16,23,0,179,23486,16,47,0,23549,23016,354
28-09-2021,krishnagiri,318,31,18,0,331,42523,30,237,1,42791,42121,339
28-09-2021,madurai,248,26,25,0,249,74351,26,172,0,74549,73136,1164
28-09-2021,mayiladuthurai,223,17,28,1,211,22707,17,39,0,22763,22249,303
28-09-2021,nagapattinam,360,27,32,1,354,20338,27,53,0,20418,19739,325
28-09-2021,namakkal,547,54,62,0,539,50334,54,112,0,50500,49476,485
28-09-2021,nilgiris,344,36,31,1,348,32594,36,44,0,32674,32126,200
28-09-2021,perambalur,74,9,6,1,76,11906,9,3,0,11918,11605,237
28-09-2021,pudukottai,209,20,13,0,216,29652,20,35,0,29707,29085,406
28-09-2021,ramanathapuram,57,6,5,0,58,20185,6,135,0,20326,19914,354
28-09-2021,ranipet,159,15,14,0,160,42948,15,49,0,43012,42087,765
28-09-2021,salem,756,65,57,0,764,97492,65,438,0,97995,95569,1662
28-09-2021,sivagangai,162,17,12,0,167,19695,17,108,0,19820,19451,202
28-09-2021,tenkasi,70,4,11,0,63,27213,4,58,0,27275,26728,484
28-09-2021,thanjavur,872,90,115,1,846,73154,90,22,0,73266,71486,934
28-09-2021,theni,98,7,7,0,98,43351,7,45,0,43403,42788,517
28-09-2021,thirupathur,174,20,9,0,185,28817,20,118,0,28955,28152,618
28-09-2021,thiruvallur,664,70,64,0,670,117571,70,10,0,117651,115162,1819
28-09-2021,thiruvannamalai,335,31,19,0,347,53854,31,398,0,54283,53273,663
28-09-2021,thiruvarur,479,52,33,0,498,40124,52,38,0,40214,39307,409
28-09-2021,thoothukudi,169,14,14,0,169,55541,14,275,0,55830,55260,401
28-09-2021,tirunelveli,222,24,15,0,231,48402,24,427,0,48853,48192,430
28-09-2021,tiruppur,929,86,103,0,912,92752,86,11,0,92849,90983,954
28-09-2021,trichy,595,59,46,1,607,75807,59,65,0,75931,74297,1027
28-09-2021,vellore,241,24,22,1,242,47672,24,1664,0,49360,47997,1121
28-09-2021,villupuram,226,21,16,0,231,45219,21,174,0,45414,44829,354
28-09-2021,virudhunagar,135,13,7,0,141,45906,13,104,0,46023,45335,547
28-09-2021,airport surveillance (international),2,0,0,0,2,0,0,1025,0,1025,1022,1
28-09-2021,airport surveillance (domestic),1,0,0,0,1,0,0,1083,0,1083,1081,1
28-09-2021,railway surveillance,0,0,0,0,0,0,0,428,0,428,428,0
30-09-2021,ariyalur,103,6,12,1,96,16662,6,20,0,16688,16337,255
30-09-2021,chengalpattu,1100,112,115,1,1096,168651,112,5,0,168768,165200,2472
30-09-2021,chennai,2003,183,211,5,1970,549597,183,47,0,549827,539375,8482
30-09-2021,coimbatore,2040,176,176,2,2038,242265,176,51,0,242492,238114,2340
30-09-2021,cuddalore,389,34,39,0,384,63164,34,203,0,63401,62159,858
30-09-2021,dharmapuri,359,45,36,0,368,27417,45,216,0,27678,27053,257
30-09-2021,dindigul,120,14,14,1,119,32711,14,77,0,32802,32045,638
30-09-2021,erode,1194,109,121,0,1182,101703,109,94,0,101906,100054,670
30-09-2021,kallakurichi,280,22,31,0,271,30523,22,404,0,30949,30469,209
30-09-2021,kancheepuram,415,36,54,1,396,73911,36,4,0,73951,72308,1247
30-09-2021,kanyakumari,263,26,24,0,265,61617,26,124,0,61767,60461,1041
30-09-2021,karur,179,19,22,0,176,23522,19,47,0,23588,23057,355
30-09-2021,krishnagiri,339,29,26,0,342,42582,29,238,0,42849,42168,339
30-09-2021,madurai,252,24,19,0,257,74403,24,172,0,74599,73178,1164
30-09-2021,mayiladuthurai,220,26,23,1,222,22754,26,39,0,22819,22292,305
30-09-2021,nagapattinam,345,29,37,1,336,20392,29,53,0,20474,19811,327
30-09-2021,namakkal,528,65,65,1,527,50445,65,112,0,50622,49609,486
30-09-2021,nilgiris,341,35,30,0,346,32661,35,44,0,32740,32193,201
30-09-2021,perambalur,87,8,6,0,89,11931,8,3,0,11942,11616,237
30-09-2021,pudukottai,219,15,13,1,220,29693,15,35,0,29743,29114,409
30-09-2021,ramanathapuram,62,10,9,2,61,20202,10,135,0,20347,19930,356
30-09-2021,ranipet,164,17,11,0,170,42980,17,49,0,43046,42109,767
30-09-2021,salem,764,60,61,1,762,97622,60,438,0,98120,95693,1665
30-09-2021,sivagangai,173,14,7,0,180,19726,14,108,0,19848,19466,202
30-09-2021,tenkasi,60,4,5,0,59,27220,4,58,0,27282,26739,484
30-09-2021,thanjavur,814,98,112,2,798,73321,98,22,0,73441,71707,936
30-09-2021,theni,93,9,15,0,87,43366,9,45,0,43420,42816,517
30-09-2021,thirupathur,192,17,6,0,203,28853,17,118,0,28988,28166,619
30-09-2021,thiruvallur,676,68,57,2,685,117711,68,10,0,117789,115281,1823
30-09-2021,thiruvannamalai,355,28,25,0,358,53917,28,398,0,54343,53322,663
30-09-2021,thiruvarur,505,48,33,1,519,40220,48,38,0,40306,39376,411
30-09-2021,thoothukudi,174,14,10,2,176,55570,14,275,0,55859,55280,403
30-09-2021,tirunelveli,232,20,21,0,231,48445,20,427,0,48892,48231,430
30-09-2021,tiruppur,906,84,101,1,888,92929,84,11,0,93024,91181,955
30-09-2021,trichy,621,57,38,2,638,75925,57,65,0,76047,74378,1031
30-09-2021,vellore,239,22,16,0,245,47710,22,1664,0,49396,48030,1121
30-09-2021,villupuram,240,19,18,0,241,45263,19,174,0,45456,44861,354
30-09-2021,virudhunagar,143,10,7,0,146,45930,10,104,0,46044,45351,547
30-09-2021,airport surveillance (international),2,0,0,0,2,0,0,1025,0,1025,1022,1
30-09-2021,airport surveillance (domestic),1,0,0,0,1,0,0,1083,0,1083,1081,1
30-09-2021,railway surveillance,0,0,0,0,0,0,0,428,0,428,428,0
01-10-2021,ariyalur,96,5,8,0,93,16668,5,20,0,16693,16345,255
01-10-2021,chengalpattu,1088,111,109,3,1087,168755,111,5,0,168871,165309,2475
01-10-2021,chennai,1973,190,208,3,1952,549783,190,47,0,550020,539583,8485
01-10-2021,coimbatore,2040,170,186,2,2022,242443,170,51,0,242664,238300,2342
01-10-2021,cuddalore,382,38,37,0,383,63196,38,203,0,63437,62196,858
01-10-2021,dharmapuri,369,43,31,2,379,27463,43,216,0,27722,27084,259
01-10-2021,dindigul,118,18,9,0,127,32724,18,77,0,32819,32054,638
01-10-2021,erode,1181,102,116,2,1165,101811,102,94,0,102007,100170,672
01-10-2021,kallakurichi,272,19,43,0,248,30546,19,404,0,30969,30512,209
01-10-2021,kancheepuram,399,38,51,1,385,73950,38,4,0,73992,72359,1248
01-10-2021,kanyakumari,265,29,20,1,273,61643,29,124,0,61796,60481,1042
01-10-2021,karur,173,22,18,0,177,23538,22,47,0,23607,23075,355
01-10-2021,krishnagiri,341,28,28,0,341,42610,28,238,0,42876,42196,339
01-10-2021,madurai,257,25,14,0,268,74427,25,172,0,74624,73192,1164
01-10-2021,mayiladuthurai,223,23,25,1,220,22781,23,39,0,22843,22317,306
01-10-2021,nagapattinam,339,30,46,1,322,20424,30,53,0,20507,19857,328
01-10-2021,namakkal,527,58,54,1,530,50510,58,112,0,50680,49663,487
01-10-2021,nilgiris,346,34,26,0,354,32696,34,44,0,32774,32219,201
01-10-2021,perambalur,89,7,7,1,88,11939,7,3,0,11949,11623,238
01-10-2021,pudukottai,221,14,12,0,223,29709,14,35,0,29758,29126,409
01-10-2021,ramanathapuram,61,9,5,0,65,20212,9,135,0,20356,19935,356
01-10-2021,ranipet,169,15,10,1,173,42996,15,49,0,43060,42119,768
01-10-2021,salem,762,56,72,1,745,97682,56,438,0,98176,95765,1666
01-10-2021,sivagangai,180,15,9,0,186,19740,15,108,0,19863,19475,202
01-10-2021,tenkasi,59,3,6,0,56,27224,3,58,0,27285,26745,484
01-10-2021,thanjavur,791,107,105,2,791,73412,107,22,0,73541,71812,938
01-10-2021,theni,87,8,11,0,84,43375,8,45,0,43428,42827,517
01-10-2021,thirupathur,203,18,9,0,212,28870,18,118,0,29006,28175,619
01-10-2021,thiruvallur,683,66,53,0,696,117777,66,10,0,117853,115334,1823
01-10-2021,thiruvannamalai,358,27,27,0,358,53945,27,398,0,54370,53349,663
01-10-2021,thiruvarur,523,51,35,1,538,40272,51,38,0,40361,39411,412
01-10-2021,thoothukudi,178,13,16,1,174,55586,13,275,0,55874,55296,404
01-10-2021,tirunelveli,232,19,23,0,228,48466,19,427,0,48912,48254,430
01-10-2021,tiruppur,891,80,98,0,873,93016,80,11,0,93107,91279,955
01-10-2021,trichy,638,59,42,1,654,75982,59,65,0,76106,74420,1032
01-10-2021,vellore,246,20,17,0,249,47733,20,1664,0,49417,48047,1121
01-10-2021,villupuram,241,18,24,0,235,45282,18,174,0,45474,44885,354
01-10-2021,virudhunagar,146,9,13,0,142,45940,9,104,0,46053,45364,547
01-10-2021,airport surveillance (international),2,0,0,0,2,0,0,1025,0,1025,1022,1
01-10-2021,airport surveillance (domestic),1,0,0,0,1,0,0,1083,0,1083,1081,1
01-10-2021,railway surveillance,0,0,0,0,0,0,0,428,0,428,428,0
02-10-2021,ariyalur,93,9,7,0,95,16673,9,20,0,16702,16352,255
02-10-2021,chengalpattu,1087,107,96,2,1096,168866,107,5,0,168978,165405,2477
02-10-2021,chennai,1958,188,204,5,1937,549979,188,47,0,550214,539787,8490
02-10-2021,coimbatore,2025,163,198,0,1990,242616,163,51,0,242830,238498,2342
02-10-2021,cuddalore,383,30,42,1,370,63234,30,203,0,63467,62238,859
02-10-2021,dharmapuri,379,34,33,0,380,27506,34,216,0,27756,27117,259
02-10-2021,dindigul,124,12,10,0,126,32739,12,77,0,32828,32064,638
02-10-2021,erode,1164,95,108,0,1151,101912,95,94,0,102101,100278,672
02-10-2021,kallakurichi,248,18,35,0,231,30565,18,404,0,30987,30547,209
02-10-2021,kancheepuram,382,34,47,3,366,73985,34,4,0,74023,72406,1251
02-10-2021,kanyakumari,273,26,19,0,280,61672,26,124,0,61822,60500,1042
02-10-2021,karur,178,24,14,0,188,23561,24,47,0,23632,23089,355
02-10-2021,krishnagiri,341,31,32,1,339,42638,31,238,0,42907,42228,340
02-10-2021,madurai,267,35,16,0,286,74451,35,172,0,74658,73208,1164
02-10-2021,mayiladuthurai,235,31,30,0,236,22819,31,39,0,22889,22347,306
02-10-2021,nagapattinam,307,29,34,0,302,20439,29,53,0,20521,19891,328
02-10-2021,namakkal,523,53,46,1,529,50561,53,112,0,50726,49709,488
02-10-2021,nilgiris,354,33,29,1,357,32730,33,44,0,32807,32248,202
02-10-2021,perambalur,88,8,6,1,89,11946,8,3,0,11957,11629,239
02-10-2021,pudukottai,222,19,18,0,223,29722,19,35,0,29776,29144,409
02-10-2021,ramanathapuram,65,8,3,0,70,20221,8,135,0,20364,19938,356
02-10-2021,ranipet,174,20,14,0,180,43012,20,49,0,43081,42133,768
02-10-2021,salem,750,55,69,1,735,97743,55,438,0,98236,95834,1667
02-10-2021,sivagangai,186,12,11,0,187,19755,12,108,0,19875,19486,202
02-10-2021,tenkasi,56,2,7,0,51,27227,2,58,0,27287,26752,484
02-10-2021,thanjavur,796,94,94,1,795,73524,94,22,0,73640,71906,939
02-10-2021,theni,83,9,8,0,84,43382,9,45,0,43436,42835,517
02-10-2021,thirupathur,212,24,13,0,223,28888,24,118,0,29030,28188,619
02-10-2021,thiruvallur,691,61,56,2,694,117838,61,10,0,117909,115390,1825
02-10-2021,thiruvannamalai,360,26,31,1,354,53974,26,398,0,54398,53380,664
02-10-2021,thiruvarur,535,62,37,2,558,40320,62,38,0,40420,39448,414
02-10-2021,thoothukudi,174,15,20,0,169,55599,15,275,0,55889,55316,404
02-10-2021,tirunelveli,228,26,25,0,229,48485,26,427,0,48938,48279,430
02-10-2021,tiruppur,875,79,92,0,862,93098,79,11,0,93188,91371,955
02-10-2021,trichy,658,53,48,0,663,76045,53,65,0,76163,74468,1032
02-10-2021,vellore,245,17,15,2,245,47749,17,1664,0,49430,48062,1123
02-10-2021,villupuram,235,17,28,0,224,45300,17,174,0,45491,44913,354
02-10-2021,virudhunagar,142,19,12,0,149,45949,19,104,0,46072,45376,547
02-10-2021,airport surveillance (international),2,0,0,0,2,0,0,1025,0,1025,1022,1
02-10-2021,airport surveillance (domestic),1,0,0,0,1,0,0,1083,0,1083,1081,1
02-10-2021,railway surveillance,0,0,0,0,0,0,0,428,0,428,428,0
03-10-2021,ariyalur,96,7,9,0,94,16683,7,20,0,16710,16361,255
03-10-2021,chengalpattu,1094,105,91,2,1106,168971,105,5,0,169081,165496,2479
03-10-2021,chennai,1937,184,194,1,1926,550167,184,47,0,550398,539981,8491
03-10-2021,coimbatore,1990,158,206,1,1941,242779,158,51,0,242988,238704,2343
03-10-2021,cuddalore,370,32,38,0,364,63264,32,203,0,63499,62276,859
03-10-2021,dharmapuri,380,33,34,3,376,27540,33,216,0,27789,27151,262
03-10-2021,dindigul,125,11,8,0,128,32750,11,77,0,32838,32072,638
03-10-2021,erode,1147,91,103,0,1135,102003,91,94,0,102188,100381,672
03-10-2021,kallakurichi,232,17,26,0,223,30584,17,404,0,31005,30573,209
03-10-2021,kancheepuram,366,33,39,1,359,74019,33,4,0,74056,72445,1252
03-10-2021,kanyakumari,280,25,21,1,283,61698,25,124,0,61847,60521,1043
03-10-2021,karur,185,20,16,0,189,23582,20,47,0,23649,23105,355
03-10-2021,krishnagiri,341,41,41,1,340,42671,41,238,0,42950,42269,341
03-10-2021,madurai,282,33,13,0,302,74482,32,172,1,74687,73221,1164
03-10-2021,mayiladuthurai,236,27,35,1,227,22850,27,39,0,22916,22382,307
03-10-2021,nagapattinam,303,28,29,2,300,20469,28,53,0,20550,19920,330
03-10-2021,namakkal,528,51,36,0,543,50613,51,112,0,50776,49745,488
03-10-2021,nilgiris,358,38,25,0,371,32764,38,44,0,32846,32273,202
03-10-2021,perambalur,90,7,7,1,89,11955,7,3,0,11965,11636,240
03-10-2021,pudukottai,227,23,28,2,220,29745,23,35,0,29803,29172,411
03-10-2021,ramanathapuram,70,9,5,0,74,20229,9,135,0,20373,19943,356
03-10-2021,ranipet,181,18,18,0,181,43033,18,49,0,43100,42151,768
03-10-2021,salem,737,53,74,0,716,97800,53,438,0,98291,95908,1667
03-10-2021,sivagangai,188,14,17,1,184,19768,14,108,0,19890,19503,203
03-10-2021,tenkasi,51,1,6,0,46,27229,1,58,0,27288,26758,484
03-10-2021,thanjavur,789,93,87,1,794,73612,93,22,0,73727,71993,940
03-10-2021,theni,83,8,4,0,87,43390,8,45,0,43443,42839,517
03-10-2021,thirupathur,225,19,14,1,229,28914,19,118,0,29051,28202,620
03-10-2021,thiruvallur,695,62,48,0,709,117900,62,10,0,117972,115438,1825
03-10-2021,thiruvannamalai,355,25,37,1,342,54001,25,398,0,54424,53417,665
03-10-2021,thiruvarur,559,58,31,2,584,40383,58,38,0,40479,39479,416
03-10-2021,thoothukudi,169,13,17,0,165,55614,13,275,0,55902,55333,404
03-10-2021,tirunelveli,229,21,28,0,222,48511,21,427,0,48959,48307,430
03-10-2021,tiruppur,866,76,86,1,855,93181,76,11,0,93268,91457,956
03-10-2021,trichy,667,51,59,0,659,76102,51,65,0,76218,74527,1032
03-10-2021,vellore,239,15,19,0,235,47760,15,1664,0,49439,48081,1123
03-10-2021,villupuram,224,15,22,0,217,45317,15,174,0,45506,44935,354
03-10-2021,virudhunagar,149,16,10,0,155,45968,16,104,0,46088,45386,547
03-10-2021,airport surveillance (international),2,0,0,0,2,0,0,1025,0,1025,1022,1
03-10-2021,airport surveillance (domestic),1,0,1,0,0,0,0,1083,0,1083,1082,1
03-10-2021,railway surveillance,0,0,0,0,0,0,0,428,0,428,428,0
04-10-2021,ariyalur,94,6,13,0,87,16690,6,20,0,16716,16374,255
04-10-2021,chengalpattu,1110,103,87,0,1126,169080,103,5,0,169188,165583,2479
04-10-2021,chennai,1929,181,189,4,1917,550354,181,47,0,550582,540170,8495
04-10-2021,coimbatore,1941,155,195,0,1901,242937,155,51,0,243143,238899,2343
04-10-2021,cuddalore,365,30,35,0,360,63297,30,203,0,63530,62311,859
04-10-2021,dharmapuri,376,32,27,1,380,27572,32,216,0,27820,27178,262
04-10-2021,dindigul,129,10,6,0,133,32762,10,77,0,32849,32078,638
04-10-2021,erode,1126,88,105,0,1109,102085,88,94,0,102267,100486,672
04-10-2021,kallakurichi,223,16,24,0,215,30601,16,404,0,31021,30597,209
04-10-2021,kancheepuram,361,31,36,0,356,74054,31,4,0,74089,72481,1252
04-10-2021,kanyakumari,283,24,26,0,281,61723,24,124,0,61871,60547,1043
04-10-2021,karur,189,18,12,0,195,23602,18,47,0,23667,23117,355
04-10-2021,krishnagiri,339,38,47,1,329,42712,38,238,0,42988,42316,343
04-10-2021,madurai,301,30,19,2,310,74513,30,173,0,74716,73240,1166
04-10-2021,mayiladuthurai,229,25,28,0,226,22879,25,39,0,22943,22410,307
04-10-2021,nagapattinam,299,24,22,0,301,20496,24,53,0,20573,19942,330
04-10-2021,namakkal,545,49,38,0,556,50666,49,112,0,50827,49783,488
04-10-2021,nilgiris,371,35,29,0,377,32802,35,44,0,32881,32302,202
04-10-2021,perambalur,89,5,8,0,86,11962,5,3,0,11970,11644,240
04-10-2021,pudukottai,221,20,32,1,208,29769,20,35,0,29824,29204,412
04-10-2021,ramanathapuram,74,8,4,0,78,20238,8,135,0,20381,19947,356
04-10-2021,ranipet,182,16,15,0,183,43052,16,49,0,43117,42166,768
04-10-2021,salem,717,51,81,0,687,97854,51,438,0,98343,95989,1667
04-10-2021,sivagangai,183,12,20,0,175,19781,12,108,0,19901,19523,203
04-10-2021,tenkasi,46,2,7,0,41,27230,2,58,0,27290,26765,484
04-10-2021,thanjavur,792,90,74,3,805,73703,90,22,0,73815,72067,943
04-10-2021,theni,87,7,5,0,89,43398,7,45,0,43450,42844,517
04-10-2021,thirupathur,229,18,16,0,231,28933,18,118,0,29069,28218,620
04-10-2021,thiruvallur,702,60,54,2,706,117955,60,10,0,118025,115492,1827
04-10-2021,thiruvannamalai,342,23,31,0,334,54026,23,398,0,54447,53448,665
04-10-2021,thiruvarur,585,55,37,1,602,40442,55,38,0,40535,39516,417
04-10-2021,thoothukudi,166,17,13,1,169,55628,17,275,0,55920,55346,405
04-10-2021,tirunelveli,220,19,25,0,214,48530,19,427,0,48976,48332,430
04-10-2021,tiruppur,860,74,82,0,852,93262,74,11,0,93347,91539,956
04-10-2021,trichy,658,50,63,0,645,76152,50,65,0,76267,74590,1032
04-10-2021,vellore,235,17,17,0,235,47775,17,1664,0,49456,48098,1123
04-10-2021,villupuram,217,13,23,0,207,45332,13,174,0,45519,44958,354
04-10-2021,virudhunagar,155,14,14,0,155,45984,14,104,0,46102,45400,547
04-10-2021,airport surveillance (international),2,1,0,0,3,0,0,1025,1,1026,1022,1
04-10-2021,airport surveillance (domestic),0,0,0,0,0,0,0,1083,0,1083,1082,1
04-10-2021,railway surveillance,0,0,0,0,0,0,0,428,0,428,428,0
05-10-2021,ariyalur,87,7,9,0,85,16696,7,20,0,16723,16383,255
05-10-2021,chengalpattu,1126,113,86,0,1153,169183,113,5,0,169301,165669,2479
05-10-2021,chennai,1915,179,192,2,1900,550533,179,47,0,550759,540362,8497
05-10-2021,coimbatore,1901,151,208,2,1842,243092,151,51,0,243294,239107,2345
05-10-2021,cuddalore,358,28,32,0,354,63325,28,203,0,63556,62343,859
05-10-2021,dharmapuri,380,31,28,1,382,27604,31,216,0,27851,27206,263
05-10-2021,dindigul,133,11,7,0,137,32772,11,77,0,32860,32085,638
05-10-2021,erode,1106,93,98,1,1100,102170,93,94,0,102357,100584,673
05-10-2021,kallakurichi,215,15,20,0,210,30617,15,404,0,31036,30617,209
05-10-2021,kancheepuram,356,34,34,1,355,74085,34,4,0,74123,72515,1253
05-10-2021,kanyakumari,281,23,29,0,275,61747,23,124,0,61894,60576,1043
05-10-2021,karur,196,17,13,0,200,23621,17,47,0,23685,23130,355
05-10-2021,krishnagiri,330,33,43,0,320,42751,33,238,0,43022,42359,343
05-10-2021,madurai,310,29,26,0,313,74543,29,173,0,74745,73266,1166
05-10-2021,mayiladuthurai,228,24,12,1,239,22906,24,39,0,22969,22422,308
05-10-2021,nagapattinam,303,20,15,0,308,20522,20,53,0,20595,19957,330
05-10-2021,namakkal,553,48,41,0,560,50712,48,112,0,50872,49824,488
05-10-2021,nilgiris,377,34,37,2,372,32837,34,44,0,32915,32339,204
05-10-2021,perambalur,86,6,4,0,88,11967,6,3,0,11976,11648,240
05-10-2021,pudukottai,210,19,27,0,202,29791,19,35,0,29845,29231,412
05-10-2021,ramanathapuram,78,7,5,0,80,20246,7,135,0,20388,19952,356
05-10-2021,ranipet,182,14,11,0,185,43067,14,49,0,43130,42177,768
05-10-2021,salem,691,49,87,0,653,97909,49,438,0,98396,96076,1667
05-10-2021,sivagangai,175,11,17,0,169,19793,11,108,0,19912,19540,203
05-10-2021,tenkasi,41,3,6,0,38,27232,3,58,0,27293,26771,484
05-10-2021,thanjavur,802,83,65,3,817,73790,83,22,0,73895,72132,946
05-10-2021,theni,88,11,4,0,95,43404,11,45,0,43460,42848,517
05-10-2021,thirupathur,230,15,25,1,219,28950,15,118,0,29083,28243,621
05-10-2021,thiruvallur,710,58,62,0,706,118019,58,10,0,118087,115554,1827
05-10-2021,thiruvannamalai,336,21,33,0,324,54051,21,398,0,54470,53481,665
05-10-2021,thiruvarur,602,50,31,0,621,40497,50,38,0,40585,39547,417
05-10-2021,thoothukudi,170,16,10,0,176,55646,16,275,0,55937,55356,405
05-10-2021,tirunelveli,213,26,18,0,221,48548,26,427,0,49001,48350,430
05-10-2021,tiruppur,854,72,79,1,846,93338,72,11,0,93421,91618,957
05-10-2021,trichy,646,51,74,1,622,76203,51,65,0,76319,74664,1033
05-10-2021,vellore,229,18,22,0,225,47786,18,1664,0,49468,48120,1123
05-10-2021,villupuram,207,14,19,0,202,45345,14,174,0,45533,44977,354
05-10-2021,virudhunagar,156,15,18,0,153,45999,15,104,0,46118,45418,547
05-10-2021,airport surveillance (international),3,0,1,0,2,0,0,1026,0,1026,1023,1
05-10-2021,airport surveillance (domestic),0,0,0,0,0,0,0,1083,0,1083,1082,1
05-10-2021,railway surveillance,0,0,0,0,0,0,0,428,0,428,428,0
06-10-2021,ariyalur,83,6,8,0,81,16701,6,20,0,16727,16391,255
06-10-2021,chengalpattu,1154,110,94,1,1169,169297,110,5,0,169412,165763,2480
06-10-2021,chennai,1900,176,187,4,1885,550713,176,47,0,550936,540549,8502
06-10-2021,coimbatore,1842,149,184,4,1803,243243,149,51,0,243443,239291,2349
06-10-2021,cuddalore,354,26,29,1,350,63353,26,203,0,63582,62372,860
06-10-2021,dharmapuri,383,32,26,1,388,27636,32,216,0,27884,27232,264
06-10-2021,dindigul,137,13,9,0,141,32783,13,77,0,32873,32094,638
06-10-2021,erode,1083,90,103,0,1070,102246,90,94,0,102430,100687,673
06-10-2021,kallakurichi,210,14,16,0,208,30632,14,404,0,31050,30633,209
06-10-2021,kancheepuram,357,32,28,0,361,74120,32,4,0,74156,72543,1252
06-10-2021,kanyakumari,275,21,23,0,273,61770,21,124,0,61915,60599,1043
06-10-2021,karur,199,16,11,0,204,23637,16,47,0,23700,23141,355
06-10-2021,krishnagiri,321,31,31,2,319,42785,31,238,0,43054,42390,345
06-10-2021,madurai,313,26,30,0,309,74572,26,173,0,74771,73296,1166
06-10-2021,mayiladuthurai,241,21,13,0,249,22932,21,39,0,22992,22435,308
06-10-2021,nagapattinam,308,25,18,1,314,20542,25,53,0,20620,19975,331
06-10-2021,namakkal,564,47,49,0,562,50764,47,112,0,50923,49873,488
06-10-2021,nilgiris,372,38,42,1,367,32871,38,44,0,32953,32381,205
06-10-2021,perambalur,88,5,7,0,86,11973,5,3,0,11981,11655,240
06-10-2021,pudukottai,201,22,22,0,201,29809,22,35,0,29866,29253,412
06-10-2021,ramanathapuram,80,10,4,0,86,20253,10,135,0,20398,19956,356
06-10-2021,ranipet,186,12,15,1,182,43082,12,49,0,43143,42192,769
06-10-2021,salem,656,47,72,0,631,97961,47,438,0,98446,96148,1667
06-10-2021,sivagangai,169,9,19,0,159,19804,9,108,0,19921,19559,203
06-10-2021,tenkasi,40,3,5,0,38,27237,3,58,0,27298,26776,484
06-10-2021,thanjavur,815,80,52,1,842,73871,80,22,0,73973,72184,947
06-10-2021,theni,95,9,6,2,96,43415,9,45,0,43469,42854,519
06-10-2021,thirupathur,221,13,27,0,207,28967,13,118,0,29098,28270,621
06-10-2021,thiruvallur,705,57,69,0,693,118076,57,10,0,118143,115623,1827
06-10-2021,thiruvannamalai,324,20,35,0,309,54072,20,398,0,54490,53516,665
06-10-2021,thiruvarur,622,66,37,2,649,40548,66,38,0,40652,39584,419
06-10-2021,thoothukudi,177,14,14,0,177,55663,14,275,0,55952,55370,405
06-10-2021,tirunelveli,215,23,10,0,228,48568,23,427,0,49018,48360,430
06-10-2021,tiruppur,856,70,84,3,839,93420,70,11,0,93501,91702,960
06-10-2021,trichy,624,50,78,1,595,76256,50,65,0,76371,74742,1034
06-10-2021,vellore,221,16,24,0,213,47800,16,1664,0,49480,48144,1123
06-10-2021,villupuram,202,20,21,0,201,45359,20,174,0,45553,44998,354
06-10-2021,virudhunagar,154,13,17,0,150,46015,13,104,0,46132,45435,547
06-10-2021,airport surveillance (international),2,0,0,0,2,0,0,1026,0,1026,1023,1
06-10-2021,airport surveillance (domestic),0,0,0,0,0,0,0,1083,0,1083,1082,1
06-10-2021,railway surveillance,0,0,0,0,0,0,0,428,0,428,428,0
07-10-2021,ariyalur,81,5,7,1,78,16707,5,20,0,16732,16398,256
07-10-2021,chengalpattu,1166,107,97,1,1175,169404,107,5,0,169516,165860,2481
07-10-2021,chennai,1886,173,191,3,1865,550890,173,47,0,551110,540740,8505
07-10-2021,coimbatore,1804,145,187,7,1755,243393,145,51,0,243589,239478,2356
07-10-2021,cuddalore,350,23,31,0,342,63379,23,203,0,63605,62403,860
07-10-2021,dharmapuri,388,29,24,1,392,27668,29,216,0,27913,27256,265
07-10-2021,dindigul,140,10,10,0,140,32795,10,77,0,32882,32104,638
07-10-2021,erode,1066,85,105,1,1045,102332,85,94,0,102511,100792,674
07-10-2021,kallakurichi,208,12,21,0,199,30646,12,404,0,31062,30654,209
07-10-2021,kancheepuram,362,30,26,0,366,74153,30,4,0,74187,72569,1252
07-10-2021,kanyakumari,273,23,22,0,274,61791,23,124,0,61938,60621,1043
07-10-2021,karur,204,14,12,0,206,23653,14,47,0,23714,23153,355
07-10-2021,krishnagiri,319,30,27,0,322,42816,30,238,0,43084,42417,345
07-10-2021,madurai,309,23,32,0,300,74598,23,173,0,74794,73328,1166
07-10-2021,mayiladuthurai,254,23,14,2,261,22958,23,39,0,23020,22449,310
07-10-2021,nagapattinam,312,27,16,1,322,20565,27,53,0,20645,19991,332
07-10-2021,namakkal,563,60,45,2,576,50812,60,112,0,50984,49918,490
07-10-2021,nilgiris,369,34,39,0,364,32911,34,44,0,32989,32420,205
07-10-2021,perambalur,86,4,5,0,85,11978,4,3,0,11985,11660,240
07-10-2021,pudukottai,197,20,19,0,198,29827,20,35,0,29882,29272,412
07-10-2021,ramanathapuram,86,13,6,0,93,20263,13,135,0,20411,19962,356
07-10-2021,ranipet,181,14,20,0,175,43093,14,49,0,43156,42212,769
07-10-2021,salem,633,46,69,2,608,98010,46,438,0,98494,96217,1669
07-10-2021,sivagangai,159,8,17,0,150,19813,8,108,0,19929,19576,203
07-10-2021,tenkasi,37,2,4,0,35,27239,2,58,0,27299,26780,484
07-10-2021,thanjavur,844,76,48,1,871,73953,76,22,0,74051,72232,948
07-10-2021,theni,95,7,8,0,94,43423,7,45,0,43475,42862,519
07-10-2021,thirupathur,207,12,28,1,190,28980,12,118,0,29110,28298,622
07-10-2021,thiruvallur,692,55,65,0,682,118132,55,10,0,118197,115688,1827
07-10-2021,thiruvannamalai,309,18,30,0,297,54092,18,398,0,54508,53546,665
07-10-2021,thiruvarur,644,62,35,2,669,40609,62,38,0,40709,39619,421
07-10-2021,thoothukudi,177,13,13,0,177,55677,13,275,0,55965,55383,405
07-10-2021,tirunelveli,228,20,9,0,239,48591,20,427,0,49038,48369,430
07-10-2021,tiruppur,840,75,78,2,835,93491,75,11,0,93577,91780,962
07-10-2021,trichy,599,49,71,0,577,76310,49,65,0,76424,74813,1034
07-10-2021,vellore,214,15,23,0,206,47817,15,1664,0,49496,48167,1123
07-10-2021,villupuram,203,18,18,0,203,45381,18,174,0,45573,45016,354
07-10-2021,virudhunagar,150,10,15,0,145,46028,10,104,0,46142,45450,547
07-10-2021,airport surveillance (international),2,0,0,0,2,0,0,1026,0,1026,1023,1
07-10-2021,airport surveillance (domestic),0,0,0,0,0,0,0,1083,0,1083,1082,1
07-10-2021,railway surveillance,0,0,0,0,0,0,0,428,0,428,428,0
08-10-2021,ariyalur,78,4,8,1,73,16712,4,20,0,16736,16406,257
08-10-2021,chengalpattu,1175,103,102,1,1175,169511,103,5,0,169619,165962,2482
08-10-2021,chennai,1861,169,184,3,1843,551059,169,47,0,551275,540924,8508
08-10-2021,coimbatore,1758,140,193,1,1704,243541,140,51,0,243732,239671,2357
08-10-2021,cuddalore,342,21,34,1,328,63402,21,203,0,63626,62437,861
08-10-2021,dharmapuri,391,27,28,3,387,27696,27,216,0,27939,27284,268
08-10-2021,dindigul,141,9,13,1,136,32806,9,77,0,32892,32117,639
08-10-2021,erode,1044,82,97,0,1029,102416,82,94,0,102592,100889,674
08-10-2021,kallakurichi,199,14,17,0,196,30658,14,404,0,31076,30671,209
08-10-2021,kancheepuram,366,29,21,0,374,74183,29,4,0,74216,72590,1252
08-10-2021,kanyakumari,272,27,16,0,283,61812,27,124,0,61963,60637,1043
08-10-2021,karur,206,12,10,0,208,23667,12,47,0,23726,23163,355
08-10-2021,krishnagiri,322,37,23,1,335,42846,37,238,0,43121,42440,346
08-10-2021,madurai,299,21,27,0,293,74620,21,173,0,74814,73355,1166
08-10-2021,mayiladuthurai,261,18,18,1,260,22981,18,39,0,23038,22467,311
08-10-2021,nagapattinam,322,24,24,0,322,20592,24,53,0,20669,20015,332
08-10-2021,namakkal,574,59,51,0,582,50870,59,112,0,51041,49969,490
08-10-2021,nilgiris,365,31,32,0,364,32946,31,44,0,33021,32452,205
08-10-2021,perambalur,85,3,7,0,81,11982,3,3,0,11988,11667,240
08-10-2021,pudukottai,197,16,14,0,199,29846,16,35,0,29897,29286,412
08-10-2021,ramanathapuram,93,12,4,0,101,20276,12,135,0,20423,19966,356
08-10-2021,ranipet,175,19,11,1,182,43107,19,49,0,43175,42223,770
08-10-2021,salem,609,45,62,0,592,98057,45,438,0,98540,96279,1669
08-10-2021,sivagangai,151,14,15,0,150,19822,14,108,0,19944,19591,203
08-10-2021,tenkasi,35,1,5,0,31,27241,1,58,0,27300,26785,484
08-10-2021,thanjavur,868,73,46,2,893,74026,73,22,0,74121,72278,950
08-10-2021,theni,94,6,6,0,94,43430,6,45,0,43481,42868,519
08-10-2021,thirupathur,190,10,22,0,178,28992,10,118,0,29120,28320,622
08-10-2021,thiruvallur,683,58,63,2,676,118188,58,10,0,118256,115751,1829
08-10-2021,thiruvannamalai,297,16,36,0,277,54110,16,398,0,54524,53582,665
08-10-2021,thiruvarur,671,56,48,2,677,40673,56,38,0,40767,39667,423
08-10-2021,thoothukudi,178,23,19,0,182,55691,23,275,0,55989,55402,405
08-10-2021,tirunelveli,240,17,13,0,244,48612,17,427,0,49056,48382,430
08-10-2021,tiruppur,836,72,84,0,824,93567,72,11,0,93650,91864,962
08-10-2021,trichy,578,52,67,0,563,76360,52,65,0,76477,74880,1034
08-10-2021,vellore,207,14,21,0,200,47833,14,1664,0,49511,48188,1123
08-10-2021,villupuram,203,16,20,0,199,45399,16,174,0,45589,45036,354
08-10-2021,virudhunagar,145,9,12,0,142,46038,9,104,0,46151,45462,547
08-10-2021,airport surveillance (international),2,0,0,0,2,0,0,1026,0,1026,1023,1
08-10-2021,airport surveillance (domestic),0,0,0,0,0,0,0,1083,0,1083,1082,1
08-10-2021,railway surveillance,0,0,0,0,0,0,0,428,0,428,428,0
09-10-2021,ariyalur,73,3,6,0,70,16715,3,20,0,16738,16412,256
09-10-2021,chengalpattu,1178,101,104,0,1175,169617,101,5,0,169723,166066,2482
09-10-2021,chennai,1844,164,169,0,1839,551229,164,47,0,551440,541093,8508
09-10-2021,coimbatore,1706,137,181,3,1659,243683,137,51,0,243871,239852,2360
09-10-2021,cuddalore,327,22,27,2,320,63422,22,203,0,63647,62464,863
09-10-2021,dharmapuri,387,25,31,1,380,27723,25,216,0,27964,27315,269
09-10-2021,dindigul,136,11,10,0,137,32815,11,77,0,32903,32127,639
09-10-2021,erode,1012,91,102,2,999,102481,91,94,0,102666,100991,676
09-10-2021,kallakurichi,196,11,15,0,192,30672,11,404,0,31087,30686,209
09-10-2021,kancheepuram,373,28,24,0,377,74211,28,4,0,74243,72614,1252
09-10-2021,kanyakumari,283,22,20,0,285,61839,22,124,0,61985,60657,1043
09-10-2021,karur,208,14,12,0,210,23679,14,47,0,23740,23175,355
09-10-2021,krishnagiri,335,29,19,1,344,42883,29,238,0,43150,42459,347
09-10-2021,madurai,293,18,25,0,286,74641,18,173,0,74832,73380,1166
09-10-2021,mayiladuthurai,266,13,21,0,258,23005,13,39,0,23057,22488,311
09-10-2021,nagapattinam,317,22,30,0,309,20611,22,53,0,20686,20045,332
09-10-2021,namakkal,585,74,56,0,603,50932,74,112,0,51118,50025,490
09-10-2021,nilgiris,365,46,34,0,377,32978,46,44,0,33068,32486,205
09-10-2021,perambalur,81,2,5,0,78,11985,2,3,0,11990,11672,240
09-10-2021,pudukottai,201,15,9,0,207,29864,15,35,0,29914,29295,412
09-10-2021,ramanathapuram,101,10,3,0,108,20288,10,135,0,20433,19969,356
09-10-2021,ranipet,181,17,14,0,184,43125,17,49,0,43191,42237,770
09-10-2021,salem,597,54,59,0,592,98107,54,438,0,98599,96338,1669
09-10-2021,sivagangai,147,12,17,0,142,19833,12,108,0,19953,19608,203
09-10-2021,tenkasi,31,3,4,0,30,27242,3,58,0,27303,26789,484
09-10-2021,thanjavur,893,74,39,1,927,74099,74,22,0,74195,72317,951
09-10-2021,theni,94,12,4,0,102,43436,12,45,0,43493,42872,519
09-10-2021,thirupathur,177,7,13,0,171,29001,7,118,0,29126,28333,622
09-10-2021,thiruvallur,674,55,67,0,662,118244,55,10,0,118309,115818,1829
09-10-2021,thiruvannamalai,278,17,32,0,263,54127,17,398,0,54542,53614,665
09-10-2021,thiruvarur,677,50,57,2,668,40730,50,38,0,40818,39724,426
09-10-2021,thoothukudi,182,16,22,0,176,55714,16,275,0,56005,55424,405
09-10-2021,tirunelveli,245,13,16,0,242,48630,13,427,0,49070,48398,430
09-10-2021,tiruppur,829,70,89,0,810,93644,70,11,0,93725,91953,962
09-10-2021,trichy,564,51,69,1,545,76413,51,65,0,76529,74949,1035
09-10-2021,vellore,200,15,18,1,196,47847,15,1664,0,49526,48206,1124
09-10-2021,villupuram,199,12,23,0,188,45415,12,174,0,45601,45059,354
09-10-2021,virudhunagar,142,8,11,0,139,46047,8,104,0,46159,45473,547
09-10-2021,airport surveillance (international),2,0,0,0,2,0,0,1026,0,1026,1023,1
09-10-2021,airport surveillance (domestic),0,0,0,0,0,0,0,1083,0,1083,1082,1
09-10-2021,railway surveillance,0,0,0,0,0,0,0,428,0,428,428,0
10-10-2021,ariyalur,69,9,5,0,73,16717,9,20,0,16746,16417,256
10-10-2021,chengalpattu,1174,99,119,2,1152,169717,99,5,0,169821,166185,2484
10-10-2021,chennai,1839,171,164,0,1846,551393,171,47,0,551611,541257,8508
10-10-2021,coimbatore,1659,132,157,0,1634,243820,132,51,0,244003,240009,2360
10-10-2021,cuddalore,321,24,24,0,321,63445,24,203,0,63672,62488,863
10-10-2021,dharmapuri,382,24,29,0,377,27750,24,216,0,27990,27344,269
10-10-2021,dindigul,136,14,8,0,142,32825,14,77,0,32916,32135,639
10-10-2021,erode,992,78,106,0,964,102565,78,94,0,102737,101097,676
10-10-2021,kallakurichi,192,18,21,0,189,30683,18,404,0,31105,30707,209
10-10-2021,kancheepuram,378,34,28,0,384,74240,34,4,0,74278,72642,1252
10-10-2021,kanyakumari,285,21,23,0,283,61861,21,124,0,62006,60680,1043
10-10-2021,karur,209,13,14,0,208,23692,13,47,0,23752,23189,355
10-10-2021,krishnagiri,344,27,13,0,358,42912,27,238,0,43177,42472,347
10-10-2021,madurai,285,16,19,1,281,74658,16,173,0,74847,73399,1167
10-10-2021,mayiladuthurai,262,12,16,0,258,23022,12,39,0,23073,22504,311
10-10-2021,nagapattinam,307,21,33,2,293,20631,21,53,0,20705,20078,334
10-10-2021,namakkal,603,63,64,0,602,51006,63,112,0,51181,50089,490
10-10-2021,nilgiris,377,39,30,0,386,33024,39,44,0,33107,32516,205
10-10-2021,perambalur,79,3,8,1,73,11988,3,3,0,11994,11680,241
10-10-2021,pudukottai,205,14,11,0,208,29877,14,35,0,29926,29306,412
10-10-2021,ramanathapuram,109,9,7,0,111,20299,9,135,0,20443,19976,356
10-10-2021,ranipet,185,13,18,0,180,43143,13,49,0,43205,42255,770
10-10-2021,salem,594,53,62,2,583,98163,53,438,0,98654,96400,1671
10-10-2021,sivagangai,142,11,12,0,141,19845,11,108,0,19964,19620,203
10-10-2021,tenkasi,30,2,2,0,30,27245,2,58,0,27305,26791,484
10-10-2021,thanjavur,922,66,48,2,938,74168,66,22,0,74256,72365,953
10-10-2021,theni,102,8,6,0,104,43448,8,45,0,43501,42878,519
10-10-2021,thirupathur,171,6,10,0,167,29008,6,118,0,29132,28343,622
10-10-2021,thiruvallur,662,54,65,0,651,118299,54,10,0,118363,115883,1829
10-10-2021,thiruvannamalai,263,21,26,0,258,54144,21,398,0,54563,53640,665
10-10-2021,thiruvarur,671,47,68,3,647,40783,47,38,0,40868,39792,429
10-10-2021,thoothukudi,177,14,17,0,174,55731,14,275,0,56020,55441,405
10-10-2021,tirunelveli,241,12,20,0,233,48642,12,427,0,49081,48418,430
10-10-2021,tiruppur,814,91,86,0,819,93718,91,11,0,93820,92039,962
10-10-2021,trichy,548,50,57,0,541,76467,50,65,0,76582,75006,1035
10-10-2021,vellore,193,18,15,2,194,47859,18,1664,0,49541,48221,1126
10-10-2021,villupuram,189,13,16,0,186,45428,13,174,0,45615,45075,354
10-10-2021,virudhunagar,139,9,9,0,139,46055,9,104,0,46168,45482,547
10-10-2021,airport surveillance (international),2,0,0,0,2,0,0,1026,0,1026,1023,1
10-10-2021,airport surveillance (domestic),0,0,0,0,0,0,0,1083,0,1083,1082,1
10-10-2021,railway surveillance,0,0,0,0,0,0,0,428,0,428,428,0
12-10-2021,ariyalur,72,5,5,0,72,16732,5,20,0,16757,16429,256
12-10-2021,chengalpattu,1139,104,102,2,1139,169910,104,5,0,170019,166393,2487
12-10-2021,chennai,1855,164,173,4,1842,551740,164,47,0,551951,541597,8512
12-10-2021,coimbatore,1607,137,148,2,1594,244083,137,51,0,244271,240311,2366
12-10-2021,cuddalore,316,21,26,1,310,63493,21,203,0,63717,62543,864
12-10-2021,dharmapuri,378,22,29,0,371,27802,22,216,0,28040,27400,269
12-10-2021,dindigul,142,9,15,0,136,32852,9,77,0,32938,32162,640
12-10-2021,erode,934,78,82,1,929,102706,78,94,0,102878,101272,677
12-10-2021,kallakurichi,182,16,18,0,180,30718,16,404,0,31138,30749,209
12-10-2021,kancheepuram,386,37,37,0,386,74307,37,4,0,74348,72710,1252
12-10-2021,kanyakumari,281,20,30,0,271,61906,20,124,0,62050,60736,1043
12-10-2021,karur,204,12,20,0,196,23718,12,47,0,23777,23226,355
12-10-2021,krishnagiri,363,19,22,0,360,42963,19,238,0,43220,42513,347
12-10-2021,madurai,277,19,24,1,271,74692,19,173,0,74884,73445,1168
12-10-2021,mayiladuthurai,251,9,18,0,242,23048,9,39,0,23096,22542,312
12-10-2021,nagapattinam,288,22,27,0,283,20679,22,53,0,20754,20136,335
12-10-2021,namakkal,600,53,58,0,595,51124,53,112,0,51289,50204,490
12-10-2021,nilgiris,395,31,31,2,393,33097,31,44,0,33172,32572,207
12-10-2021,perambalur,69,6,9,0,66,11994,6,3,0,12003,11695,242
12-10-2021,pudukottai,212,14,17,0,209,29908,14,35,0,29957,29336,412
12-10-2021,ramanathapuram,109,7,4,0,112,20316,7,135,0,20458,19990,356
12-10-2021,ranipet,177,11,13,0,175,43169,11,49,0,43229,42284,770
12-10-2021,salem,577,55,56,1,575,98274,55,438,0,98767,96519,1673
12-10-2021,sivagangai,134,11,12,1,132,19864,11,108,0,19983,19647,204
12-10-2021,tenkasi,30,1,2,0,29,27248,1,58,0,27307,26794,484
12-10-2021,thanjavur,939,58,66,1,930,74288,58,22,0,74368,72484,954
12-10-2021,theni,102,6,8,0,100,43463,6,45,0,43514,42895,519
12-10-2021,thirupathur,163,6,14,0,155,29022,6,118,0,29146,28368,623
12-10-2021,thiruvallur,648,65,59,0,654,118413,65,10,0,118488,116004,1830
12-10-2021,thiruvannamalai,253,19,25,1,246,54188,19,398,0,54605,53693,666
12-10-2021,thiruvarur,626,41,52,0,615,40874,41,38,0,40953,39908,430
12-10-2021,thoothukudi,176,14,15,0,175,55761,14,275,0,56050,55470,405
12-10-2021,tirunelveli,228,20,21,0,227,48667,20,427,0,49114,48457,430
12-10-2021,tiruppur,816,79,85,0,810,93898,79,11,0,93988,92216,962
12-10-2021,trichy,545,48,49,1,543,76568,48,65,0,76681,75101,1037
12-10-2021,vellore,195,31,16,0,210,47890,31,1664,0,49585,48250,1125
12-10-2021,villupuram,182,12,23,0,171,45456,12,174,0,45642,45117,354
12-10-2021,virudhunagar,139,7,10,0,136,46072,7,104,0,46183,45500,547
12-10-2021,airport surveillance (international),2,0,0,0,2,0,0,1026,0,1026,1023,1
12-10-2021,airport surveillance (domestic),0,0,0,0,0,0,0,1083,0,1083,1082,1
12-10-2021,railway surveillance,0,0,0,0,0,0,0,428,0,428,428,0
14-10-2021,ariyalur,71,7,8,0,70,16743,7,20,0,16770,16444,256
14-10-2021,chengalpattu,1141,95,103,1,1132,170115,95,5,0,170215,166594,2489
14-10-2021,chennai,1835,163,169,4,1825,552074,163,47,0,552284,541942,8517
14-10-2021,coimbatore,1593,143,138,2,1596,244365,143,51,0,244559,240592,2371
14-10-2021,cuddalore,297,20,25,0,292,63529,20,203,0,63752,62596,864
14-10-2021,dharmapuri,364,25,34,0,355,27851,25,216,0,28092,27466,271
14-10-2021,dindigul,130,8,11,1,126,32868,8,77,0,32953,32186,641
14-10-2021,erode,930,79,81,0,928,102864,79,94,0,103037,101431,678
14-10-2021,kallakurichi,173,18,19,0,172,30748,18,404,0,31170,30789,209
14-10-2021,kancheepuram,382,35,38,1,378,74380,35,4,0,74419,72787,1254
14-10-2021,kanyakumari,256,19,29,0,246,61947,19,124,0,62090,60800,1044
14-10-2021,karur,183,12,21,0,174,23741,12,47,0,23800,23271,355
14-10-2021,krishnagiri,347,16,32,0,331,42999,16,238,0,43253,42575,347
14-10-2021,madurai,262,22,24,1,259,74729,22,173,0,74924,73496,1169
14-10-2021,mayiladuthurai,229,9,27,2,209,23068,9,39,0,23116,22593,314
14-10-2021,nagapattinam,269,18,31,0,256,20720,18,53,0,20791,20200,335
14-10-2021,namakkal,599,54,61,1,591,51241,54,112,0,51407,50324,492
14-10-2021,nilgiris,384,30,39,0,375,33156,30,44,0,33230,32648,207
14-10-2021,perambalur,60,4,6,0,58,12002,4,3,0,12009,11709,242
14-10-2021,pudukottai,206,13,20,0,199,29938,13,35,0,29986,29375,412
14-10-2021,ramanathapuram,117,9,7,0,119,20333,9,135,0,20477,20002,356
14-10-2021,ranipet,174,9,16,0,167,43194,9,49,0,43252,42315,770
14-10-2021,salem,575,56,55,2,574,98388,56,438,0,98882,96632,1676
14-10-2021,sivagangai,130,14,9,0,135,19883,14,108,0,20005,19666,204
14-10-2021,tenkasi,29,1,3,0,27,27251,1,58,0,27310,26799,484
14-10-2021,thanjavur,919,63,59,0,923,74400,63,22,0,74485,72607,955
14-10-2021,theni,98,3,5,0,96,43474,3,45,0,43522,42906,520
14-10-2021,thirupathur,156,9,12,0,153,29040,9,118,0,29167,28391,623
14-10-2021,thiruvallur,657,61,65,1,652,118542,61,10,0,118613,116130,1831
14-10-2021,thiruvannamalai,240,19,28,0,231,54227,19,398,0,54644,53747,666
14-10-2021,thiruvarur,596,34,57,0,573,40951,34,38,0,41023,40019,431
14-10-2021,thoothukudi,173,17,18,0,172,55791,17,275,0,56083,55504,407
14-10-2021,tirunelveli,217,21,23,0,215,48699,21,427,0,49147,48502,430
14-10-2021,tiruppur,815,74,72,2,815,94059,74,11,0,94144,92364,965
14-10-2021,trichy,537,43,54,1,525,76662,43,65,0,76770,75207,1038
14-10-2021,vellore,208,19,15,1,211,47933,19,1664,0,49616,48279,1126
14-10-2021,villupuram,164,10,14,0,160,45479,10,174,0,45663,45149,354
14-10-2021,virudhunagar,131,7,10,0,128,46087,7,104,0,46198,45522,548
14-10-2021,airport surveillance (international),3,0,0,0,3,0,0,1027,0,1027,1023,1
14-10-2021,airport surveillance (domestic),0,0,0,0,0,0,0,1083,0,1083,1082,1
14-10-2021,railway surveillance,0,0,0,0,0,0,0,428,0,428,428,0
15-10-2021,ariyalur,71,10,9,0,72,16751,10,20,0,16781,16453,256
15-10-2021,chengalpattu,1127,92,105,2,1112,170205,92,5,0,170302,166699,2491
15-10-2021,chennai,1833,167,168,2,1830,552245,167,47,0,552459,542110,8519
15-10-2021,coimbatore,1597,139,143,6,1587,244509,139,51,0,244699,240735,2377
15-10-2021,cuddalore,292,18,27,0,283,63549,18,203,0,63770,62623,864
15-10-2021,dharmapuri,357,26,38,0,345,27878,26,216,0,28120,27504,271
15-10-2021,dindigul,126,7,13,1,119,32876,7,77,0,32960,32199,642
15-10-2021,erode,915,91,85,0,921,102930,91,94,0,103115,101516,678
15-10-2021,kallakurichi,171,17,21,0,167,30765,17,404,0,31186,30810,209
15-10-2021,kancheepuram,379,34,40,0,373,74416,34,4,0,74454,72827,1254
15-10-2021,kanyakumari,246,17,23,0,240,61966,17,124,0,62107,60823,1044
15-10-2021,karur,174,14,19,0,169,23753,14,47,0,23814,23290,355
15-10-2021,krishnagiri,332,21,30,0,323,43016,21,238,0,43275,42605,347
15-10-2021,madurai,257,21,28,0,250,74749,21,173,0,74943,73524,1169
15-10-2021,mayiladuthurai,213,6,20,0,199,23081,6,39,0,23126,22613,314
15-10-2021,nagapattinam,254,17,25,0,246,20736,17,53,0,20806,20225,335
15-10-2021,namakkal,596,50,52,0,594,51300,50,112,0,51462,50376,492
15-10-2021,nilgiris,376,28,29,0,375,33187,28,44,0,33259,32677,207
15-10-2021,perambalur,58,3,5,0,56,12006,3,3,0,12012,11714,242
15-10-2021,pudukottai,199,14,22,1,190,29951,14,35,0,30000,29397,413
15-10-2021,ramanathapuram,119,8,6,0,121,20342,8,135,0,20485,20008,356
15-10-2021,ranipet,167,10,12,0,165,43203,10,49,0,43262,42327,770
15-10-2021,salem,572,54,58,0,568,98442,54,438,0,98934,96690,1676
15-10-2021,sivagangai,135,13,11,0,137,19897,13,108,0,20018,19677,204
15-10-2021,tenkasi,29,2,2,0,29,27254,2,58,0,27314,26801,484
15-10-2021,thanjavur,921,59,78,0,902,74461,59,22,0,74542,72685,955
15-10-2021,theni,96,2,7,0,91,43477,2,45,0,43524,42913,520
15-10-2021,thirupathur,152,7,16,1,142,29048,7,118,0,29173,28407,624
15-10-2021,thiruvallur,648,59,69,0,638,118599,59,10,0,118668,116199,1831
15-10-2021,thiruvannamalai,232,20,24,0,228,54247,20,398,0,54665,53771,666
15-10-2021,thiruvarur,574,31,48,0,557,40986,31,38,0,41055,40067,431
15-10-2021,thoothukudi,174,15,13,1,175,55810,15,275,0,56100,55517,408
15-10-2021,tirunelveli,210,18,18,0,210,48715,18,427,0,49160,48520,430
15-10-2021,tiruppur,820,71,76,0,815,94138,71,11,0,94220,92440,965
15-10-2021,trichy,525,49,51,2,521,76705,49,65,0,76819,75258,1040
15-10-2021,vellore,212,18,18,0,212,47953,18,1664,0,49635,48297,1126
15-10-2021,villupuram,160,12,15,0,157,45489,12,174,0,45675,45164,354
15-10-2021,virudhunagar,129,3,17,0,115,46095,3,104,0,46202,45539,548
15-10-2021,airport surveillance (international),3,0,1,0,2,0,0,1027,0,1027,1024,1
15-10-2021,airport surveillance (domestic),0,2,0,0,2,0,0,1083,2,1085,1082,1
15-10-2021,railway surveillance,0,0,0,0,0,0,0,428,0,428,428,0
16-10-2021,ariyalur,73,8,6,0,75,16762,8,20,0,16790,16459,256
16-10-2021,chengalpattu,1111,90,99,0,1102,170296,90,5,0,170391,166798,2491
16-10-2021,chennai,1827,160,173,4,1810,552410,160,47,0,552617,542283,8524
16-10-2021,coimbatore,1588,136,148,1,1575,244649,136,51,0,244836,240883,2378
16-10-2021,cuddalore,284,22,22,0,284,63568,22,203,0,63793,62645,864
16-10-2021,dharmapuri,345,24,34,0,335,27904,24,216,0,28144,27538,271
16-10-2021,dindigul,121,10,11,0,120,32885,10,77,0,32972,32210,642
16-10-2021,erode,905,97,94,0,908,103005,97,94,0,103196,101610,678
16-10-2021,kallakurichi,167,16,13,0,170,30782,16,404,0,31202,30823,209
16-10-2021,kancheepuram,374,31,38,1,366,74450,31,4,0,74485,72865,1254
16-10-2021,kanyakumari,241,16,19,0,238,61984,16,124,0,62124,60842,1044
16-10-2021,karur,164,12,23,0,153,23762,12,47,0,23821,23313,355
16-10-2021,krishnagiri,324,19,28,0,315,43038,19,238,0,43295,42633,347
16-10-2021,madurai,249,19,25,0,243,74769,19,173,0,74961,73549,1169
16-10-2021,mayiladuthurai,200,15,18,1,196,23088,15,39,0,23142,22631,315
16-10-2021,nagapattinam,247,21,26,0,242,20754,21,53,0,20828,20251,335
16-10-2021,namakkal,592,46,43,0,595,51348,46,112,0,51506,50419,492
16-10-2021,nilgiris,375,24,32,0,367,33215,24,44,0,33283,32709,207
16-10-2021,perambalur,56,2,8,0,50,12009,2,3,0,12014,11722,242
16-10-2021,pudukottai,190,11,18,0,183,29965,11,35,0,30011,29415,413
16-10-2021,ramanathapuram,121,9,7,0,123,20350,9,135,0,20494,20015,356
16-10-2021,ranipet,170,11,17,0,164,43218,11,49,0,43278,42344,770
16-10-2021,salem,572,55,62,2,563,98500,55,438,0,98993,96752,1678
16-10-2021,sivagangai,137,10,10,0,137,19910,10,108,0,20028,19687,204
16-10-2021,tenkasi,28,3,4,0,27,27255,3,58,0,27316,26805,484
16-10-2021,thanjavur,903,71,98,1,875,74521,71,22,0,74614,72783,956
16-10-2021,theni,91,3,5,0,89,43479,3,45,0,43527,42918,520
16-10-2021,thirupathur,143,6,20,0,129,29056,6,118,0,29180,28427,624
16-10-2021,thiruvallur,641,58,63,0,636,118661,58,10,0,118729,116262,1831
16-10-2021,thiruvannamalai,228,21,27,0,222,54267,21,398,0,54686,53798,666
16-10-2021,thiruvarur,555,29,46,1,537,41015,29,38,0,41082,40113,432
16-10-2021,thoothukudi,175,13,15,0,173,55825,13,275,0,56113,55532,408
16-10-2021,tirunelveli,210,16,21,0,205,48733,16,427,0,49176,48541,430
16-10-2021,tiruppur,828,70,74,2,822,94222,70,11,0,94303,92514,967
16-10-2021,trichy,523,47,48,2,520,76756,47,65,0,76868,75306,1042
16-10-2021,vellore,204,17,16,0,205,47963,17,1664,0,49644,48313,1126
16-10-2021,villupuram,157,13,9,0,161,45501,13,174,0,45688,45173,354
16-10-2021,virudhunagar,115,2,14,0,103,46098,2,104,0,46204,45553,548
16-10-2021,airport surveillance (international),2,0,0,0,2,0,0,1027,0,1027,1024,1
16-10-2021,airport surveillance (domestic),2,0,0,0,2,0,0,1085,0,1085,1082,1
16-10-2021,railway surveillance,0,0,0,0,0,0,0,428,0,428,428,0
17-10-2021,ariyalur,75,7,7,0,75,16770,7,20,0,16797,16466,256
17-10-2021,chengalpattu,1102,88,102,0,1088,170386,88,5,0,170479,166900,2491
17-10-2021,chennai,1810,156,170,2,1794,552570,156,47,0,552773,542453,8526
17-10-2021,coimbatore,1575,132,151,4,1552,244785,132,51,0,244968,241034,2382
17-10-2021,cuddalore,284,20,24,0,280,63590,20,203,0,63813,62669,864
17-10-2021,dharmapuri,335,23,35,0,323,27928,23,216,0,28167,27573,271
17-10-2021,dindigul,120,8,12,0,116,32895,8,77,0,32980,32222,642
17-10-2021,erode,908,90,91,1,906,103102,90,94,0,103286,101701,679
17-10-2021,kallakurichi,170,15,11,0,174,30798,15,404,0,31217,30834,209
17-10-2021,kancheepuram,366,30,34,0,362,74481,30,4,0,74515,72899,1254
17-10-2021,kanyakumari,238,14,16,0,236,62000,14,124,0,62138,60858,1044
17-10-2021,karur,153,11,21,0,143,23774,11,47,0,23832,23334,355
17-10-2021,krishnagiri,315,23,26,0,312,43057,23,238,0,43318,42659,347
17-10-2021,madurai,243,18,23,0,238,74788,18,173,0,74979,73572,1169
17-10-2021,mayiladuthurai,196,13,17,0,192,23103,13,39,0,23155,22648,315
17-10-2021,nagapattinam,242,22,25,0,239,20775,22,53,0,20850,20276,335
17-10-2021,namakkal,595,51,41,0,605,51394,51,112,0,51557,50460,492
17-10-2021,nilgiris,367,21,30,0,358,33239,21,44,0,33304,32739,207
17-10-2021,perambalur,50,4,5,0,49,12011,4,3,0,12018,11727,242
17-10-2021,pudukottai,183,10,19,0,174,29976,10,35,0,30021,29434,413
17-10-2021,ramanathapuram,123,8,8,0,123,20359,8,135,0,20502,20023,356
17-10-2021,ranipet,164,12,15,0,161,43229,12,49,0,43290,42359,770
17-10-2021,salem,563,56,59,0,560,98555,56,438,0,99049,96811,1678
17-10-2021,sivagangai,137,11,9,0,139,19920,11,108,0,20039,19696,204
17-10-2021,tenkasi,27,2,3,0,26,27258,2,58,0,27318,26808,484
17-10-2021,thanjavur,875,68,103,0,840,74592,68,22,0,74682,72886,956
17-10-2021,theni,89,4,4,0,89,43482,4,45,0,43531,42922,520
17-10-2021,thirupathur,129,13,22,0,120,29062,13,118,0,29193,28449,624
17-10-2021,thiruvallur,636,55,65,0,626,118719,55,10,0,118784,116327,1831
17-10-2021,thiruvannamalai,222,19,28,1,212,54288,19,398,0,54705,53826,667
17-10-2021,thiruvarur,537,28,43,2,520,41044,28,38,0,41110,40156,434
17-10-2021,thoothukudi,173,12,14,0,171,55838,12,275,0,56125,55546,408
17-10-2021,tirunelveli,205,20,20,0,205,48749,20,427,0,49196,48561,430
17-10-2021,tiruppur,822,73,76,1,818,94292,73,11,0,94376,92590,968
17-10-2021,trichy,520,45,49,2,514,76803,45,65,0,76913,75355,1044
17-10-2021,vellore,205,16,12,2,207,47980,16,1664,0,49660,48325,1128
17-10-2021,villupuram,161,11,8,0,164,45514,11,174,0,45699,45181,354
17-10-2021,virudhunagar,103,9,13,0,99,46100,9,104,0,46213,45566,548
17-10-2021,airport surveillance (international),2,0,0,0,2,0,0,1027,0,1027,1024,1
17-10-2021,airport surveillance (domestic),2,0,0,0,2,0,0,1085,0,1085,1082,1
17-10-2021,railway surveillance,0,0,0,0,0,0,0,428,0,428,428,0
18-10-2021,ariyalur,77,6,6,0,77,16779,6,20,0,16805,16472,256
18-10-2021,chengalpattu,1088,87,97,1,1077,170474,87,5,0,170566,166997,2492
18-10-2021,chennai,1791,150,166,1,1774,552723,150,47,0,552920,542619,8527
18-10-2021,coimbatore,1553,130,154,1,1528,244918,130,51,0,245099,241188,2383
18-10-2021,cuddalore,280,19,27,0,272,63610,19,203,0,63832,62696,864
18-10-2021,dharmapuri,325,26,32,0,319,27953,26,216,0,28195,27605,271
18-10-2021,dindigul,114,10,9,0,115,32901,10,77,0,32988,32231,642
18-10-2021,erode,896,88,94,0,890,103182,88,94,0,103364,101795,679
18-10-2021,kallakurichi,174,14,13,0,175,30813,14,404,0,31231,30847,209
18-10-2021,kancheepuram,360,32,38,0,354,74509,32,4,0,74545,72937,1254
18-10-2021,kanyakumari,230,13,20,1,222,62008,13,124,0,62145,60878,1045
18-10-2021,karur,145,13,18,0,140,23787,13,47,0,23847,23352,355
18-10-2021,krishnagiri,309,21,30,0,300,43077,21,238,0,43336,42689,347
18-10-2021,madurai,239,19,25,0,233,74807,19,173,0,74999,73597,1169
18-10-2021,mayiladuthurai,196,12,21,0,187,23120,12,39,0,23171,22669,315
18-10-2021,nagapattinam,239,16,28,0,227,20797,16,53,0,20866,20304,335
18-10-2021,namakkal,606,53,44,0,615,51446,53,112,0,51611,50504,492
18-10-2021,nilgiris,359,20,27,0,352,33261,20,44,0,33325,32766,207
18-10-2021,perambalur,50,3,7,0,46,12016,3,3,0,12022,11734,242
18-10-2021,pudukottai,179,9,16,0,172,29991,9,35,0,30035,29450,413
18-10-2021,ramanathapuram,123,9,10,0,122,20367,9,135,0,20511,20033,356
18-10-2021,ranipet,162,13,19,1,155,43242,13,49,0,43304,42378,771
18-10-2021,salem,561,55,62,0,554,98612,55,438,0,99105,96873,1678
18-10-2021,sivagangai,138,12,12,0,138,19930,12,108,0,20050,19708,204
18-10-2021,tenkasi,24,1,1,0,24,27258,1,58,0,27317,26809,484
18-10-2021,thanjavur,819,61,92,2,786,74639,61,22,0,74722,72978,958
18-10-2021,theni,89,3,8,0,84,43486,3,45,0,43534,42930,520
18-10-2021,thirupathur,120,12,24,1,107,29075,12,118,0,29205,28473,625
18-10-2021,thiruvallur,631,52,60,1,622,118779,52,10,0,118841,116387,1832
18-10-2021,thiruvannamalai,213,22,23,0,212,54308,22,398,0,54728,53849,667
18-10-2021,thiruvarur,528,27,39,0,516,41080,27,38,0,41145,40195,434
18-10-2021,thoothukudi,172,10,15,0,167,55851,10,275,0,56136,55561,408
18-10-2021,tirunelveli,211,17,22,0,206,48775,17,427,0,49219,48583,430
18-10-2021,tiruppur,825,72,74,0,823,94372,72,11,0,94455,92664,968
18-10-2021,trichy,514,47,52,3,506,76848,47,65,0,76960,75407,1047
18-10-2021,vellore,205,18,13,1,209,47994,18,1664,0,49676,48338,1129
18-10-2021,villupuram,166,10,11,0,165,45527,10,174,0,45711,45192,354
18-10-2021,virudhunagar,99,10,14,0,95,46109,10,104,0,46223,45580,548
18-10-2021,airport surveillance (international),2,0,0,0,2,0,0,1027,0,1027,1024,1
18-10-2021,airport surveillance (domestic),2,0,0,0,2,0,0,1085,0,1085,1082,1
18-10-2021,railway surveillance,0,0,0,0,0,0,0,428,0,428,428,0
19-10-2021,ariyalur,76,5,7,0,74,16784,5,20,0,16809,16479,256
19-10-2021,chengalpattu,1077,98,95,0,1080,170561,98,5,0,170664,167092,2492
19-10-2021,chennai,1777,156,159,3,1771,552876,156,47,0,553079,542778,8530
19-10-2021,coimbatore,1528,127,148,1,1506,245048,127,51,0,245226,241336,2384
19-10-2021,cuddalore,272,23,25,0,270,63629,23,203,0,63855,62721,864
19-10-2021,dharmapuri,319,24,30,0,313,27979,24,216,0,28219,27635,271
19-10-2021,dindigul,115,13,11,0,117,32911,13,77,0,33001,32242,642
19-10-2021,erode,884,82,88,0,878,103264,82,94,0,103440,101883,679
19-10-2021,kallakurichi,175,15,15,0,175,30827,15,404,0,31246,30862,209
19-10-2021,kancheepuram,355,34,36,0,353,74542,34,4,0,74580,72973,1254
19-10-2021,kanyakumari,222,12,18,0,216,62021,12,124,0,62157,60896,1045
19-10-2021,karur,138,17,14,0,141,23798,17,47,0,23862,23366,355
19-10-2021,krishnagiri,300,16,33,0,283,43098,16,238,0,43352,42722,347
19-10-2021,madurai,231,18,26,0,223,74824,18,173,0,75015,73623,1169
19-10-2021,mayiladuthurai,187,10,23,0,174,23132,10,39,0,23181,22692,315
19-10-2021,nagapattinam,227,15,29,0,213,20813,15,53,0,20881,20333,335
19-10-2021,namakkal,619,51,49,1,620,51503,51,112,0,51666,50553,493
19-10-2021,nilgiris,352,18,28,1,341,33281,18,44,0,33343,32794,208
19-10-2021,perambalur,46,6,5,1,46,12019,6,3,0,12028,11739,243
19-10-2021,pudukottai,169,12,17,0,164,29997,12,35,0,30044,29467,413
19-10-2021,ramanathapuram,122,8,12,0,118,20376,8,135,0,20519,20045,356
19-10-2021,ranipet,157,12,21,0,148,43257,12,49,0,43318,42399,771
19-10-2021,salem,556,58,64,1,549,98669,58,438,0,99165,96937,1679
19-10-2021,sivagangai,138,10,13,1,134,19942,10,108,0,20060,19721,205
19-10-2021,tenkasi,24,4,3,0,25,27259,4,58,0,27321,26812,484
19-10-2021,thanjavur,787,59,87,0,759,74701,59,22,0,74782,73065,958
19-10-2021,theni,84,6,6,0,84,43489,6,45,0,43540,42936,520
19-10-2021,thirupathur,110,8,20,0,98,29090,8,118,0,29216,28493,625
19-10-2021,thiruvallur,621,53,62,0,612,118830,53,10,0,118893,116449,1832
19-10-2021,thiruvannamalai,213,21,22,0,212,54331,21,398,0,54750,53871,667
19-10-2021,thiruvarur,516,22,41,1,496,41107,22,38,0,41167,40236,435
19-10-2021,thoothukudi,168,9,16,0,161,55862,9,275,0,56146,55577,408
19-10-2021,tirunelveli,205,14,19,1,199,48791,14,427,0,49232,48602,431
19-10-2021,tiruppur,826,71,72,2,823,94447,71,11,0,94529,92736,970
19-10-2021,trichy,506,45,54,2,495,76895,45,65,0,77005,75461,1049
19-10-2021,vellore,204,15,18,0,201,48007,15,1664,0,49686,48356,1129
19-10-2021,villupuram,165,9,9,1,164,45537,9,174,0,45720,45201,355
19-10-2021,virudhunagar,95,3,12,0,86,46119,3,104,0,46226,45592,548
19-10-2021,airport surveillance (international),2,0,0,0,2,0,0,1027,0,1027,1024,1
19-10-2021,airport surveillance (domestic),2,0,0,0,2,0,0,1085,0,1085,1082,1
19-10-2021,railway surveillance,0,0,0,0,0,0,0,428,0,428,428,0
20-10-2021,ariyalur,74,4,4,0,74,16789,4,20,0,16813,16483,256
20-10-2021,chengalpattu,1064,93,99,2,1056,170643,93,5,0,170741,167191,2494
20-10-2021,chennai,1765,148,161,1,1751,553026,148,47,0,553221,542939,8531
20-10-2021,coimbatore,1508,141,143,6,1500,245177,141,51,0,245369,241479,2390
20-10-2021,cuddalore,270,22,29,0,263,63652,22,203,0,63877,62750,864
20-10-2021,dharmapuri,313,21,31,1,302,28003,21,216,0,28240,27666,272
20-10-2021,dindigul,117,8,13,0,112,32924,8,77,0,33009,32255,642
20-10-2021,erode,876,91,91,0,876,103344,91,94,0,103529,101974,679
20-10-2021,kallakurichi,175,12,18,0,169,30842,12,404,0,31258,30880,209
20-10-2021,kancheepuram,369,33,35,1,366,74592,33,4,0,74629,73008,1255
20-10-2021,kanyakumari,213,13,21,1,204,62030,13,124,0,62167,60917,1046
20-10-2021,karur,141,19,17,0,143,23815,19,47,0,23881,23383,355
20-10-2021,krishnagiri,283,18,28,0,273,43114,18,238,0,43370,42750,347
20-10-2021,madurai,223,26,24,0,225,74842,26,173,0,75041,73647,1169
20-10-2021,mayiladuthurai,176,9,27,0,158,23144,9,39,0,23192,22719,315
20-10-2021,nagapattinam,213,16,16,1,212,20828,16,53,0,20897,20349,336
20-10-2021,namakkal,621,48,52,0,617,51555,48,112,0,51715,50605,493
20-10-2021,nilgiris,341,19,30,0,330,33299,19,44,0,33362,32824,208
20-10-2021,perambalur,47,2,7,0,42,12026,2,3,0,12031,11746,243
20-10-2021,pudukottai,165,11,22,1,153,30010,11,35,0,30056,29489,414
20-10-2021,ramanathapuram,118,9,15,0,112,20384,9,135,0,20528,20060,356
20-10-2021,ranipet,148,11,23,0,136,43269,11,49,0,43329,42422,771
20-10-2021,salem,550,61,53,1,557,98728,61,438,0,99227,96990,1680
20-10-2021,sivagangai,134,11,15,0,130,19952,11,108,0,20071,19736,205
20-10-2021,tenkasi,25,3,1,0,27,27263,3,58,0,27324,26813,484
20-10-2021,thanjavur,752,51,94,1,708,74753,51,22,0,74826,73159,959
20-10-2021,theni,84,3,11,0,76,43495,3,45,0,43543,42947,520
20-10-2021,thirupathur,98,7,14,0,91,29098,7,118,0,29223,28507,625
20-10-2021,thiruvallur,615,49,57,1,606,118886,49,10,0,118945,116506,1833
20-10-2021,thiruvannamalai,212,20,16,0,216,54352,20,398,0,54770,53887,667
20-10-2021,thiruvarur,498,23,44,0,477,41131,23,38,0,41192,40280,435
20-10-2021,thoothukudi,163,13,19,0,157,55873,13,275,0,56161,55596,408
20-10-2021,tirunelveli,200,10,20,0,190,48806,10,427,0,49243,48622,431
20-10-2021,tiruppur,823,67,74,1,815,94518,67,11,0,94596,92810,971
20-10-2021,trichy,496,44,56,2,482,76941,44,65,0,77050,75517,1051
20-10-2021,vellore,201,16,12,0,205,48022,16,1664,0,49702,48368,1129
20-10-2021,villupuram,165,11,18,0,158,45547,11,174,0,45732,45219,355
20-10-2021,virudhunagar,86,7,8,0,85,46122,7,104,0,46233,45600,548
20-10-2021,airport surveillance (international),2,0,0,0,2,0,0,1027,0,1027,1024,1
20-10-2021,airport surveillance (domestic),2,0,0,0,2,0,0,1085,0,1085,1082,1
20-10-2021,railway surveillance,0,0,0,0,0,0,0,428,0,428,428,0
21-10-2021,ariyalur,73,2,6,1,68,16792,2,20,0,16814,16489,257
21-10-2021,chengalpattu,1074,98,102,0,1070,170754,98,5,0,170857,167293,2494
21-10-2021,chennai,1749,152,165,1,1735,553172,152,47,0,553371,543104,8532
21-10-2021,coimbatore,1501,137,148,2,1488,245319,137,51,0,245507,241627,2392
21-10-2021,cuddalore,263,21,33,3,248,63674,21,203,0,63898,62783,867
21-10-2021,dharmapuri,302,20,34,0,288,28024,20,216,0,28260,27700,272
21-10-2021,dindigul,111,6,15,2,100,32931,6,77,0,33014,32270,644
21-10-2021,erode,875,89,84,2,878,103434,89,94,0,103617,102058,681
21-10-2021,kallakurichi,169,11,13,0,167,30854,11,404,0,31269,30893,209
21-10-2021,kancheepuram,349,34,28,1,354,74608,34,4,0,74646,73036,1256
21-10-2021,kanyakumari,201,19,24,0,196,62040,19,124,0,62183,60941,1046
21-10-2021,karur,144,15,11,0,148,23835,15,47,0,23897,23394,355
21-10-2021,krishnagiri,273,19,35,0,257,43132,19,238,0,43389,42785,347
21-10-2021,madurai,221,24,18,0,227,74864,24,173,0,75061,73665,1169
21-10-2021,mayiladuthurai,160,8,16,0,152,23155,8,39,0,23202,22735,315
21-10-2021,nagapattinam,215,15,21,0,209,20847,15,53,0,20915,20370,336
21-10-2021,namakkal,614,45,54,1,604,51600,45,112,0,51757,50659,494
21-10-2021,nilgiris,330,20,26,0,324,33318,20,44,0,33382,32850,208
21-10-2021,perambalur,42,4,5,0,41,12028,4,3,0,12035,11751,243
21-10-2021,pudukottai,149,10,20,0,139,30017,10,35,0,30062,29509,414
21-10-2021,ramanathapuram,112,5,17,1,99,20393,5,135,0,20533,20077,357
21-10-2021,ranipet,139,10,24,0,125,43283,10,49,0,43342,42446,771
21-10-2021,salem,562,59,41,0,580,98794,59,438,0,99291,97031,1680
21-10-2021,sivagangai,130,16,12,0,134,19963,16,108,0,20087,19748,205
21-10-2021,tenkasi,28,4,3,0,29,27267,4,58,0,27329,26816,484
21-10-2021,thanjavur,711,55,87,2,677,74807,55,22,0,74884,73246,961
21-10-2021,theni,76,5,14,0,67,43498,5,45,0,43548,42961,520
21-10-2021,thirupathur,92,6,9,0,89,29106,6,118,0,29230,28516,625
21-10-2021,thiruvallur,607,46,61,1,591,118936,46,10,0,118992,116567,1834
21-10-2021,thiruvannamalai,217,18,19,0,216,54373,18,398,0,54789,53906,667
21-10-2021,thiruvarur,472,22,48,0,446,41149,22,38,0,41209,40328,435
21-10-2021,thoothukudi,158,14,25,0,147,55887,14,275,0,56176,55621,408
21-10-2021,tirunelveli,191,9,22,0,178,48817,9,427,0,49253,48644,431
21-10-2021,tiruppur,815,73,79,1,808,94585,73,11,0,94669,92889,972
21-10-2021,trichy,486,43,52,2,475,76989,43,65,0,77097,75569,1053
21-10-2021,vellore,199,14,8,0,205,48032,14,1664,0,49710,48376,1129
21-10-2021,villupuram,159,12,23,0,148,45559,12,174,0,45745,45242,355
21-10-2021,virudhunagar,85,4,10,0,79,46129,4,104,0,46237,45610,548
21-10-2021,airport surveillance (international),2,0,0,0,2,0,0,1027,0,1027,1024,1
21-10-2021,airport surveillance (domestic),2,0,0,0,2,0,0,1085,0,1085,1082,1
21-10-2021,railway surveillance,0,0,0,0,0,0,0,428,0,428,428,0
22-10-2021,ariyalur,68,1,5,0,64,16794,1,20,0,16815,16494,257
22-10-2021,chengalpattu,1070,93,107,0,1056,170852,93,5,0,170950,167400,2494
22-10-2021,chennai,1726,147,168,1,1704,553315,147,47,0,553509,543272,8533
22-10-2021,coimbatore,1488,140,152,5,1471,245456,140,51,0,245647,241779,2397
22-10-2021,cuddalore,247,18,30,0,235,63694,18,203,0,63915,62813,867
22-10-2021,dharmapuri,289,19,37,0,271,28045,19,216,0,28280,27737,272
22-10-2021,dindigul,100,5,9,0,96,32937,5,77,0,33019,32279,644
22-10-2021,erode,874,83,76,0,881,103519,83,94,0,103696,102134,681
22-10-2021,kallakurichi,167,14,15,0,166,30865,14,404,0,31283,30908,209
22-10-2021,kancheepuram,355,31,32,0,354,74643,31,4,0,74678,73068,1256
22-10-2021,kanyakumari,196,20,26,2,188,62059,20,124,0,62203,60967,1048
22-10-2021,karur,148,21,12,0,157,23850,21,47,0,23918,23406,355
22-10-2021,krishnagiri,256,16,34,0,238,43150,16,238,0,43404,42819,347
22-10-2021,madurai,227,19,20,0,226,74888,19,173,0,75080,73685,1169
22-10-2021,mayiladuthurai,153,9,18,0,144,23164,9,39,0,23212,22753,315
22-10-2021,nagapattinam,210,16,23,0,203,20863,16,53,0,20932,20393,336
22-10-2021,namakkal,605,65,58,1,611,51646,65,112,0,51823,50717,495
22-10-2021,nilgiris,327,19,31,0,315,33341,19,44,0,33404,32881,208
22-10-2021,perambalur,41,3,4,0,40,12032,3,3,0,12038,11755,243
22-10-2021,pudukottai,139,15,14,0,140,30027,15,35,0,30077,29523,414
22-10-2021,ramanathapuram,99,2,11,0,90,20398,2,135,0,20535,20088,357
22-10-2021,ranipet,127,9,17,0,119,43295,9,49,0,43353,42463,771
22-10-2021,salem,583,57,46,1,593,98856,57,438,0,99351,97077,1681
22-10-2021,sivagangai,134,13,11,0,136,19979,13,108,0,20100,19759,205
22-10-2021,tenkasi,26,3,1,0,28,27268,3,58,0,27329,26817,484
22-10-2021,thanjavur,677,51,72,2,654,74862,51,22,0,74935,73318,963
22-10-2021,theni,67,3,13,0,57,43503,3,45,0,43551,42974,520
22-10-2021,thirupathur,91,5,6,0,90,29114,5,118,0,29237,28522,625
22-10-2021,thiruvallur,596,42,67,3,568,118987,42,10,0,119039,116634,1837
22-10-2021,thiruvannamalai,218,17,16,0,219,54393,17,398,0,54808,53922,667
22-10-2021,thiruvarur,446,20,59,1,406,41171,20,38,0,41229,40387,436
22-10-2021,thoothukudi,147,16,15,0,148,55901,16,275,0,56192,55636,408
22-10-2021,tirunelveli,179,13,17,0,175,48827,13,427,0,49267,48661,431
22-10-2021,tiruppur,809,67,81,2,793,94659,67,11,0,94737,92970,974
22-10-2021,trichy,474,46,48,1,471,77031,46,65,0,77142,75617,1054
22-10-2021,vellore,200,16,10,0,206,48041,16,1664,0,49721,48386,1129
22-10-2021,villupuram,148,11,19,0,140,45571,11,174,0,45756,45261,355
22-10-2021,virudhunagar,79,7,12,0,74,46133,7,104,0,46244,45622,548
22-10-2021,airport surveillance (international),2,0,0,0,2,0,0,1027,0,1027,1024,1
22-10-2021,airport surveillance (domestic),2,0,0,0,2,0,0,1085,0,1085,1082,1
22-10-2021,railway surveillance,0,0,0,0,0,0,0,428,0,428,428,0
23-10-2021,ariyalur,63,4,6,3,58,16794,4,20,0,16818,16500,260
23-10-2021,chengalpattu,1060,97,109,2,1046,170949,97,5,0,171051,167509,2496
23-10-2021,chennai,1705,141,171,1,1674,553463,141,47,0,553651,543443,8534
23-10-2021,coimbatore,1474,132,154,3,1449,245599,132,51,0,245782,241933,2400
23-10-2021,cuddalore,235,20,27,0,228,63712,20,203,0,63935,62840,867
23-10-2021,dharmapuri,271,18,31,1,257,28064,18,216,0,28298,27768,273
23-10-2021,dindigul,95,12,8,0,99,32941,12,77,0,33030,32287,644
23-10-2021,erode,875,72,67,0,880,103596,72,94,0,103762,102201,681
23-10-2021,kallakurichi,165,9,16,1,157,30878,9,404,0,31291,30924,210
23-10-2021,kancheepuram,354,33,28,0,359,74674,33,4,0,74711,73096,1256
23-10-2021,kanyakumari,188,19,23,0,184,62079,19,124,0,62222,60990,1048
23-10-2021,karur,156,17,15,0,158,23870,17,47,0,23934,23421,355
23-10-2021,krishnagiri,238,15,30,0,223,43166,15,238,0,43419,42849,347
23-10-2021,madurai,230,17,24,0,223,74911,17,173,0,75101,73709,1169
23-10-2021,mayiladuthurai,146,13,19,1,139,23175,13,39,0,23227,22772,316
23-10-2021,nagapattinam,204,20,26,0,198,20880,20,53,0,20953,20419,336
23-10-2021,namakkal,610,55,64,1,600,51710,55,112,0,51877,50781,496
23-10-2021,nilgiris,315,18,29,0,304,33360,18,44,0,33422,32910,208
23-10-2021,perambalur,40,1,5,0,36,12035,1,3,0,12039,11760,243
23-10-2021,pudukottai,141,16,17,0,140,30043,16,35,0,30094,29540,414
23-10-2021,ramanathapuram,91,1,9,0,83,20401,1,135,0,20537,20097,357
23-10-2021,ranipet,120,7,13,1,113,43305,7,49,0,43361,42476,772
23-10-2021,salem,595,54,49,0,600,98915,54,438,0,99407,97126,1681
23-10-2021,sivagangai,130,11,10,1,130,19986,11,108,0,20105,19769,206
23-10-2021,tenkasi,27,2,1,0,28,27270,2,58,0,27330,26818,484
23-10-2021,thanjavur,653,54,65,1,641,74912,54,22,0,74988,73383,964
23-10-2021,theni,56,4,12,0,48,43505,4,45,0,43554,42986,520
23-10-2021,thirupathur,90,3,7,0,86,29119,3,118,0,29240,28529,625
23-10-2021,thiruvallur,565,40,56,0,549,119026,40,10,0,119076,116690,1837
23-10-2021,thiruvannamalai,221,19,18,0,222,54412,19,398,0,54829,53940,667
23-10-2021,thiruvarur,406,31,62,1,374,41191,31,38,0,41260,40449,437
23-10-2021,thoothukudi,148,15,14,0,149,55917,15,275,0,56207,55650,408
23-10-2021,tirunelveli,173,10,11,0,172,48838,10,427,0,49275,48672,431
23-10-2021,tiruppur,798,81,87,0,792,94731,81,11,0,94823,93057,974
23-10-2021,trichy,471,45,42,0,474,77077,45,65,0,77187,75659,1054
23-10-2021,vellore,202,18,16,0,204,48053,18,1664,0,49735,48402,1129
23-10-2021,villupuram,141,10,20,0,131,45583,10,174,0,45767,45281,355
23-10-2021,virudhunagar,75,6,13,0,68,46141,6,104,0,46251,45635,548
23-10-2021,airport surveillance (international),2,0,0,0,2,0,0,1027,0,1027,1024,1
23-10-2021,airport surveillance (domestic),2,0,0,0,2,0,0,1085,0,1085,1082,1
23-10-2021,railway surveillance,0,0,0,0,0,0,0,428,0,428,428,0
24-10-2021,ariyalur,57,2,4,0,55,16797,2,20,0,16819,16504,260
24-10-2021,chengalpattu,1049,96,112,5,1028,171049,96,5,0,171150,167621,2501
24-10-2021,chennai,1669,146,165,0,1650,553599,146,47,0,553792,543608,8534
24-10-2021,coimbatore,1450,128,149,1,1428,245732,128,51,0,245911,242082,2401
24-10-2021,cuddalore,228,21,25,0,224,63732,21,203,0,63956,62865,867
24-10-2021,dharmapuri,258,16,28,0,246,28083,16,216,0,28315,27796,273
24-10-2021,dindigul,100,10,10,0,100,32954,10,77,0,33041,32297,644
24-10-2021,erode,874,70,62,1,881,103662,70,94,0,103826,102263,682
24-10-2021,kallakurichi,157,7,14,0,150,30887,7,404,0,31298,30938,210
24-10-2021,kancheepuram,359,34,31,0,362,74707,34,4,0,74745,73127,1256
24-10-2021,kanyakumari,184,20,20,0,184,62098,20,124,0,62242,61010,1048
24-10-2021,karur,158,21,12,0,167,23887,21,47,0,23955,23433,355
24-10-2021,krishnagiri,221,19,27,0,213,43179,19,238,0,43436,42876,347
24-10-2021,madurai,223,15,22,0,216,74928,15,173,0,75116,73731,1169
24-10-2021,mayiladuthurai,141,10,26,0,125,23190,10,39,0,23239,22798,316
24-10-2021,nagapattinam,200,22,21,0,201,20902,22,53,0,20977,20440,336
24-10-2021,namakkal,603,50,75,0,578,51768,50,112,0,51930,50856,496
24-10-2021,nilgiris,304,20,34,1,289,33378,20,44,0,33442,32944,209
24-10-2021,perambalur,36,2,3,0,35,12036,2,3,0,12041,11763,243
24-10-2021,pudukottai,142,12,19,0,135,30061,12,35,0,30108,29559,414
24-10-2021,ramanathapuram,83,2,6,0,79,20402,2,135,0,20539,20103,357
24-10-2021,ranipet,113,6,8,1,110,43312,6,49,0,43367,42484,773
24-10-2021,salem,601,58,51,1,607,98970,58,438,0,99466,97177,1682
24-10-2021,sivagangai,129,9,7,0,131,19996,9,108,0,20113,19776,206
24-10-2021,tenkasi,27,3,2,0,28,27271,3,58,0,27332,26820,484
24-10-2021,thanjavur,638,57,63,2,630,74963,57,22,0,75042,73446,966
24-10-2021,theni,47,3,9,0,41,43508,3,45,0,43556,42995,520
24-10-2021,thirupathur,90,7,5,0,92,29126,7,118,0,29251,28534,625
24-10-2021,thiruvallur,550,41,52,2,537,119067,41,10,0,119118,116742,1839
24-10-2021,thiruvannamalai,223,18,24,0,217,54432,18,398,0,54848,53964,667
24-10-2021,thiruvarur,376,29,58,0,347,41224,29,38,0,41291,40507,437
24-10-2021,thoothukudi,149,12,17,0,144,55932,12,275,0,56219,55667,408
24-10-2021,tirunelveli,173,5,15,0,163,48849,5,427,0,49281,48687,431
24-10-2021,tiruppur,792,78,89,0,781,94812,78,11,0,94901,93146,974
24-10-2021,trichy,472,47,45,0,474,77120,47,65,0,77232,75704,1054
24-10-2021,vellore,201,15,23,1,192,48068,15,1664,0,49747,48425,1130
24-10-2021,villupuram,131,11,18,0,124,45593,11,174,0,45778,45299,355
24-10-2021,virudhunagar,68,5,7,0,66,46147,5,104,0,46256,45642,548
24-10-2021,airport surveillance (international),2,0,0,0,2,0,0,1027,0,1027,1024,1
24-10-2021,airport surveillance (domestic),2,0,0,0,2,0,0,1085,0,1085,1082,1
24-10-2021,railway surveillance,0,0,0,0,0,0,0,428,0,428,428,0
25-10-2021,ariyalur,56,1,5,1,51,16800,1,20,0,16821,16509,261
25-10-2021,chengalpattu,1026,95,114,1,1006,171143,95,5,0,171243,167735,2502
25-10-2021,chennai,1652,144,168,3,1625,553747,144,47,0,553938,543776,8537
25-10-2021,coimbatore,1430,130,151,2,1407,245862,130,51,0,246043,242233,2403
25-10-2021,cuddalore,222,22,23,0,221,63751,22,203,0,63976,62888,867
25-10-2021,dharmapuri,246,19,21,0,244,28099,19,216,0,28334,27817,273
25-10-2021,dindigul,99,9,11,1,96,32963,9,77,0,33049,32308,645
25-10-2021,erode,879,69,67,0,881,103730,69,94,0,103893,102330,682
25-10-2021,kallakurichi,150,10,12,0,148,30894,10,404,0,31308,30950,210
25-10-2021,kancheepuram,365,33,36,0,362,74744,33,4,0,74781,73163,1256
25-10-2021,kanyakumari,180,18,22,0,176,62114,18,124,0,62256,61032,1048
25-10-2021,karur,164,20,15,0,169,23905,20,47,0,23972,23448,355
25-10-2021,krishnagiri,214,17,24,0,207,43199,17,238,0,43454,42900,347
25-10-2021,madurai,215,14,18,1,210,74942,14,173,0,75129,73749,1170
25-10-2021,mayiladuthurai,128,8,20,0,116,23203,8,39,0,23250,22818,316
25-10-2021,nagapattinam,201,17,16,1,201,20924,17,53,0,20994,20456,337
25-10-2021,namakkal,576,48,69,0,555,51816,48,112,0,51976,50925,496
25-10-2021,nilgiris,289,19,38,0,270,33398,19,44,0,33461,32982,209
25-10-2021,perambalur,35,3,2,0,36,12038,3,3,0,12044,11765,243
25-10-2021,pudukottai,133,13,10,1,135,30071,13,35,0,30119,29569,415
25-10-2021,ramanathapuram,80,3,7,0,76,20405,3,135,0,20543,20110,357
25-10-2021,ranipet,111,7,6,0,112,43319,7,49,0,43375,42490,773
25-10-2021,salem,610,57,58,1,608,99031,57,438,0,99526,97235,1683
25-10-2021,sivagangai,130,10,8,0,132,20004,10,108,0,20122,19784,206
25-10-2021,tenkasi,29,4,1,0,32,27275,4,58,0,27337,26821,484
25-10-2021,thanjavur,624,55,62,1,616,75014,55,22,0,75091,73508,967
25-10-2021,theni,41,2,4,0,39,43511,2,45,0,43558,42999,520
25-10-2021,thirupathur,92,4,12,0,84,29133,4,118,0,29255,28546,625
25-10-2021,thiruvallur,535,40,57,0,518,119106,40,10,0,119156,116799,1839
25-10-2021,thiruvannamalai,218,17,21,0,214,54451,17,398,0,54866,53985,667
25-10-2021,thiruvarur,350,28,52,0,326,41256,28,38,0,41322,40559,437
25-10-2021,thoothukudi,144,11,13,0,142,55944,11,275,0,56230,55680,408
25-10-2021,tirunelveli,165,6,17,0,154,48856,6,427,0,49289,48704,431
25-10-2021,tiruppur,783,77,92,0,768,94892,77,11,0,94980,93238,974
25-10-2021,trichy,478,46,41,1,482,77171,46,65,0,77282,75745,1055
25-10-2021,vellore,190,14,25,0,179,48081,14,1664,0,49759,48450,1130
25-10-2021,villupuram,124,13,14,0,123,45604,13,174,0,45791,45313,355
25-10-2021,virudhunagar,66,9,9,0,66,46152,9,104,0,46265,45651,548
25-10-2021,airport surveillance (international),2,0,0,0,2,0,0,1027,0,1027,1024,1
25-10-2021,airport surveillance (domestic),2,0,0,0,2,0,0,1085,0,1085,1082,1
25-10-2021,railway surveillance,0,0,0,0,0,0,0,428,0,428,428,0
26-10-2021,ariyalur,54,5,7,0,52,16804,5,20,0,16829,16516,261
26-10-2021,chengalpattu,1010,93,109,1,993,171242,93,5,0,171340,167844,2503
26-10-2021,chennai,1604,141,172,0,1573,553870,141,47,0,554058,543948,8537
26-10-2021,coimbatore,1408,128,154,1,1381,245993,128,51,0,246172,242387,2404
26-10-2021,cuddalore,221,19,21,0,219,63773,19,203,0,63995,62909,867
26-10-2021,dharmapuri,244,18,24,0,238,28118,18,216,0,28352,27841,273
26-10-2021,dindigul,96,11,5,0,102,32972,11,77,0,33060,32313,645
26-10-2021,erode,874,67,69,0,872,103792,67,94,0,103953,102399,682
26-10-2021,kallakurichi,146,9,15,0,140,30902,9,404,0,31315,30965,210
26-10-2021,kancheepuram,365,31,38,0,358,74780,31,4,0,74815,73201,1256
26-10-2021,kanyakumari,176,17,16,0,177,62132,17,124,0,62273,61048,1048
26-10-2021,karur,170,19,11,1,177,23926,19,47,0,23992,23459,356
26-10-2021,krishnagiri,206,20,20,0,206,43215,20,238,0,43473,42920,347
26-10-2021,madurai,209,15,14,1,209,74955,15,173,0,75143,73763,1171
26-10-2021,mayiladuthurai,116,6,8,0,114,23211,6,39,0,23256,22826,316
26-10-2021,nagapattinam,201,13,17,4,193,20941,13,53,0,21007,20473,341
26-10-2021,namakkal,557,44,65,0,536,51866,44,112,0,52022,50990,496
26-10-2021,nilgiris,270,18,35,0,253,33417,18,44,0,33479,33017,209
26-10-2021,perambalur,36,4,4,0,36,12041,4,3,0,12048,11769,243
26-10-2021,pudukottai,135,12,13,0,134,30084,12,35,0,30131,29582,415
26-10-2021,ramanathapuram,76,2,8,0,70,20408,2,135,0,20545,20118,357
26-10-2021,ranipet,112,6,10,1,107,43326,6,49,0,43381,42500,774
26-10-2021,salem,611,59,62,0,608,99091,59,438,0,99588,97297,1683
26-10-2021,sivagangai,133,11,12,0,132,20015,11,108,0,20134,19796,206
26-10-2021,tenkasi,32,6,1,0,37,27279,6,58,0,27343,26822,484
26-10-2021,thanjavur,613,52,67,3,595,75066,52,22,0,75140,73575,970
26-10-2021,theni,39,3,2,0,40,43513,3,45,0,43561,43001,520
26-10-2021,thirupathur,84,3,9,0,78,29137,3,118,0,29258,28555,625
26-10-2021,thiruvallur,520,39,59,1,499,119148,39,10,0,119197,116858,1840
26-10-2021,thiruvannamalai,216,15,18,0,213,54470,15,398,0,54883,54003,667
26-10-2021,thiruvarur,328,25,43,1,309,41286,25,38,0,41349,40602,438
26-10-2021,thoothukudi,142,10,17,0,135,55955,10,275,0,56240,55697,408
26-10-2021,tirunelveli,156,14,19,0,151,48864,14,427,0,49305,48723,431
26-10-2021,tiruppur,771,75,94,0,752,94972,75,11,0,95058,93332,974
26-10-2021,trichy,484,45,48,0,481,77219,45,65,0,77329,75793,1055
26-10-2021,vellore,182,21,23,0,180,48098,21,1664,0,49783,48473,1130
26-10-2021,villupuram,124,11,11,1,123,45618,11,174,0,45803,45324,356
26-10-2021,virudhunagar,66,2,6,0,62,46161,2,104,0,46267,45657,548
26-10-2021,airport surveillance (international),2,1,0,0,3,0,0,1027,1,1028,1024,1
26-10-2021,airport surveillance (domestic),2,0,0,0,2,0,0,1085,0,1085,1082,1
26-10-2021,railway surveillance,0,0,0,0,0,0,0,428,0,428,428,0
27-10-2021,ariyalur,51,8,6,0,53,16808,8,20,0,16836,16522,261
27-10-2021,chengalpattu,990,90,104,0,976,171332,90,5,0,171427,167948,2503
27-10-2021,chennai,1564,139,169,1,1533,554002,139,47,0,554188,544117,8538
27-10-2021,coimbatore,1382,125,151,3,1353,246122,125,51,0,246298,242538,2407
27-10-2021,cuddalore,219,17,20,0,216,63792,17,203,0,64012,62929,867
27-10-2021,dharmapuri,238,17,22,0,233,28136,17,216,0,28369,27863,273
27-10-2021,dindigul,102,10,7,0,105,32983,10,77,0,33070,32320,645
27-10-2021,erode,865,71,71,0,865,103852,71,94,0,104017,102470,682
27-10-2021,kallakurichi,139,2,12,0,129,30910,2,404,0,31316,30977,210
27-10-2021,kancheepuram,358,29,36,1,350,74811,29,4,0,74844,73237,1257
27-10-2021,kanyakumari,177,20,17,0,180,62149,20,124,0,62293,61065,1048
27-10-2021,karur,182,15,16,0,181,23950,15,47,0,24012,23475,356
27-10-2021,krishnagiri,206,23,23,0,206,43235,23,238,0,43496,42943,347
27-10-2021,madurai,208,13,13,1,207,74969,13,173,0,75155,73776,1172
27-10-2021,mayiladuthurai,115,5,5,0,115,23218,5,39,0,23262,22831,316
27-10-2021,nagapattinam,194,15,15,0,194,20955,15,53,0,21023,20488,341
27-10-2021,namakkal,536,43,59,0,520,51910,43,112,0,52065,51049,496
27-10-2021,nilgiris,253,15,32,1,235,33435,15,44,0,33494,33049,210
27-10-2021,perambalur,36,3,4,0,35,12045,3,3,0,12051,11773,243
27-10-2021,pudukottai,135,11,14,0,132,30097,11,35,0,30143,29596,415
27-10-2021,ramanathapuram,70,7,9,0,68,20410,7,135,0,20552,20127,357
27-10-2021,ranipet,107,8,11,0,104,43332,8,49,0,43389,42511,774
27-10-2021,salem,610,57,64,0,603,99152,57,438,0,99647,97361,1683
27-10-2021,sivagangai,133,13,13,0,133,20027,13,108,0,20148,19809,206
27-10-2021,tenkasi,37,4,2,0,39,27285,4,58,0,27347,26824,484
27-10-2021,thanjavur,594,48,65,0,577,75117,48,22,0,75187,73640,970
27-10-2021,theni,40,2,3,0,39,43516,2,45,0,43563,43004,520
27-10-2021,thirupathur,78,5,8,0,75,29140,5,118,0,29263,28563,625
27-10-2021,thiruvallur,500,37,55,2,480,119188,37,10,0,119235,116913,1842
27-10-2021,thiruvannamalai,216,16,19,0,213,54488,16,398,0,54902,54022,667
27-10-2021,thiruvarur,308,21,45,0,284,41310,21,38,0,41369,40647,438
27-10-2021,thoothukudi,137,11,21,0,127,55967,11,275,0,56253,55718,408
27-10-2021,tirunelveli,150,22,18,0,154,48877,22,427,0,49326,48741,431
27-10-2021,tiruppur,754,70,97,3,724,95049,70,11,0,95130,93429,977
27-10-2021,trichy,484,44,50,0,478,77267,44,65,0,77376,75843,1055
27-10-2021,vellore,180,22,25,0,177,48119,22,1664,0,49805,48498,1130
27-10-2021,villupuram,125,12,10,0,127,45631,12,174,0,45817,45334,356
27-10-2021,virudhunagar,62,5,4,0,63,46163,5,104,0,46272,45661,548
27-10-2021,airport surveillance (international),3,0,0,0,3,0,0,1028,0,1028,1024,1
27-10-2021,airport surveillance (domestic),2,0,0,0,2,0,0,1085,0,1085,1082,1
27-10-2021,railway surveillance,0,0,0,0,0,0,0,428,0,428,428,0
28-10-2021,ariyalur,53,7,10,0,50,16816,7,20,0,16843,16532,261
28-10-2021,chengalpattu,977,86,94,0,969,171423,86,5,0,171514,168042,2503
28-10-2021,chennai,1533,135,157,3,1508,554141,135,47,0,554323,544274,8541
28-10-2021,coimbatore,1355,123,145,3,1330,246249,123,51,0,246423,242683,2410
28-10-2021,cuddalore,216,20,18,0,218,63809,20,203,0,64032,62947,867
28-10-2021,dharmapuri,233,16,24,0,225,28153,16,216,0,28385,27887,273
28-10-2021,dindigul,104,6,8,0,102,32992,6,77,0,33075,32328,645
28-10-2021,erode,865,77,83,0,859,103923,77,94,0,104094,102553,682
28-10-2021,kallakurichi,129,9,17,0,121,30912,9,404,0,31325,30994,210
28-10-2021,kancheepuram,351,28,39,0,340,74841,28,4,0,74873,73276,1257
28-10-2021,kanyakumari,180,18,14,0,184,62169,18,124,0,62311,61079,1048
28-10-2021,karur,181,19,12,0,188,23965,19,47,0,24031,23487,356
28-10-2021,krishnagiri,208,21,26,0,203,43260,21,238,0,43519,42969,347
28-10-2021,madurai,206,16,19,0,203,74981,16,173,0,75170,73795,1172
28-10-2021,mayiladuthurai,115,2,9,0,108,23223,2,39,0,23264,22840,316
28-10-2021,nagapattinam,194,11,18,2,185,20970,11,53,0,21034,20506,343
28-10-2021,namakkal,520,47,52,0,515,51953,47,112,0,52112,51101,496
28-10-2021,nilgiris,235,17,29,0,223,33450,17,44,0,33511,33078,210
28-10-2021,perambalur,35,4,2,0,37,12048,4,3,0,12055,11775,243
28-10-2021,pudukottai,132,9,11,0,130,30108,9,35,0,30152,29607,415
28-10-2021,ramanathapuram,68,4,7,0,65,20417,4,135,0,20556,20134,357
28-10-2021,ranipet,105,11,12,0,104,43341,11,49,0,43401,42523,774
28-10-2021,salem,603,62,61,0,604,99209,62,438,0,99709,97422,1683
28-10-2021,sivagangai,132,11,15,0,128,20039,11,108,0,20158,19824,206
28-10-2021,tenkasi,38,2,2,0,38,27288,2,58,0,27348,26826,484
28-10-2021,thanjavur,577,44,58,0,563,75165,44,22,0,75231,73698,970
28-10-2021,theni,39,1,3,0,37,43518,1,45,0,43564,43007,520
28-10-2021,thirupathur,75,11,6,0,80,29145,11,118,0,29274,28569,625
28-10-2021,thiruvallur,481,35,59,0,457,119226,35,10,0,119271,116972,1842
28-10-2021,thiruvannamalai,213,14,22,0,205,54504,14,398,0,54916,54044,667
28-10-2021,thiruvarur,284,24,38,1,269,41331,24,38,0,41393,40685,439
28-10-2021,thoothukudi,129,14,13,0,130,55980,14,275,0,56269,55731,408
28-10-2021,tirunelveli,153,15,25,0,143,48898,15,427,0,49340,48766,431
28-10-2021,tiruppur,724,65,82,1,706,95119,65,11,0,95195,93511,978
28-10-2021,trichy,478,42,54,2,464,77311,42,65,0,77418,75897,1057
28-10-2021,vellore,172,20,21,0,171,48136,20,1664,0,49820,48519,1130
28-10-2021,villupuram,127,11,16,0,122,45643,11,174,0,45828,45350,356
28-10-2021,virudhunagar,63,4,5,0,62,46168,4,104,0,46276,45666,548
28-10-2021,airport surveillance (international),3,0,0,0,3,0,0,1028,0,1028,1024,1
28-10-2021,airport surveillance (domestic),2,0,0,0,2,0,0,1085,0,1085,1082,1
28-10-2021,railway surveillance,0,0,0,0,0,0,0,428,0,428,428,0
29-10-2021,ariyalur,48,6,9,0,45,16821,6,20,0,16847,16541,261
29-10-2021,chengalpattu,975,88,97,0,966,171515,88,5,0,171608,168139,2503
29-10-2021,chennai,1498,126,146,1,1477,554266,126,47,0,554439,544420,8542
29-10-2021,coimbatore,1333,118,137,2,1312,246375,118,51,0,246544,242820,2412
29-10-2021,cuddalore,218,19,15,0,222,63829,19,203,0,64051,62962,867
29-10-2021,dharmapuri,225,13,26,1,211,28169,13,216,0,28398,27913,274
29-10-2021,dindigul,102,8,5,0,105,32998,8,77,0,33083,32333,645
29-10-2021,erode,850,79,92,0,837,103991,79,94,0,104164,102645,682
29-10-2021,kallakurichi,121,11,18,0,114,30921,11,404,0,31336,31012,210
29-10-2021,kancheepuram,344,33,34,0,343,74873,33,4,0,74910,73310,1257
29-10-2021,kanyakumari,184,17,12,0,189,62187,17,124,0,62328,61091,1048
29-10-2021,karur,188,17,9,0,196,23984,17,47,0,24048,23496,356
29-10-2021,krishnagiri,203,17,28,1,191,43281,17,238,0,43536,42997,348
29-10-2021,madurai,206,15,23,0,198,75000,15,173,0,75188,73818,1172
29-10-2021,mayiladuthurai,109,8,13,0,104,23226,8,39,0,23273,22853,316
29-10-2021,nagapattinam,187,10,16,0,181,20983,10,53,0,21046,20522,343
29-10-2021,namakkal,511,46,48,2,507,51996,46,112,0,52154,51149,498
29-10-2021,nilgiris,223,18,32,0,209,33467,18,44,0,33529,33110,210
29-10-2021,perambalur,38,3,4,0,37,12053,3,3,0,12059,11779,243
29-10-2021,pudukottai,128,13,7,1,133,30115,13,35,0,30163,29614,416
29-10-2021,ramanathapuram,65,3,10,0,58,20421,3,135,0,20559,20144,357
29-10-2021,ranipet,103,12,8,0,107,43351,12,49,0,43412,42531,774
29-10-2021,salem,606,60,66,0,600,99273,60,438,0,99771,97488,1683
29-10-2021,sivagangai,129,12,14,0,127,20051,12,108,0,20171,19838,206
29-10-2021,tenkasi,38,2,1,0,39,27290,2,58,0,27350,26827,484
29-10-2021,thanjavur,563,42,56,2,547,75209,42,22,0,75273,73754,972
29-10-2021,theni,37,1,2,0,36,43519,1,45,0,43565,43009,520
29-10-2021,thirupathur,79,10,13,0,76,29155,10,118,0,29283,28582,625
29-10-2021,thiruvallur,462,33,54,0,441,119266,33,10,0,119309,117026,1842
29-10-2021,thiruvannamalai,211,13,24,0,200,54524,13,398,0,54935,54068,667
29-10-2021,thiruvarur,269,22,29,0,262,41355,22,38,0,41415,40714,439
29-10-2021,thoothukudi,129,13,11,0,131,55993,13,275,0,56281,55742,408
29-10-2021,tirunelveli,141,13,19,0,135,48911,13,427,0,49351,48785,431
29-10-2021,tiruppur,713,63,68,0,708,95191,63,11,0,95265,93579,978
29-10-2021,trichy,463,40,47,0,456,77352,40,65,0,77457,75944,1057
29-10-2021,vellore,163,18,17,1,163,48148,18,1664,0,49830,48536,1131
29-10-2021,villupuram,122,10,12,0,120,45654,10,174,0,45838,45362,356
29-10-2021,virudhunagar,62,7,6,0,63,46172,7,104,0,46283,45672,548
29-10-2021,airport surveillance (international),3,0,1,0,2,0,0,1028,0,1028,1025,1
29-10-2021,airport surveillance (domestic),2,0,0,0,2,0,0,1085,0,1085,1082,1
29-10-2021,railway surveillance,0,0,0,0,0,0,0,428,0,428,428,0
30-10-2021,ariyalur,43,4,4,0,43,16825,4,20,0,16849,16545,261
30-10-2021,chengalpattu,967,85,95,1,956,171604,85,5,0,171694,168234,2504
30-10-2021,chennai,1472,120,138,0,1454,554387,120,47,0,554554,544558,8542
30-10-2021,coimbatore,1312,116,124,3,1301,246493,116,51,0,246660,242944,2415
30-10-2021,cuddalore,222,18,17,0,223,63848,18,203,0,64069,62979,867
30-10-2021,dharmapuri,210,12,23,0,199,28181,12,216,0,28409,27936,274
30-10-2021,dindigul,105,7,8,0,104,33006,7,77,0,33090,32341,645
30-10-2021,erode,832,76,97,2,809,104065,76,94,0,104235,102742,684
30-10-2021,kallakurichi,113,15,21,0,107,30931,15,404,0,31350,31033,210
30-10-2021,kancheepuram,341,32,39,1,333,74904,32,4,0,74940,73349,1258
30-10-2021,kanyakumari,190,16,9,0,197,62205,16,124,0,62345,61100,1048
30-10-2021,karur,196,23,11,0,208,24001,23,47,0,24071,23507,356
30-10-2021,krishnagiri,191,18,20,0,189,43298,18,238,0,43554,43017,348
30-10-2021,madurai,198,14,18,0,194,75015,14,173,0,75202,73836,1172
30-10-2021,mayiladuthurai,105,3,15,0,93,23235,3,39,0,23277,22868,316
30-10-2021,nagapattinam,181,12,19,2,172,20993,12,53,0,21058,20541,345
30-10-2021,namakkal,511,44,53,0,502,52046,44,112,0,52202,51202,498
30-10-2021,nilgiris,209,17,29,0,197,33485,17,44,0,33546,33139,210
30-10-2021,perambalur,39,4,6,0,37,12058,4,3,0,12065,11785,243
30-10-2021,pudukottai,130,11,5,0,136,30125,11,35,0,30171,29619,416
30-10-2021,ramanathapuram,58,2,8,0,52,20424,2,135,0,20561,20152,357
30-10-2021,ranipet,106,11,12,1,104,43362,11,49,0,43422,42543,775
30-10-2021,salem,601,59,64,1,595,99334,59,438,0,99831,97552,1684
30-10-2021,sivagangai,128,10,7,0,131,20064,10,108,0,20182,19845,206
30-10-2021,tenkasi,39,3,3,0,39,27292,3,58,0,27353,26830,484
30-10-2021,thanjavur,549,40,61,0,528,75253,40,22,0,75315,73815,972
30-10-2021,theni,36,5,4,0,37,43520,5,45,0,43570,43013,520
30-10-2021,thirupathur,76,8,10,0,74,29165,8,118,0,29291,28592,625
30-10-2021,thiruvallur,442,32,57,0,417,119300,32,10,0,119342,117083,1842
30-10-2021,thiruvannamalai,200,15,26,0,189,54537,15,398,0,54950,54094,667
30-10-2021,thiruvarur,261,24,24,1,260,41376,24,38,0,41438,40738,440
30-10-2021,thoothukudi,131,12,6,0,137,56006,12,275,0,56293,55748,408
30-10-2021,tirunelveli,135,12,14,0,133,48924,12,427,0,49363,48799,431
30-10-2021,tiruppur,710,69,51,0,728,95256,69,11,0,95336,93630,978
30-10-2021,trichy,457,39,45,2,449,77393,39,65,0,77497,75989,1059
30-10-2021,vellore,166,19,13,0,172,48169,19,1664,0,49852,48549,1131
30-10-2021,villupuram,121,8,9,0,120,45665,8,174,0,45847,45371,356
30-10-2021,virudhunagar,63,6,7,0,62,46179,6,104,0,46289,45679,548
30-10-2021,airport surveillance (international),2,0,0,0,2,0,0,1028,0,1028,1025,1
30-10-2021,airport surveillance (domestic),2,0,0,0,2,0,0,1085,0,1085,1082,1
30-10-2021,railway surveillance,0,0,0,0,0,0,0,428,0,428,428,0
31-10-2021,ariyalur,43,5,3,0,45,16829,5,20,0,16854,16548,261
31-10-2021,chengalpattu,956,83,93,2,944,171689,83,5,0,171777,168327,2506
31-10-2021,chennai,1458,114,143,4,1425,554511,114,47,0,554672,544701,8546
31-10-2021,coimbatore,1302,119,126,1,1294,246610,119,51,0,246780,243070,2416
31-10-2021,cuddalore,222,17,18,0,221,63865,17,203,0,64085,62997,867
31-10-2021,dharmapuri,199,16,21,0,194,28193,16,216,0,28425,27957,274
31-10-2021,dindigul,108,5,7,0,106,33017,5,77,0,33099,32348,645
31-10-2021,erode,802,75,94,2,781,104134,75,94,0,104303,102836,686
31-10-2021,kallakurichi,107,14,23,0,98,30946,14,404,0,31364,31056,210
31-10-2021,kancheepuram,333,30,37,0,326,74936,30,4,0,74970,73386,1258
31-10-2021,kanyakumari,197,17,12,0,202,62221,17,124,0,62362,61112,1048
31-10-2021,karur,206,22,16,0,212,24022,22,47,0,24091,23523,356
31-10-2021,krishnagiri,189,16,19,0,186,43316,16,238,0,43570,43036,348
31-10-2021,madurai,194,13,17,0,190,75029,13,173,0,75215,73853,1172
31-10-2021,mayiladuthurai,94,2,10,0,86,23239,2,39,0,23280,22878,316
31-10-2021,nagapattinam,174,14,20,1,167,21007,14,53,0,21074,20561,346
31-10-2021,namakkal,502,43,51,0,494,52090,43,112,0,52245,51253,498
31-10-2021,nilgiris,197,20,25,2,190,33502,20,44,0,33566,33164,212
31-10-2021,perambalur,37,2,5,0,34,12062,2,3,0,12067,11790,243
31-10-2021,pudukottai,136,12,8,0,140,30136,12,35,0,30183,29627,416
31-10-2021,ramanathapuram,52,3,6,0,49,20426,3,135,0,20564,20158,357
31-10-2021,ranipet,108,10,14,0,104,43377,10,49,0,43436,42557,775
31-10-2021,salem,599,58,67,1,589,99397,58,438,0,99893,97619,1685
31-10-2021,sivagangai,131,13,9,0,135,20074,13,108,0,20195,19854,206
31-10-2021,tenkasi,39,4,4,0,39,27295,4,58,0,27357,26834,484
31-10-2021,thanjavur,526,39,59,0,506,75291,39,22,0,75352,73874,972
31-10-2021,theni,35,3,5,1,32,43523,3,45,0,43571,43018,521
31-10-2021,thirupathur,75,9,8,0,76,29174,9,118,0,29301,28600,625
31-10-2021,thiruvallur,414,31,55,0,390,119329,31,10,0,119370,117138,1842
31-10-2021,thiruvannamalai,190,17,28,0,179,54553,17,398,0,54968,54122,667
31-10-2021,thiruvarur,260,23,22,2,259,41400,23,38,0,41461,40760,442
31-10-2021,thoothukudi,137,11,9,1,138,56018,11,275,0,56304,55757,409
31-10-2021,tirunelveli,133,11,13,1,130,48936,11,427,0,49374,48812,432
31-10-2021,tiruppur,729,68,53,1,743,95326,68,11,0,95405,93683,979
31-10-2021,trichy,449,37,49,0,437,77432,37,65,0,77534,76038,1059
31-10-2021,vellore,166,18,15,0,169,48182,18,1664,0,49864,48564,1131
31-10-2021,villupuram,120,10,11,0,119,45673,10,174,0,45857,45382,356
31-10-2021,virudhunagar,62,5,8,0,59,46185,5,104,0,46294,45687,548
31-10-2021,airport surveillance (international),2,0,0,0,2,0,0,1028,0,1028,1025,1
31-10-2021,airport surveillance (domestic),2,0,0,0,2,0,0,1085,0,1085,1082,1
31-10-2021,railway surveillance,0,0,0,0,0,0,0,428,0,428,428,0
01-11-2021,ariyalur,45,4,2,0,47,16834,4,20,0,16858,16550,261
01-11-2021,chengalpattu,944,85,98,4,927,171772,85,5,0,171862,168425,2510
01-11-2021,chennai,1420,111,137,3,1391,554620,111,47,0,554778,544838,8549
01-11-2021,coimbatore,1294,117,131,3,1277,246729,117,51,0,246897,243201,2419
01-11-2021,cuddalore,221,16,24,0,213,63882,16,203,0,64101,63021,867
01-11-2021,dharmapuri,195,15,18,1,191,28210,15,216,0,28441,27975,275
01-11-2021,dindigul,105,4,13,0,96,33021,4,77,0,33102,32361,645
01-11-2021,erode,779,73,89,0,763,104207,73,94,0,104374,102925,686
01-11-2021,kallakurichi,98,13,19,0,92,30960,13,404,0,31377,31075,210
01-11-2021,kancheepuram,327,28,32,0,323,74967,28,4,0,74999,73418,1258
01-11-2021,kanyakumari,202,20,14,1,207,62238,20,124,0,62382,61126,1049
01-11-2021,karur,212,23,18,0,217,24044,23,47,0,24114,23541,356
01-11-2021,krishnagiri,184,18,16,0,186,43330,18,238,0,43586,43052,348
01-11-2021,madurai,190,12,23,1,178,75042,12,173,0,75227,73876,1173
01-11-2021,mayiladuthurai,86,0,12,0,74,23241,0,39,0,23280,22890,316
01-11-2021,nagapattinam,167,12,17,0,162,21021,12,53,0,21086,20578,346
01-11-2021,namakkal,497,42,48,0,491,52136,42,112,0,52290,51301,498
01-11-2021,nilgiris,190,19,22,0,187,33522,19,44,0,33585,33186,212
01-11-2021,perambalur,34,0,3,0,31,12064,0,3,0,12067,11793,243
01-11-2021,pudukottai,140,11,13,0,138,30148,11,35,0,30194,29640,416
01-11-2021,ramanathapuram,49,6,7,0,48,20429,6,135,0,20570,20165,357
01-11-2021,ranipet,105,13,12,0,106,43388,13,49,0,43450,42569,775
01-11-2021,salem,589,57,62,0,584,99455,57,438,0,99950,97681,1685
01-11-2021,sivagangai,134,12,15,1,130,20086,12,108,0,20206,19869,207
01-11-2021,tenkasi,39,3,5,0,37,27299,3,58,0,27360,26839,484
01-11-2021,thanjavur,506,42,51,2,495,75330,42,22,0,75394,73925,974
01-11-2021,theni,32,2,4,0,30,43526,2,45,0,43573,43022,521
01-11-2021,thirupathur,77,7,9,0,75,29184,7,118,0,29309,28609,625
01-11-2021,thiruvallur,392,30,43,0,379,119362,30,10,0,119402,117181,1842
01-11-2021,thiruvannamalai,179,16,20,0,175,54570,16,398,0,54984,54142,667
01-11-2021,thiruvarur,260,22,27,2,253,41424,22,38,0,41484,40787,444
01-11-2021,thoothukudi,140,12,13,0,139,56031,12,275,0,56318,55770,409
01-11-2021,tirunelveli,129,10,11,0,128,48946,10,427,0,49383,48823,432
01-11-2021,tiruppur,745,66,59,2,750,95396,66,11,0,95473,93742,981
01-11-2021,trichy,437,35,41,0,431,77469,35,65,0,77569,76079,1059
01-11-2021,vellore,167,21,8,0,180,48198,21,1664,0,49883,48572,1131
01-11-2021,villupuram,119,9,10,0,118,45683,9,174,0,45866,45392,356
01-11-2021,virudhunagar,59,4,6,0,57,46190,4,104,0,46298,45693,548
01-11-2021,airport surveillance (international),2,0,0,0,2,0,0,1028,0,1028,1025,1
01-11-2021,airport surveillance (domestic),2,0,1,0,1,0,0,1085,0,1085,1083,1
01-11-2021,railway surveillance,0,0,0,0,0,0,0,428,0,428,428,0
02-11-2021,ariyalur,47,3,4,0,46,16838,3,20,0,16861,16554,261
02-11-2021,chengalpattu,930,84,94,2,918,171860,84,5,0,171949,168519,2512
02-11-2021,chennai,1385,109,135,5,1354,554725,109,47,0,554881,544973,8554
02-11-2021,coimbatore,1277,114,129,1,1261,246846,114,51,0,247011,243330,2420
02-11-2021,cuddalore,213,15,21,0,207,63898,15,203,0,64116,63042,867
02-11-2021,dharmapuri,190,14,20,0,184,28224,14,216,0,28454,27995,275
02-11-2021,dindigul,96,5,9,1,91,33025,5,77,0,33107,32370,646
02-11-2021,erode,759,71,82,1,747,104276,71,94,0,104441,103007,687
02-11-2021,kallakurichi,92,12,10,0,94,30973,12,404,0,31389,31085,210
02-11-2021,kancheepuram,325,30,26,0,329,74997,30,4,0,75031,73444,1258
02-11-2021,kanyakumari,207,19,19,0,207,62258,19,124,0,62401,61145,1049
02-11-2021,karur,218,22,17,1,222,24068,22,47,0,24137,23558,357
02-11-2021,krishnagiri,186,16,13,0,189,43348,16,238,0,43602,43065,348
02-11-2021,madurai,178,10,28,0,160,75054,10,173,0,75237,73904,1173
02-11-2021,mayiladuthurai,74,6,15,0,65,23241,6,39,0,23286,22905,316
02-11-2021,nagapattinam,163,8,11,1,159,21034,8,53,0,21095,20589,347
02-11-2021,namakkal,491,45,52,2,482,52178,45,112,0,52335,51353,500
02-11-2021,nilgiris,187,22,18,0,191,33541,22,44,0,33607,33204,212
02-11-2021,perambalur,32,0,2,0,30,12065,0,3,0,12068,11795,243
02-11-2021,pudukottai,138,8,16,0,130,30159,8,35,0,30202,29656,416
02-11-2021,ramanathapuram,48,3,8,1,42,20435,3,135,0,20573,20173,358
02-11-2021,ranipet,106,8,12,0,102,43401,8,49,0,43458,42581,775
02-11-2021,salem,588,59,58,0,589,99516,59,438,0,100013,97739,1685
02-11-2021,sivagangai,130,15,14,0,131,20098,15,108,0,20221,19883,207
02-11-2021,tenkasi,37,2,6,1,32,27302,2,58,0,27362,26845,485
02-11-2021,thanjavur,493,40,48,2,483,75370,40,22,0,75432,73973,976
02-11-2021,theni,30,4,3,0,31,43528,4,45,0,43577,43025,521
02-11-2021,thirupathur,75,8,7,0,76,29191,8,118,0,29317,28616,625
02-11-2021,thiruvallur,378,32,40,0,370,119391,32,10,0,119433,117221,1842
02-11-2021,thiruvannamalai,179,15,15,0,179,54590,15,398,0,55003,54157,667
02-11-2021,thiruvarur,251,21,24,0,248,41444,21,38,0,41503,40811,444
02-11-2021,thoothukudi,139,9,16,0,132,56043,9,275,0,56327,55786,409
02-11-2021,tirunelveli,128,12,10,1,129,48956,12,427,0,49395,48833,433
02-11-2021,tiruppur,752,65,67,0,750,95464,65,11,0,95540,93809,981
02-11-2021,trichy,431,33,39,1,424,77504,33,65,0,77602,76118,1060
02-11-2021,vellore,178,20,9,1,188,48217,20,1664,0,49901,48581,1132
02-11-2021,villupuram,118,11,12,0,117,45692,11,174,0,45877,45404,356
02-11-2021,virudhunagar,57,3,5,0,55,46194,3,104,0,46301,45698,548
02-11-2021,airport surveillance (international),2,0,0,0,2,0,0,1028,0,1028,1025,1
02-11-2021,airport surveillance (domestic),1,0,0,0,1,0,0,1085,0,1085,1083,1
02-11-2021,railway surveillance,0,0,0,0,0,0,0,428,0,428,428,0
03-11-2021,ariyalur,47,4,3,0,48,16842,4,20,0,16866,16557,261
03-11-2021,chengalpattu,920,82,89,0,913,171946,82,5,0,172033,168608,2512
03-11-2021,chennai,1349,105,127,3,1324,554829,105,47,0,554981,545100,8557
03-11-2021,coimbatore,1262,109,125,0,1246,246961,109,51,0,247121,243455,2420
03-11-2021,cuddalore,208,18,22,0,204,63914,18,203,0,64135,63064,867
03-11-2021,dharmapuri,185,16,25,1,175,28239,16,216,0,28471,28020,276
03-11-2021,dindigul,90,4,11,1,82,33029,4,77,0,33110,32381,647
03-11-2021,erode,743,69,78,0,734,104343,69,94,0,104506,103085,687
03-11-2021,kallakurichi,94,11,8,0,97,30985,11,404,0,31400,31093,210
03-11-2021,kancheepuram,328,29,24,0,333,75026,29,4,0,75059,73468,1258
03-11-2021,kanyakumari,207,18,21,1,203,62277,18,124,0,62419,61166,1050
03-11-2021,karur,221,25,19,0,227,24089,25,47,0,24161,23577,357
03-11-2021,krishnagiri,190,15,10,1,194,43365,15,238,0,43618,43075,349
03-11-2021,madurai,159,11,17,2,151,75063,11,173,0,75247,73921,1175
03-11-2021,mayiladuthurai,65,4,12,0,57,23247,4,39,0,23290,22917,316
03-11-2021,nagapattinam,159,11,14,2,154,21042,11,53,0,21106,20603,349
03-11-2021,namakkal,486,47,57,1,475,52227,47,112,0,52386,51410,501
03-11-2021,nilgiris,191,21,16,1,195,33563,21,44,0,33628,33220,213
03-11-2021,perambalur,30,4,1,1,32,12065,4,3,0,12072,11796,244
03-11-2021,pudukottai,130,7,15,0,122,30167,7,35,0,30209,29671,416
03-11-2021,ramanathapuram,42,1,7,0,36,20438,1,135,0,20574,20180,358
03-11-2021,ranipet,103,5,9,0,99,43410,5,49,0,43464,42590,775
03-11-2021,salem,589,58,52,1,594,99575,58,438,0,100071,97791,1686
03-11-2021,sivagangai,131,13,13,0,131,20113,13,108,0,20234,19896,207
03-11-2021,tenkasi,32,6,2,0,36,27304,6,58,0,27368,26847,485
03-11-2021,thanjavur,481,37,51,0,467,75408,37,22,0,75467,74024,976
03-11-2021,theni,31,1,5,0,27,43532,1,45,0,43578,43030,521
03-11-2021,thirupathur,76,6,6,0,76,29199,6,118,0,29323,28622,625
03-11-2021,thiruvallur,371,33,39,0,365,119424,33,10,0,119467,117260,1842
03-11-2021,thiruvannamalai,179,14,18,1,174,54605,14,398,0,55017,54175,668
03-11-2021,thiruvarur,250,24,20,2,252,41467,24,38,0,41529,40831,446
03-11-2021,thoothukudi,132,10,14,0,128,56052,10,275,0,56337,55800,409
03-11-2021,tirunelveli,129,10,9,0,130,48968,10,427,0,49405,48842,433
03-11-2021,tiruppur,752,66,74,1,743,95531,66,11,0,95608,93883,982
03-11-2021,trichy,424,32,38,0,418,77537,32,65,0,77634,76156,1060
03-11-2021,vellore,186,18,13,0,191,48235,18,1664,0,49917,48594,1132
03-11-2021,villupuram,117,13,10,0,120,45703,13,174,0,45890,45414,356
03-11-2021,virudhunagar,55,5,4,0,56,46197,5,104,0,46306,45702,548
03-11-2021,airport surveillance (international),2,0,0,0,2,0,0,1028,0,1028,1025,1
03-11-2021,airport surveillance (domestic),1,0,0,0,1,0,0,1085,0,1085,1083,1
03-11-2021,railway surveillance,0,0,0,0,0,0,0,428,0,428,428,0
04-11-2021,ariyalur,48,1,4,0,45,16846,1,20,0,16867,16561,261
04-11-2021,chengalpattu,917,83,92,0,908,172032,83,5,0,172120,168700,2512
04-11-2021,chennai,1316,112,123,1,1304,554926,112,47,0,555085,545223,8558
04-11-2021,coimbatore,1247,107,119,3,1232,247071,107,51,0,247229,243574,2423
04-11-2021,cuddalore,204,17,21,3,197,63932,17,203,0,64152,63085,870
04-11-2021,dharmapuri,175,15,20,0,170,28255,15,216,0,28486,28040,276
04-11-2021,dindigul,82,5,9,0,78,33033,5,77,0,33115,32390,647
04-11-2021,erode,731,70,74,1,726,104409,70,94,0,104573,103159,688
04-11-2021,kallakurichi,97,10,10,0,97,30996,10,404,0,31410,31103,210
04-11-2021,kancheepuram,333,30,26,0,337,75055,30,4,0,75089,73494,1258
04-11-2021,kanyakumari,203,21,19,0,205,62295,21,124,0,62440,61185,1050
04-11-2021,karur,227,22,22,0,227,24114,22,47,0,24183,23599,357
04-11-2021,krishnagiri,194,13,13,1,193,43380,13,238,0,43631,43088,350
04-11-2021,madurai,151,12,15,1,147,75074,12,173,0,75259,73936,1176
04-11-2021,mayiladuthurai,57,2,8,0,51,23251,2,39,0,23292,22925,316
04-11-2021,nagapattinam,154,13,12,0,155,21053,13,53,0,21119,20615,349
04-11-2021,namakkal,473,45,53,0,465,52272,45,112,0,52429,51463,501
04-11-2021,nilgiris,195,22,18,0,199,33584,22,44,0,33650,33238,213
04-11-2021,perambalur,32,1,1,0,32,12069,1,3,0,12073,11797,244
04-11-2021,pudukottai,122,6,7,0,121,30174,6,35,0,30215,29678,416
04-11-2021,ramanathapuram,36,1,5,1,31,20439,1,135,0,20575,20185,359
04-11-2021,ranipet,101,4,6,0,99,43417,4,49,0,43470,42596,775
04-11-2021,salem,596,57,56,1,596,99635,57,438,0,100130,97847,1687
04-11-2021,sivagangai,131,11,17,0,125,20126,11,108,0,20245,19913,207
04-11-2021,tenkasi,36,3,3,0,36,27310,3,58,0,27371,26850,485
04-11-2021,thanjavur,466,36,48,2,452,75444,36,22,0,75502,74072,978
04-11-2021,theni,27,3,2,0,28,43533,3,45,0,43581,43032,521
04-11-2021,thirupathur,76,1,7,0,70,29205,1,118,0,29324,28629,625
04-11-2021,thiruvallur,366,35,37,0,364,119458,35,10,0,119503,117297,1842
04-11-2021,thiruvannamalai,174,13,16,0,171,54619,13,398,0,55030,54191,668
04-11-2021,thiruvarur,255,23,23,0,255,41494,23,38,0,41555,40854,446
04-11-2021,thoothukudi,128,12,14,0,126,56062,12,275,0,56349,55814,409
04-11-2021,tirunelveli,130,13,11,0,132,48978,13,427,0,49418,48853,433
04-11-2021,tiruppur,744,63,71,1,735,95598,63,11,0,95672,93954,983
04-11-2021,trichy,419,30,34,0,415,77570,30,65,0,77665,76190,1060
04-11-2021,vellore,189,17,16,0,190,48251,17,1664,0,49932,48610,1132
04-11-2021,villupuram,121,12,9,0,124,45717,12,174,0,45903,45423,356
04-11-2021,virudhunagar,56,4,6,0,54,46202,4,104,0,46310,45708,548
04-11-2021,airport surveillance (international),2,0,0,0,2,0,0,1028,0,1028,1025,1
04-11-2021,airport surveillance (domestic),1,0,0,0,1,0,0,1085,0,1085,1083,1
04-11-2021,railway surveillance,0,0,0,0,0,0,0,428,0,428,428,0
05-11-2021,ariyalur,45,2,2,0,45,16847,2,20,0,16869,16563,261
05-11-2021,chengalpattu,913,80,98,1,894,172120,80,5,0,172205,168798,2513
05-11-2021,chennai,1294,106,132,3,1265,555028,106,47,0,555181,545355,8561
05-11-2021,coimbatore,1232,102,124,2,1208,247178,102,51,0,247331,243698,2425
05-11-2021,cuddalore,197,15,19,0,193,63949,15,203,0,64167,63104,870
05-11-2021,dharmapuri,170,14,16,0,168,28270,14,216,0,28500,28056,276
05-11-2021,dindigul,78,4,8,0,74,33038,4,77,0,33119,32398,647
05-11-2021,erode,726,68,59,1,734,104479,68,94,0,104641,103218,689
05-11-2021,kallakurichi,97,7,6,0,98,31006,7,404,0,31417,31109,210
05-11-2021,kancheepuram,338,27,33,0,332,75086,27,4,0,75117,73527,1258
05-11-2021,kanyakumari,205,19,20,0,204,62316,19,124,0,62459,61205,1050
05-11-2021,karur,224,20,15,1,228,24133,20,47,0,24200,23614,358
05-11-2021,krishnagiri,193,12,11,0,194,43393,12,238,0,43643,43099,350
05-11-2021,madurai,146,11,14,1,142,75085,11,173,0,75269,73950,1177
05-11-2021,mayiladuthurai,51,0,9,0,42,23253,0,39,0,23292,22934,316
05-11-2021,nagapattinam,155,10,17,1,147,21066,10,53,0,21129,20632,350
05-11-2021,namakkal,467,41,49,1,458,52319,41,112,0,52472,51512,502
05-11-2021,nilgiris,199,19,7,0,211,33606,19,44,0,33669,33245,213
05-11-2021,perambalur,32,0,3,0,29,12070,0,3,0,12073,11800,244
05-11-2021,pudukottai,121,1,10,0,112,30180,1,35,0,30216,29688,416
05-11-2021,ramanathapuram,31,0,1,0,30,20440,0,135,0,20575,20186,359
05-11-2021,ranipet,101,1,5,0,97,43423,1,49,0,43473,42601,775
05-11-2021,salem,596,56,45,1,606,99692,56,438,0,100186,97892,1688
05-11-2021,sivagangai,126,8,13,0,121,20138,8,108,0,20254,19926,207
05-11-2021,tenkasi,36,5,2,0,39,27313,5,58,0,27376,26852,485
05-11-2021,thanjavur,454,33,43,0,444,75482,33,22,0,75537,74115,978
05-11-2021,theni,28,2,4,0,26,43536,2,45,0,43583,43036,521
05-11-2021,thirupathur,70,4,6,0,68,29206,4,118,0,29328,28635,625
05-11-2021,thiruvallur,366,32,34,0,364,119495,32,10,0,119537,117331,1842
05-11-2021,thiruvannamalai,171,12,21,0,162,54632,12,398,0,55042,54212,668
05-11-2021,thiruvarur,253,19,24,1,247,41515,19,38,0,41572,40878,447
05-11-2021,thoothukudi,126,9,10,0,125,56074,9,275,0,56358,55824,409
05-11-2021,tirunelveli,132,10,8,0,134,48991,10,427,0,49428,48861,433
05-11-2021,tiruppur,736,62,76,0,722,95662,62,11,0,95735,94030,983
05-11-2021,trichy,414,29,36,0,407,77599,29,65,0,77693,76226,1060
05-11-2021,vellore,190,15,12,0,193,48268,15,1664,0,49947,48622,1132
05-11-2021,villupuram,125,11,16,0,120,45730,11,174,0,45915,45439,356
05-11-2021,virudhunagar,54,9,4,0,59,46206,9,104,0,46319,45712,548
05-11-2021,airport surveillance (international),2,0,0,0,2,0,0,1028,0,1028,1025,1
05-11-2021,airport surveillance (domestic),1,0,0,0,1,0,0,1085,0,1085,1083,1
05-11-2021,railway surveillance,0,0,0,0,0,0,0,428,0,428,428,0
06-11-2021,ariyalur,45,1,3,0,43,16849,1,20,0,16870,16566,261
06-11-2021,chengalpattu,894,79,94,0,879,172200,79,5,0,172284,168892,2513
06-11-2021,chennai,1267,122,137,1,1251,555136,122,47,0,555305,545492,8562
06-11-2021,coimbatore,1209,99,126,3,1179,247281,99,51,0,247431,243824,2428
06-11-2021,cuddalore,193,13,21,0,185,63964,13,203,0,64180,63125,870
06-11-2021,dharmapuri,168,18,17,0,169,28284,18,216,0,28518,28073,276
06-11-2021,dindigul,74,6,7,0,73,33042,6,77,0,33125,32405,647
06-11-2021,erode,719,67,61,1,724,104532,67,94,0,104693,103279,690
06-11-2021,kallakurichi,98,5,4,0,99,31013,5,404,0,31422,31113,210
06-11-2021,kancheepuram,331,26,31,0,326,75112,26,4,0,75142,73558,1258
06-11-2021,kanyakumari,204,17,18,0,203,62335,17,124,0,62476,61223,1050
06-11-2021,karur,229,21,20,1,229,24154,21,47,0,24222,23634,359
06-11-2021,krishnagiri,196,9,9,0,196,43407,9,238,0,43654,43108,350
06-11-2021,madurai,141,13,12,0,142,75095,13,173,0,75281,73962,1177
06-11-2021,mayiladuthurai,42,3,5,0,40,23253,3,39,0,23295,22939,316
06-11-2021,nagapattinam,147,7,15,0,139,21076,7,53,0,21136,20647,350
06-11-2021,namakkal,458,39,45,0,452,52360,39,112,0,52511,51557,502
06-11-2021,nilgiris,212,16,10,0,218,33626,16,44,0,33686,33255,213
06-11-2021,perambalur,29,2,2,0,29,12070,2,3,0,12075,11802,244
06-11-2021,pudukottai,112,7,5,0,114,30181,7,35,0,30223,29693,416
06-11-2021,ramanathapuram,30,0,1,0,29,20440,0,135,0,20575,20187,359
06-11-2021,ranipet,96,3,4,0,95,43423,3,49,0,43475,42605,775
06-11-2021,salem,607,54,51,0,610,99749,54,438,0,100241,97943,1688
06-11-2021,sivagangai,121,7,8,0,120,20146,7,108,0,20261,19934,207
06-11-2021,tenkasi,39,2,2,0,39,27318,2,58,0,27378,26854,485
06-11-2021,thanjavur,444,30,39,2,433,75515,30,22,0,75567,74154,980
06-11-2021,theni,26,2,4,0,24,43538,2,45,0,43585,43040,521
06-11-2021,thirupathur,69,3,6,0,66,29211,3,118,0,29332,28641,625
06-11-2021,thiruvallur,366,34,32,0,368,119529,34,10,0,119573,117363,1842
06-11-2021,thiruvannamalai,162,8,23,0,147,54644,8,398,0,55050,54235,668
06-11-2021,thiruvarur,247,16,26,0,237,41534,16,38,0,41588,40904,447
06-11-2021,thoothukudi,125,7,11,0,121,56083,7,275,0,56365,55835,409
06-11-2021,tirunelveli,134,8,6,0,136,49001,8,427,0,49436,48867,433
06-11-2021,tiruppur,732,60,79,0,713,95734,60,11,0,95805,94109,983
06-11-2021,trichy,407,30,38,1,398,77628,30,65,0,77723,76264,1061
06-11-2021,vellore,190,13,16,1,186,48280,13,1664,0,49957,48638,1133
06-11-2021,villupuram,120,9,13,0,116,45741,9,174,0,45924,45452,356
06-11-2021,virudhunagar,59,6,8,0,57,46215,6,104,0,46325,45720,548
06-11-2021,airport surveillance (international),2,0,0,0,2,0,0,1028,0,1028,1025,1
06-11-2021,airport surveillance (domestic),1,0,0,0,1,0,0,1085,0,1085,1083,1
06-11-2021,railway surveillance,0,0,0,0,0,0,0,428,0,428,428,0
07-11-2021,ariyalur,43,4,4,0,43,16850,4,20,0,16874,16570,261
07-11-2021,chengalpattu,877,76,87,0,866,172277,76,5,0,172358,168979,2513
07-11-2021,chennai,1248,129,134,0,1243,555255,129,47,0,555431,545626,8562
07-11-2021,coimbatore,1180,96,112,2,1162,247381,96,51,0,247528,243936,2430
07-11-2021,cuddalore,185,12,16,0,181,63977,12,203,0,64192,63141,870
07-11-2021,dharmapuri,171,16,18,0,169,28304,16,216,0,28536,28091,276
07-11-2021,dindigul,71,4,8,0,67,33046,4,77,0,33127,32413,647
07-11-2021,erode,722,69,52,1,738,104597,69,94,0,104760,103331,691
07-11-2021,kallakurichi,99,6,3,0,102,31018,6,404,0,31428,31116,210
07-11-2021,kancheepuram,328,24,34,0,318,75140,24,4,0,75168,73592,1258
07-11-2021,kanyakumari,203,18,15,0,206,62352,18,124,0,62494,61238,1050
07-11-2021,karur,232,19,11,0,240,24178,19,47,0,24244,23645,359
07-11-2021,krishnagiri,194,12,19,0,187,43414,12,238,0,43664,43127,350
07-11-2021,madurai,141,12,10,1,142,75107,12,173,0,75292,73972,1178
07-11-2021,mayiladuthurai,40,8,6,0,42,23256,8,39,0,23303,22945,316
07-11-2021,nagapattinam,140,6,17,0,129,21084,6,53,0,21143,20664,350
07-11-2021,namakkal,450,37,37,0,450,52397,37,112,0,52546,51594,502
07-11-2021,nilgiris,218,14,14,0,218,33642,14,44,0,33700,33269,213
07-11-2021,perambalur,29,3,5,0,27,12072,3,3,0,12078,11807,244
07-11-2021,pudukottai,113,5,12,0,106,30187,5,35,0,30227,29705,416
07-11-2021,ramanathapuram,29,2,2,0,29,20440,2,135,0,20577,20189,359
07-11-2021,ranipet,97,2,7,0,92,43428,2,49,0,43479,42612,775
07-11-2021,salem,609,52,58,0,603,99802,52,438,0,100292,98001,1688
07-11-2021,sivagangai,119,6,5,1,119,20152,6,108,0,20266,19939,208
07-11-2021,tenkasi,37,1,4,0,34,27318,1,58,0,27377,26858,485
07-11-2021,thanjavur,435,28,42,1,420,75547,28,22,0,75597,74196,981
07-11-2021,theni,24,2,1,0,25,43540,2,45,0,43587,43041,521
07-11-2021,thirupathur,66,4,2,0,68,29214,4,118,0,29336,28643,625
07-11-2021,thiruvallur,372,32,35,0,369,119567,32,10,0,119609,117398,1842
07-11-2021,thiruvannamalai,148,7,16,0,139,54653,7,398,0,55058,54251,668
07-11-2021,thiruvarur,236,14,13,0,237,41549,14,38,0,41601,40917,447
07-11-2021,thoothukudi,120,10,9,0,121,56089,10,275,0,56374,55844,409
07-11-2021,tirunelveli,138,7,10,0,135,49011,7,427,0,49445,48877,433
07-11-2021,tiruppur,714,62,74,0,702,95795,62,11,0,95868,94183,983
07-11-2021,trichy,401,28,41,0,388,77661,28,65,0,77754,76305,1061
07-11-2021,vellore,183,11,12,0,182,48290,11,1664,0,49965,48650,1133
07-11-2021,villupuram,116,8,9,0,115,45750,8,174,0,45932,45461,356
07-11-2021,virudhunagar,57,4,3,0,58,46221,4,104,0,46329,45723,548
07-11-2021,airport surveillance (international),2,0,0,0,2,0,0,1028,0,1028,1025,1
07-11-2021,airport surveillance (domestic),1,0,1,0,0,0,0,1085,0,1085,1084,1
07-11-2021,railway surveillance,0,0,0,0,0,0,0,428,0,428,428,0
08-11-2021,ariyalur,42,5,5,0,42,16853,5,20,0,16878,16575,261
08-11-2021,chengalpattu,872,74,83,1,862,172359,74,5,0,172438,169062,2514
08-11-2021,chennai,1232,126,135,1,1222,555373,126,47,0,555546,545761,8563
08-11-2021,coimbatore,1162,94,109,1,1146,247477,94,51,0,247622,244045,2431
08-11-2021,cuddalore,181,13,19,0,175,63989,13,203,0,64205,63160,870
08-11-2021,dharmapuri,169,15,15,0,169,28320,15,216,0,28551,28106,276
08-11-2021,dindigul,67,7,9,0,65,33050,7,77,0,33134,32422,647
08-11-2021,erode,737,67,48,0,756,104665,67,94,0,104826,103379,691
08-11-2021,kallakurichi,102,7,2,0,107,31024,7,404,0,31435,31118,210
08-11-2021,kancheepuram,318,21,25,1,313,75164,21,4,0,75189,73617,1259
08-11-2021,kanyakumari,206,22,16,0,212,62370,22,124,0,62516,61254,1050
08-11-2021,karur,235,17,14,0,238,24192,17,47,0,24256,23659,359
08-11-2021,krishnagiri,186,13,23,0,176,43425,13,238,0,43676,43150,350
08-11-2021,madurai,141,11,12,0,140,75118,11,173,0,75302,73984,1178
08-11-2021,mayiladuthurai,42,4,4,0,42,23264,4,39,0,23307,22949,316
08-11-2021,nagapattinam,129,7,13,1,122,21090,7,53,0,21150,20677,351
08-11-2021,namakkal,451,38,35,0,454,52435,38,112,0,52585,51629,502
08-11-2021,nilgiris,218,13,18,0,213,33656,13,44,0,33713,33287,213
08-11-2021,perambalur,28,1,6,0,23,12076,1,3,0,12080,11813,244
08-11-2021,pudukottai,107,7,14,0,100,30193,7,35,0,30235,29719,416
08-11-2021,ramanathapuram,29,3,5,0,27,20442,3,135,0,20580,20194,359
08-11-2021,ranipet,93,7,8,0,92,43431,7,49,0,43487,42620,775
08-11-2021,salem,604,50,62,0,592,99855,50,438,0,100343,98063,1688
08-11-2021,sivagangai,119,7,4,0,122,20158,7,108,0,20273,19943,208
08-11-2021,tenkasi,32,1,1,0,32,27317,1,58,0,27376,26859,485
08-11-2021,thanjavur,420,27,34,0,413,75575,27,22,0,75624,74230,981
08-11-2021,theni,25,1,1,0,25,43542,1,45,0,43588,43042,521
08-11-2021,thirupathur,68,5,3,1,69,29218,5,118,0,29341,28646,626
08-11-2021,thiruvallur,373,33,36,0,370,119603,33,10,0,119646,117434,1842
08-11-2021,thiruvannamalai,139,6,10,0,135,54660,6,398,0,55064,54261,668
08-11-2021,thiruvarur,237,16,17,0,236,41563,16,38,0,41617,40934,447
08-11-2021,thoothukudi,124,9,11,0,122,56102,9,275,0,56386,55855,409
08-11-2021,tirunelveli,134,6,13,0,127,49017,6,427,0,49450,48890,433
08-11-2021,tiruppur,705,60,72,0,693,95860,60,11,0,95931,94255,983
08-11-2021,trichy,391,32,37,0,386,77692,32,65,0,77789,76342,1061
08-11-2021,vellore,181,9,9,0,181,48300,9,1664,0,49973,48659,1133
08-11-2021,villupuram,115,6,7,0,114,45758,6,174,0,45938,45468,356
08-11-2021,virudhunagar,58,1,2,0,57,46225,1,104,0,46330,45725,548
08-11-2021,airport surveillance (international),2,0,0,0,2,0,0,1028,0,1028,1025,1
08-11-2021,airport surveillance (domestic),0,0,0,0,0,0,0,1085,0,1085,1084,1
08-11-2021,railway surveillance,0,0,0,0,0,0,0,428,0,428,428,0
09-11-2021,ariyalur,41,2,6,0,37,16857,2,20,0,16879,16581,261
09-11-2021,chengalpattu,863,70,81,0,852,172434,70,5,0,172509,169143,2514
09-11-2021,chennai,1225,131,132,4,1220,555502,131,47,0,555680,545893,8567
09-11-2021,coimbatore,1146,98,105,1,1138,247571,98,51,0,247720,244150,2432
09-11-2021,cuddalore,175,14,16,0,173,64002,14,203,0,64219,63176,870
09-11-2021,dharmapuri,169,13,14,0,168,28335,13,216,0,28564,28120,276
09-11-2021,dindigul,65,6,10,1,60,33057,6,77,0,33140,32432,648
09-11-2021,erode,751,63,51,0,763,104727,63,94,0,104884,103430,691
09-11-2021,kallakurichi,107,6,3,0,110,31031,6,404,0,31441,31121,210
09-11-2021,kancheepuram,312,19,27,1,303,75184,19,4,0,75207,73644,1260
09-11-2021,kanyakumari,212,19,17,0,214,62392,19,124,0,62535,61271,1050
09-11-2021,karur,240,15,18,0,237,24211,15,47,0,24273,23677,359
09-11-2021,krishnagiri,175,9,15,0,169,43437,9,238,0,43684,43165,350
09-11-2021,madurai,140,12,13,0,139,75129,12,173,0,75314,73997,1178
09-11-2021,mayiladuthurai,47,3,7,0,43,23273,3,39,0,23315,22956,316
09-11-2021,nagapattinam,119,9,11,1,116,21094,9,53,0,21156,20688,352
09-11-2021,namakkal,453,39,32,0,460,52472,39,112,0,52623,51661,502
09-11-2021,nilgiris,214,15,19,0,210,33670,15,44,0,33729,33306,213
09-11-2021,perambalur,23,2,4,0,21,12077,2,3,0,12082,11817,244
09-11-2021,pudukottai,97,9,13,1,92,30197,9,35,0,30241,29732,417
09-11-2021,ramanathapuram,27,5,2,0,30,20445,5,135,0,20585,20196,359
09-11-2021,ranipet,92,3,12,0,83,43438,3,49,0,43490,42632,775
09-11-2021,salem,595,48,54,1,588,99908,48,438,0,100394,98117,1689
09-11-2021,sivagangai,122,8,5,0,125,20165,8,108,0,20281,19948,208
09-11-2021,tenkasi,32,2,1,0,33,27318,2,58,0,27378,26860,485
09-11-2021,thanjavur,413,32,36,1,408,75602,32,22,0,75656,74266,982
09-11-2021,theni,25,0,1,0,24,43543,0,45,0,43588,43043,521
09-11-2021,thirupathur,70,4,6,0,68,29224,4,118,0,29346,28652,626
09-11-2021,thiruvallur,367,32,37,1,361,119633,32,10,0,119675,117471,1843
09-11-2021,thiruvannamalai,135,5,8,0,132,54666,5,398,0,55069,54269,668
09-11-2021,thiruvarur,233,14,20,0,227,41576,14,38,0,41628,40954,447
09-11-2021,thoothukudi,122,8,14,0,116,56111,8,275,0,56394,55869,409
09-11-2021,tirunelveli,127,12,9,0,130,49023,12,427,0,49462,48899,433
09-11-2021,tiruppur,696,56,67,0,685,95923,56,11,0,95990,94322,983
09-11-2021,trichy,389,36,39,0,386,77727,36,65,0,77828,76381,1061
09-11-2021,vellore,180,10,7,0,183,48308,10,1664,0,49982,48666,1133
09-11-2021,villupuram,114,3,9,0,108,45764,3,174,0,45941,45477,356
09-11-2021,virudhunagar,57,3,3,0,57,46226,3,104,0,46333,45728,548
09-11-2021,airport surveillance (international),2,0,0,0,2,0,0,1028,0,1028,1025,1
09-11-2021,airport surveillance (domestic),0,0,0,0,0,0,0,1085,0,1085,1084,1
09-11-2021,railway surveillance,0,0,0,0,0,0,0,428,0,428,428,0
10-11-2021,ariyalur,37,3,4,0,36,16859,3,20,0,16882,16585,261
10-11-2021,chengalpattu,854,65,78,1,840,172506,65,5,0,172576,169221,2515
10-11-2021,chennai,1216,127,136,2,1205,555629,127,47,0,555803,546029,8569
10-11-2021,coimbatore,1139,101,107,1,1132,247670,101,51,0,247822,244257,2433
10-11-2021,cuddalore,173,15,19,0,169,64016,15,203,0,64234,63195,870
10-11-2021,dharmapuri,168,14,15,1,166,28348,14,216,0,28578,28135,277
10-11-2021,dindigul,57,5,7,0,55,33060,5,77,0,33142,32439,648
10-11-2021,erode,759,66,54,1,770,104786,66,94,0,104946,103484,692
10-11-2021,kallakurichi,110,8,5,0,113,31037,8,404,0,31449,31126,210
10-11-2021,kancheepuram,305,18,24,0,299,75205,18,4,0,75227,73668,1260
10-11-2021,kanyakumari,214,15,16,0,213,62411,15,124,0,62550,61287,1050
10-11-2021,karur,236,19,20,1,234,24225,19,47,0,24291,23697,360
10-11-2021,krishnagiri,169,10,17,0,162,43446,10,238,0,43694,43182,350
10-11-2021,madurai,135,11,11,0,135,75137,11,173,0,75321,74008,1178
10-11-2021,mayiladuthurai,44,2,5,0,41,23277,2,39,0,23318,22961,316
10-11-2021,nagapattinam,117,11,13,0,115,21104,11,53,0,21168,20701,352
10-11-2021,namakkal,460,42,34,0,468,52511,42,112,0,52665,51695,502
10-11-2021,nilgiris,210,14,16,0,208,33685,14,44,0,33743,33322,213
10-11-2021,perambalur,21,1,2,0,20,12079,1,3,0,12083,11819,244
10-11-2021,pudukottai,92,7,12,0,87,30206,7,35,0,30248,29744,417
10-11-2021,ramanathapuram,30,2,3,0,29,20450,2,135,0,20587,20199,359
10-11-2021,ranipet,83,5,10,0,78,43441,5,49,0,43495,42642,775
10-11-2021,salem,588,47,47,0,588,99956,47,438,0,100441,98164,1689
10-11-2021,sivagangai,125,7,9,0,123,20173,7,108,0,20288,19957,208
10-11-2021,tenkasi,33,1,2,0,32,27320,1,58,0,27379,26862,485
10-11-2021,thanjavur,408,27,38,0,397,75634,27,22,0,75683,74304,982
10-11-2021,theni,25,1,1,0,25,43544,1,45,0,43590,43044,521
10-11-2021,thirupathur,68,3,8,0,63,29228,3,118,0,29349,28660,626
10-11-2021,thiruvallur,359,29,32,0,356,119663,29,10,0,119702,117503,1843
10-11-2021,thiruvannamalai,132,6,6,0,132,54671,6,398,0,55075,54275,668
10-11-2021,thiruvarur,227,17,21,2,221,41590,17,38,0,41645,40975,449
10-11-2021,thoothukudi,117,7,18,0,106,56120,7,275,0,56402,55887,409
10-11-2021,tirunelveli,130,15,14,0,131,49035,15,427,0,49477,48913,433
10-11-2021,tiruppur,693,52,61,0,684,95987,52,11,0,96050,94383,983
10-11-2021,trichy,386,38,43,0,381,77763,38,65,0,77866,76424,1061
10-11-2021,vellore,184,8,11,0,181,48319,8,1664,0,49991,48677,1133
10-11-2021,villupuram,108,2,7,0,103,45767,2,174,0,45943,45484,356
10-11-2021,virudhunagar,57,7,5,0,59,46229,7,104,0,46340,45733,548
10-11-2021,airport surveillance (international),2,0,0,0,2,0,0,1028,0,1028,1025,1
10-11-2021,airport surveillance (domestic),0,0,0,0,0,0,0,1085,0,1085,1084,1
10-11-2021,railway surveillance,0,0,0,0,0,0,0,428,0,428,428,0
11-11-2021,ariyalur,36,4,6,0,34,16862,4,20,0,16886,16591,261
11-11-2021,chengalpattu,840,63,73,0,830,172571,63,5,0,172639,169294,2515
11-11-2021,chennai,1205,125,129,1,1200,555756,125,47,0,555928,546158,8570
11-11-2021,coimbatore,1134,109,112,0,1131,247773,109,51,0,247933,244369,2433
11-11-2021,cuddalore,169,14,17,0,166,64031,14,203,0,64248,63212,870
11-11-2021,dharmapuri,166,13,12,0,167,28362,13,216,0,28591,28147,277
11-11-2021,dindigul,55,3,4,0,54,33065,3,77,0,33145,32443,648
11-11-2021,erode,765,68,57,0,776,104847,68,94,0,105009,103541,692
11-11-2021,kallakurichi,114,10,7,0,117,31046,10,404,0,31460,31133,210
11-11-2021,kancheepuram,299,20,21,1,297,75223,20,4,0,75247,73689,1261
11-11-2021,kanyakumari,213,14,18,0,209,62426,14,124,0,62564,61305,1050
11-11-2021,karur,234,18,23,0,229,24244,18,47,0,24309,23720,360
11-11-2021,krishnagiri,161,11,20,0,152,43455,11,238,0,43704,43202,350
11-11-2021,madurai,135,12,13,0,134,75148,12,173,0,75333,74021,1178
11-11-2021,mayiladuthurai,41,2,3,0,40,23279,2,39,0,23320,22964,316
11-11-2021,nagapattinam,115,10,15,0,110,21115,10,53,0,21178,20716,352
11-11-2021,namakkal,469,40,36,0,473,52554,40,112,0,52706,51731,502
11-11-2021,nilgiris,208,15,19,0,204,33699,15,44,0,33758,33341,213
11-11-2021,perambalur,20,3,1,0,22,12080,3,3,0,12086,11820,244
11-11-2021,pudukottai,88,5,11,0,82,30214,5,35,0,30254,29755,417
11-11-2021,ramanathapuram,30,1,5,0,26,20453,1,135,0,20589,20204,359
11-11-2021,ranipet,78,2,14,0,66,43446,2,49,0,43497,42656,775
11-11-2021,salem,588,46,49,0,585,100003,46,438,0,100487,98213,1689
11-11-2021,sivagangai,122,6,15,0,113,20179,6,108,0,20293,19972,208
11-11-2021,tenkasi,32,0,2,0,30,27321,0,58,0,27379,26864,485
11-11-2021,thanjavur,396,29,37,0,388,75660,29,22,0,75711,74341,982
11-11-2021,theni,25,0,2,0,23,43545,0,45,0,43590,43046,521
11-11-2021,thirupathur,63,1,6,0,58,29231,1,118,0,29350,28666,626
11-11-2021,thiruvallur,356,28,34,0,350,119692,28,10,0,119730,117537,1843
11-11-2021,thiruvannamalai,132,3,14,0,121,54677,3,398,0,55078,54289,668
11-11-2021,thiruvarur,221,18,22,1,216,41607,18,38,0,41663,40997,450
11-11-2021,thoothukudi,105,5,9,0,101,56126,5,275,0,56406,55896,409
11-11-2021,tirunelveli,132,14,16,0,130,49051,14,427,0,49492,48929,433
11-11-2021,tiruppur,685,51,63,0,673,96040,51,11,0,96102,94446,983
11-11-2021,trichy,382,40,45,1,376,77802,40,65,0,77907,76469,1062
11-11-2021,vellore,181,10,14,0,177,48327,10,1664,0,50001,48691,1133
11-11-2021,villupuram,103,3,10,0,96,45769,3,174,0,45946,45494,356
11-11-2021,virudhunagar,59,4,8,0,55,46236,4,104,0,46344,45741,548
11-11-2021,airport surveillance (international),2,0,0,0,2,0,0,1028,0,1028,1025,1
11-11-2021,airport surveillance (domestic),0,0,0,0,0,0,0,1085,0,1085,1084,1
11-11-2021,railway surveillance,0,0,0,0,0,0,0,428,0,428,428,0
12-11-2021,ariyalur,33,5,4,0,34,16865,5,20,0,16890,16595,261
12-11-2021,chengalpattu,830,59,67,1,821,172634,59,5,0,172698,169361,2516
12-11-2021,chennai,1203,114,112,0,1205,555884,114,47,0,556045,546270,8570
12-11-2021,coimbatore,1133,108,106,1,1134,247883,108,51,0,248042,244475,2433
12-11-2021,cuddalore,165,13,15,0,163,64044,13,203,0,64260,63227,870
12-11-2021,dharmapuri,166,15,13,0,168,28374,15,216,0,28605,28160,277
12-11-2021,dindigul,52,4,2,0,54,33067,4,77,0,33148,32445,649
12-11-2021,erode,771,71,59,0,783,104910,71,94,0,105075,103600,692
12-11-2021,kallakurichi,117,12,12,0,117,31056,12,404,0,31472,31145,210
12-11-2021,kancheepuram,297,19,23,0,293,75243,19,4,0,75266,73712,1261
12-11-2021,kanyakumari,209,16,16,0,209,62440,16,124,0,62580,61321,1050
12-11-2021,karur,231,17,21,0,227,24264,17,47,0,24328,23741,360
12-11-2021,krishnagiri,152,8,18,0,142,43466,8,238,0,43712,43220,350
12-11-2021,madurai,134,11,14,0,131,75160,11,173,0,75344,74035,1178
12-11-2021,mayiladuthurai,41,0,5,0,36,23282,0,39,0,23321,22969,316
12-11-2021,nagapattinam,111,8,12,0,107,21126,8,53,0,21187,20728,352
12-11-2021,namakkal,471,38,39,1,469,52592,38,112,0,52742,51770,503
12-11-2021,nilgiris,204,17,24,0,197,33714,17,44,0,33775,33365,213
12-11-2021,perambalur,22,3,3,0,22,12083,3,3,0,12089,11823,244
12-11-2021,pudukottai,82,4,8,0,78,30219,4,35,0,30258,29763,417
12-11-2021,ramanathapuram,26,2,6,0,22,20454,2,135,0,20591,20210,359
12-11-2021,ranipet,66,1,10,0,57,43448,1,49,0,43498,42666,775
12-11-2021,salem,586,44,52,0,578,100050,44,438,0,100532,98265,1689
12-11-2021,sivagangai,113,8,16,0,105,20185,8,108,0,20301,19988,208
12-11-2021,tenkasi,29,0,1,0,28,27320,0,58,0,27378,26865,485
12-11-2021,thanjavur,388,27,34,1,380,75689,27,22,0,75738,74375,983
12-11-2021,theni,23,0,2,0,21,43545,0,45,0,43590,43048,521
12-11-2021,thirupathur,58,3,9,0,52,29232,3,118,0,29353,28675,626
12-11-2021,thiruvallur,346,26,30,0,342,119716,26,10,0,119752,117567,1843
12-11-2021,thiruvannamalai,122,4,11,0,115,54681,4,398,0,55083,54300,668
12-11-2021,thiruvarur,215,15,19,0,211,41624,15,38,0,41677,41016,450
12-11-2021,thoothukudi,102,7,8,0,101,56132,7,275,0,56414,55904,409
12-11-2021,tirunelveli,130,16,17,0,129,49065,16,427,0,49508,48946,433
12-11-2021,tiruppur,676,52,64,2,662,96094,52,11,0,96157,94510,985
12-11-2021,trichy,379,39,48,2,368,77845,39,65,0,77949,76517,1064
12-11-2021,vellore,177,12,16,0,173,48337,12,1664,0,50013,48707,1133
12-11-2021,villupuram,96,5,7,0,94,45772,5,174,0,45951,45501,356
12-11-2021,virudhunagar,55,8,4,0,59,46240,8,104,0,46352,45745,548
12-11-2021,airport surveillance (international),2,1,0,0,3,0,0,1028,1,1029,1025,1
12-11-2021,airport surveillance (domestic),0,0,0,0,0,0,0,1085,0,1085,1084,1
12-11-2021,railway surveillance,0,0,0,0,0,0,0,428,0,428,428,0
13-11-2021,ariyalur,35,2,2,1,34,16871,2,20,0,16893,16597,262
13-11-2021,chengalpattu,822,65,66,3,818,172694,65,5,0,172764,169427,2519
13-11-2021,chennai,1206,120,103,3,1220,555999,120,47,0,556166,546373,8573
13-11-2021,coimbatore,1135,134,109,2,1158,247992,134,51,0,248177,244584,2435
13-11-2021,cuddalore,163,12,17,0,158,64057,12,203,0,64272,63244,870
13-11-2021,dharmapuri,168,17,14,0,171,28389,17,216,0,28622,28174,277
13-11-2021,dindigul,55,3,5,0,53,33072,3,77,0,33152,32450,649
13-11-2021,erode,784,76,61,0,799,104982,76,94,0,105152,103661,692
13-11-2021,kallakurichi,117,11,15,0,113,31068,11,404,0,31483,31160,210
13-11-2021,kancheepuram,292,17,19,0,290,75261,17,4,0,75282,73731,1261
13-11-2021,kanyakumari,209,15,22,0,202,62456,15,124,0,62595,61343,1050
13-11-2021,karur,225,16,24,0,217,24279,16,47,0,24342,23765,360
13-11-2021,krishnagiri,142,4,13,0,133,43474,4,238,0,43716,43233,350
13-11-2021,madurai,131,8,9,1,129,75171,8,173,0,75352,74044,1179
13-11-2021,mayiladuthurai,36,0,3,0,33,23282,0,39,0,23321,22972,316
13-11-2021,nagapattinam,108,7,14,0,101,21135,7,53,0,21195,20742,352
13-11-2021,namakkal,467,37,42,0,462,52628,37,112,0,52777,51812,503
13-11-2021,nilgiris,197,15,21,0,191,33731,15,44,0,33790,33386,213
13-11-2021,perambalur,22,0,1,0,21,12086,0,3,0,12089,11824,244
13-11-2021,pudukottai,77,5,11,0,71,30222,5,35,0,30262,29774,417
13-11-2021,ramanathapuram,22,1,4,0,19,20456,1,135,0,20592,20214,359
13-11-2021,ranipet,57,2,8,0,51,43449,2,49,0,43500,42674,775
13-11-2021,salem,580,43,46,1,576,100096,43,438,0,100577,98311,1690
13-11-2021,sivagangai,105,9,14,0,100,20193,9,108,0,20310,20002,208
13-11-2021,tenkasi,28,0,2,0,26,27320,0,58,0,27378,26867,485
13-11-2021,thanjavur,380,25,37,0,368,75716,25,22,0,75763,74412,983
13-11-2021,theni,21,1,4,0,18,43545,1,45,0,43591,43052,521
13-11-2021,thirupathur,51,1,10,0,42,29234,1,118,0,29353,28685,626
13-11-2021,thiruvallur,341,25,27,0,339,119741,25,10,0,119776,117594,1843
13-11-2021,thiruvannamalai,115,6,16,0,105,54685,6,398,0,55089,54316,668
13-11-2021,thiruvarur,210,14,20,1,203,41638,14,38,0,41690,41036,451
13-11-2021,thoothukudi,101,3,13,0,91,56139,3,275,0,56417,55917,409
13-11-2021,tirunelveli,129,11,18,0,122,49081,11,427,0,49519,48964,433
13-11-2021,tiruppur,663,51,64,0,650,96147,51,11,0,96209,94574,985
13-11-2021,trichy,367,41,36,1,371,77883,41,65,0,77989,76553,1065
13-11-2021,vellore,172,7,26,1,152,48348,7,1664,0,50019,48733,1134
13-11-2021,villupuram,95,3,12,0,86,45778,3,174,0,45955,45513,356
13-11-2021,virudhunagar,59,2,6,0,55,46248,2,104,0,46354,45751,548
13-11-2021,airport surveillance (international),3,0,0,0,3,0,0,1029,0,1029,1025,1
13-11-2021,airport surveillance (domestic),0,0,0,0,0,0,0,1085,0,1085,1084,1
13-11-2021,railway surveillance,0,0,0,0,0,0,0,428,0,428,428,0
14-11-2021,ariyalur,35,3,3,0,35,16874,3,20,0,16897,16600,262
14-11-2021,chengalpattu,818,63,68,2,811,172759,63,5,0,172827,169495,2521
14-11-2021,chennai,1222,128,104,1,1245,556121,128,47,0,556296,546477,8574
14-11-2021,coimbatore,1158,125,112,2,1169,248126,125,51,0,248302,244696,2437
14-11-2021,cuddalore,158,11,15,0,154,64069,11,203,0,64283,63259,870
14-11-2021,dharmapuri,172,12,16,1,167,28407,12,216,0,28635,28190,278
14-11-2021,dindigul,53,2,4,0,51,33075,2,77,0,33154,32454,649
14-11-2021,erode,771,78,65,0,784,105030,78,94,0,105202,103726,692
14-11-2021,kallakurichi,113,10,12,0,111,31079,10,404,0,31493,31172,210
14-11-2021,kancheepuram,290,19,21,0,288,75278,19,4,0,75301,73752,1261
14-11-2021,kanyakumari,203,12,19,1,195,62472,12,124,0,62608,61362,1051
14-11-2021,karur,217,14,26,0,205,24295,14,47,0,24356,23791,360
14-11-2021,krishnagiri,134,6,10,0,130,43479,6,238,0,43723,43243,350
14-11-2021,madurai,129,7,8,0,128,75179,7,173,0,75359,74052,1179
14-11-2021,mayiladuthurai,34,2,2,0,34,23283,2,39,0,23324,22974,316
14-11-2021,nagapattinam,101,6,11,0,96,21142,6,53,0,21201,20753,352
14-11-2021,namakkal,472,36,44,0,464,52675,36,112,0,52823,51856,503
14-11-2021,nilgiris,191,19,18,0,192,33746,19,44,0,33809,33404,213
14-11-2021,perambalur,21,0,1,0,20,12086,0,3,0,12089,11825,244
14-11-2021,pudukottai,70,7,9,0,68,30226,7,35,0,30268,29783,417
14-11-2021,ramanathapuram,19,2,2,0,19,20457,2,135,0,20594,20216,359
14-11-2021,ranipet,51,3,6,0,48,43451,3,49,0,43503,42680,775
14-11-2021,salem,579,40,49,1,569,100142,40,438,0,100620,98360,1691
14-11-2021,sivagangai,100,8,14,0,94,20202,8,108,0,20318,20016,208
14-11-2021,tenkasi,26,1,1,0,26,27320,1,58,0,27379,26868,485
14-11-2021,thanjavur,364,28,41,0,351,75737,28,22,0,75787,74453,983
14-11-2021,theni,16,0,3,0,13,43544,0,45,0,43589,43055,521
14-11-2021,thirupathur,42,2,7,0,37,29235,2,118,0,29355,28692,626
14-11-2021,thiruvallur,338,28,28,0,338,119765,28,10,0,119803,117622,1843
14-11-2021,thiruvannamalai,105,4,13,0,96,54691,4,398,0,55093,54329,668
14-11-2021,thiruvarur,204,13,22,0,195,41653,13,38,0,41704,41058,451
14-11-2021,thoothukudi,92,7,10,0,89,56143,7,275,0,56425,55927,409
14-11-2021,tirunelveli,121,9,14,0,116,49091,9,427,0,49527,48978,433
14-11-2021,tiruppur,660,48,73,1,634,96208,48,11,0,96267,94647,986
14-11-2021,trichy,375,38,39,2,372,77928,38,65,0,78031,76592,1067
14-11-2021,vellore,153,8,25,0,136,48356,8,1664,0,50028,48758,1134
14-11-2021,villupuram,86,1,9,0,78,45781,1,174,0,45956,45522,356
14-11-2021,virudhunagar,55,5,5,0,55,46250,5,104,0,46359,45756,548
14-11-2021,airport surveillance (international),3,0,0,0,3,0,0,1029,0,1029,1025,1
14-11-2021,airport surveillance (domestic),0,0,0,0,0,0,0,1085,0,1085,1084,1
14-11-2021,railway surveillance,0,0,0,0,0,0,0,428,0,428,428,0
15-11-2021,ariyalur,35,2,2,0,35,16877,2,20,0,16899,16602,262
15-11-2021,chengalpattu,812,62,74,0,800,172823,62,5,0,172890,169569,2521
15-11-2021,chennai,1235,122,98,4,1255,556239,122,47,0,556408,546575,8578
15-11-2021,coimbatore,1170,123,116,2,1175,248252,123,51,0,248426,244812,2439
15-11-2021,cuddalore,155,10,17,0,148,64081,10,203,0,64294,63276,870
15-11-2021,dharmapuri,167,17,14,0,170,28419,17,216,0,28652,28204,278
15-11-2021,dindigul,51,6,5,0,52,33077,6,77,0,33160,32459,649
15-11-2021,erode,779,77,68,0,788,105103,77,94,0,105274,103794,692
15-11-2021,kallakurichi,111,9,15,0,105,31089,9,404,0,31502,31187,210
15-11-2021,kancheepuram,289,18,23,0,284,75298,18,4,0,75320,73775,1261
15-11-2021,kanyakumari,195,13,21,0,187,62484,13,124,0,62621,61383,1051
15-11-2021,karur,206,13,25,1,193,24310,13,47,0,24370,23816,361
15-11-2021,krishnagiri,130,7,12,0,125,43485,7,238,0,43730,43255,350
15-11-2021,madurai,129,13,10,0,132,75187,13,173,0,75373,74062,1179
15-11-2021,mayiladuthurai,34,1,5,0,30,23285,1,39,0,23325,22979,316
15-11-2021,nagapattinam,97,5,9,0,93,21149,5,53,0,21207,20762,352
15-11-2021,namakkal,466,35,38,0,463,52713,35,112,0,52860,51894,503
15-11-2021,nilgiris,192,21,20,0,193,33765,21,44,0,33830,33424,213
15-11-2021,perambalur,20,0,1,0,19,12086,0,3,0,12089,11826,244
15-11-2021,pudukottai,69,6,8,0,67,30234,6,35,0,30275,29791,417
15-11-2021,ramanathapuram,19,2,1,0,20,20459,2,135,0,20596,20217,359
15-11-2021,ranipet,49,1,10,0,40,43455,1,49,0,43505,42690,775
15-11-2021,salem,569,39,53,1,554,100182,39,438,0,100659,98413,1692
15-11-2021,sivagangai,92,7,11,0,88,20208,7,108,0,20323,20027,208
15-11-2021,tenkasi,27,0,6,0,21,27322,0,58,0,27380,26874,485
15-11-2021,thanjavur,351,27,35,1,342,75765,27,22,0,75814,74488,984
15-11-2021,theni,13,3,3,0,13,43544,3,45,0,43592,43058,521
15-11-2021,thirupathur,39,1,5,0,35,29239,1,118,0,29358,28697,626
15-11-2021,thiruvallur,341,27,34,0,334,119796,27,10,0,119833,117656,1843
15-11-2021,thiruvannamalai,97,5,16,0,86,54696,5,398,0,55099,54345,668
15-11-2021,thiruvarur,194,17,22,1,188,41665,17,38,0,41720,41080,452
15-11-2021,thoothukudi,89,6,13,0,82,56150,6,275,0,56431,55940,409
15-11-2021,tirunelveli,115,8,7,0,116,49099,8,427,0,49534,48985,433
15-11-2021,tiruppur,636,49,61,1,623,96258,49,11,0,96318,94708,987
15-11-2021,trichy,372,37,31,1,377,77966,37,65,0,78068,76623,1068
15-11-2021,vellore,134,7,18,0,123,48362,7,1664,0,50033,48776,1134
15-11-2021,villupuram,79,3,7,0,75,45783,3,174,0,45960,45529,356
15-11-2021,virudhunagar,55,1,4,0,52,46255,1,104,0,46360,45760,548
15-11-2021,airport surveillance (international),3,2,0,0,5,0,0,1029,2,1031,1025,1
15-11-2021,airport surveillance (domestic),0,0,0,0,0,0,0,1085,0,1085,1084,1
15-11-2021,railway surveillance,0,0,0,0,0,0,0,428,0,428,428,0
16-11-2021,ariyalur,35,2,3,0,34,16879,2,20,0,16901,16605,262
16-11-2021,chengalpattu,801,63,76,1,787,172886,63,5,0,172954,169645,2522
16-11-2021,chennai,1254,120,102,2,1270,556360,120,47,0,556527,546677,8580
16-11-2021,coimbatore,1178,118,110,1,1185,248378,118,51,0,248547,244922,2440
16-11-2021,cuddalore,147,11,15,1,142,64090,11,203,0,64304,63291,871
16-11-2021,dharmapuri,170,16,18,0,168,28436,16,216,0,28668,28222,278
16-11-2021,dindigul,52,7,6,1,52,33083,7,77,0,33167,32465,650
16-11-2021,erode,781,75,72,1,783,105173,75,94,0,105342,103866,693
16-11-2021,kallakurichi,105,8,16,0,97,31098,8,404,0,31510,31203,210
16-11-2021,kancheepuram,284,17,25,1,275,75316,17,4,0,75337,73800,1262
16-11-2021,kanyakumari,187,17,20,1,183,62497,17,124,0,62638,61403,1052
16-11-2021,karur,194,14,19,0,189,24324,14,47,0,24385,23835,361
16-11-2021,krishnagiri,126,5,14,1,116,43493,5,238,0,43736,43269,351
16-11-2021,madurai,132,15,12,0,135,75200,15,173,0,75388,74074,1179
16-11-2021,mayiladuthurai,31,5,4,0,32,23287,5,39,0,23331,22983,316
16-11-2021,nagapattinam,92,7,10,0,89,21153,7,53,0,21213,20772,352
16-11-2021,namakkal,465,32,41,0,456,52750,32,112,0,52894,51935,503
16-11-2021,nilgiris,193,20,23,0,190,33786,20,44,0,33850,33447,213
16-11-2021,perambalur,19,0,2,0,17,12086,0,3,0,12089,11828,244
16-11-2021,pudukottai,67,8,5,0,70,30240,8,35,0,30283,29796,417
16-11-2021,ramanathapuram,20,1,1,0,20,20461,1,135,0,20597,20218,359
16-11-2021,ranipet,40,3,7,0,36,43456,3,49,0,43508,42697,775
16-11-2021,salem,556,38,48,0,546,100223,38,438,0,100699,98461,1692
16-11-2021,sivagangai,88,6,9,0,85,20215,6,108,0,20329,20036,208
16-11-2021,tenkasi,21,0,3,0,18,27322,0,58,0,27380,26877,485
16-11-2021,thanjavur,342,26,30,0,338,75792,26,22,0,75840,74518,984
16-11-2021,theni,13,3,2,0,14,43547,3,45,0,43595,43060,521
16-11-2021,thirupathur,34,1,4,0,31,29239,1,118,0,29358,28701,626
16-11-2021,thiruvallur,335,21,35,0,321,119824,21,10,0,119855,117691,1843
16-11-2021,thiruvannamalai,86,7,13,1,79,54701,7,398,0,55106,54358,669
16-11-2021,thiruvarur,188,16,21,2,181,41682,16,38,0,41736,41101,454
16-11-2021,thoothukudi,81,5,10,0,76,56155,5,275,0,56435,55950,409
16-11-2021,tirunelveli,117,7,8,0,116,49108,7,427,0,49542,48993,433
16-11-2021,tiruppur,622,47,63,0,606,96306,47,11,0,96364,94771,987
16-11-2021,trichy,378,36,34,2,378,78004,36,65,0,78105,76657,1070
16-11-2021,vellore,122,8,15,0,115,48368,8,1664,0,50040,48791,1134
16-11-2021,villupuram,75,1,11,0,65,45786,1,174,0,45961,45540,356
16-11-2021,virudhunagar,52,3,6,0,49,46256,3,104,0,46363,45766,548
16-11-2021,airport surveillance (international),5,0,0,0,5,0,0,1031,0,1031,1025,1
16-11-2021,airport surveillance (domestic),0,0,0,0,0,0,0,1085,0,1085,1084,1
16-11-2021,railway surveillance,0,0,0,0,0,0,0,428,0,428,428,0
17-11-2021,ariyalur,35,1,2,0,34,16882,1,20,0,16903,16607,262
17-11-2021,chengalpattu,783,61,72,3,769,172945,61,5,0,173011,169717,2525
17-11-2021,chennai,1276,116,105,1,1286,556486,116,47,0,556649,546782,8581
17-11-2021,coimbatore,1185,115,113,2,1185,248496,115,51,0,248662,245035,2442
17-11-2021,cuddalore,143,10,13,0,140,64102,10,203,0,64315,63304,871
17-11-2021,dharmapuri,168,12,15,0,165,28452,12,216,0,28680,28237,278
17-11-2021,dindigul,51,9,8,0,52,33089,9,77,0,33175,32473,650
17-11-2021,erode,779,72,74,0,777,105244,72,94,0,105410,103940,693
17-11-2021,kallakurichi,97,6,11,0,92,31106,6,404,0,31516,31214,210
17-11-2021,kancheepuram,275,21,23,0,273,75333,21,4,0,75358,73823,1262
17-11-2021,kanyakumari,183,12,19,1,175,62514,12,124,0,62650,61422,1053
17-11-2021,karur,189,15,17,0,187,24338,15,47,0,24400,23852,361
17-11-2021,krishnagiri,117,6,16,0,107,43499,6,238,0,43743,43285,351
17-11-2021,madurai,135,13,14,0,134,75215,13,173,0,75401,74088,1179
17-11-2021,mayiladuthurai,34,2,3,0,33,23294,2,39,0,23335,22986,316
17-11-2021,nagapattinam,90,9,9,1,89,21161,9,53,0,21223,20781,353
17-11-2021,namakkal,459,36,43,0,452,52785,36,112,0,52933,51978,503
17-11-2021,nilgiris,190,18,21,0,187,33806,18,44,0,33868,33468,213
17-11-2021,perambalur,17,3,1,0,19,12086,3,3,0,12092,11829,244
17-11-2021,pudukottai,71,6,4,0,73,30249,6,35,0,30290,29800,417
17-11-2021,ramanathapuram,20,2,1,0,21,20462,2,135,0,20599,20219,359
17-11-2021,ranipet,36,5,5,0,36,43459,5,49,0,43513,42702,775
17-11-2021,salem,545,41,51,2,533,100260,41,438,0,100739,98512,1694
17-11-2021,sivagangai,85,5,7,0,83,20221,5,108,0,20334,20043,208
17-11-2021,tenkasi,17,0,2,0,15,27321,0,58,0,27379,26879,485
17-11-2021,thanjavur,331,23,34,0,320,75811,23,22,0,75856,74552,984
17-11-2021,theni,14,0,2,0,12,43550,0,45,0,43595,43062,521
17-11-2021,thirupathur,31,2,3,0,30,29240,2,118,0,29360,28704,626
17-11-2021,thiruvallur,320,20,37,0,303,119844,20,10,0,119874,117728,1843
17-11-2021,thiruvannamalai,80,10,10,0,80,54709,10,398,0,55117,54368,669
17-11-2021,thiruvarur,182,14,20,1,175,41699,14,38,0,41751,41121,455
17-11-2021,thoothukudi,76,6,8,0,74,56160,6,275,0,56441,55958,409
17-11-2021,tirunelveli,116,9,6,0,119,49115,9,427,0,49551,48999,433
17-11-2021,tiruppur,608,50,67,0,591,96355,50,11,0,96416,94838,987
17-11-2021,trichy,378,33,36,0,375,78040,33,65,0,78138,76693,1070
17-11-2021,vellore,113,11,18,2,104,48374,11,1664,0,50049,48809,1136
17-11-2021,villupuram,65,3,12,0,56,45787,3,174,0,45964,45552,356
17-11-2021,virudhunagar,50,5,5,0,50,46260,5,104,0,46369,45771,548
17-11-2021,airport surveillance (international),5,0,0,0,5,0,0,1031,0,1031,1025,1
17-11-2021,airport surveillance (domestic),0,0,0,0,0,0,0,1085,0,1085,1084,1
17-11-2021,railway surveillance,0,0,0,0,0,0,0,428,0,428,428,0
18-11-2021,ariyalur,34,3,3,0,34,16883,3,20,0,16906,16610,262
18-11-2021,chengalpattu,776,58,76,1,757,173013,58,5,0,173076,169793,2526
18-11-2021,chennai,1270,126,107,3,1286,556586,126,47,0,556759,546889,8584
18-11-2021,coimbatore,1185,112,116,1,1180,248611,112,51,0,248774,245151,2443
18-11-2021,cuddalore,139,9,11,0,137,64111,9,203,0,64323,63315,871
18-11-2021,dharmapuri,165,11,18,0,158,28464,11,216,0,28691,28255,278
18-11-2021,dindigul,52,7,4,0,55,33098,7,77,0,33182,32477,650
18-11-2021,erode,776,76,61,0,791,105315,76,94,0,105485,104001,693
18-11-2021,kallakurichi,92,7,7,0,92,31112,7,404,0,31523,31221,210
18-11-2021,kancheepuram,274,18,28,0,264,75355,18,4,0,75377,73851,1262
18-11-2021,kanyakumari,175,13,15,1,172,62526,13,124,0,62663,61437,1054
18-11-2021,karur,189,16,19,0,186,24355,16,47,0,24418,23871,361
18-11-2021,krishnagiri,106,5,12,0,99,43504,5,238,0,43747,43297,351
18-11-2021,madurai,134,12,16,0,130,75228,12,173,0,75413,74104,1179
18-11-2021,mayiladuthurai,34,0,5,0,29,23297,0,39,0,23336,22991,316
18-11-2021,nagapattinam,88,7,7,1,87,21169,7,53,0,21229,20788,354
18-11-2021,namakkal,452,33,47,1,437,52821,33,112,0,52966,52025,504
18-11-2021,nilgiris,187,17,20,0,184,33824,17,44,0,33885,33488,213
18-11-2021,perambalur,19,1,2,0,18,12089,1,3,0,12093,11831,244
18-11-2021,pudukottai,74,4,6,0,72,30256,4,35,0,30295,29806,417
18-11-2021,ramanathapuram,21,4,1,0,24,20464,4,135,0,20603,20220,359
18-11-2021,ranipet,37,3,3,0,37,43465,3,49,0,43517,42705,775
18-11-2021,salem,537,43,55,0,525,100305,43,438,0,100786,98567,1694
18-11-2021,sivagangai,83,7,9,0,81,20226,7,108,0,20341,20052,208
18-11-2021,tenkasi,15,1,2,0,14,27321,1,58,0,27380,26881,485
18-11-2021,thanjavur,319,27,36,0,310,75833,27,22,0,75882,74588,984
18-11-2021,theni,12,0,1,0,11,43550,0,45,0,43595,43063,521
18-11-2021,thirupathur,32,2,5,0,29,29244,2,118,0,29364,28709,626
18-11-2021,thiruvallur,308,25,34,1,298,119869,25,10,0,119904,117762,1844
18-11-2021,thiruvannamalai,81,8,13,0,76,54720,8,398,0,55126,54381,669
18-11-2021,thiruvarur,176,13,17,2,170,41714,13,38,0,41765,41138,457
18-11-2021,thoothukudi,74,5,6,0,73,56166,5,275,0,56446,55964,409
18-11-2021,tirunelveli,119,6,8,0,117,49124,6,427,0,49557,49007,433
18-11-2021,tiruppur,590,51,64,0,577,96404,51,11,0,96466,94902,987
18-11-2021,trichy,375,32,31,0,376,78073,32,65,0,78170,76724,1070
18-11-2021,vellore,100,10,14,1,95,48381,10,1664,0,50055,48823,1137
18-11-2021,villupuram,56,1,10,0,47,45790,1,174,0,45965,45562,356
18-11-2021,virudhunagar,50,2,6,0,46,46265,2,104,0,46371,45777,548
18-11-2021,airport surveillance (international),5,0,1,0,4,0,0,1031,0,1031,1026,1
18-11-2021,airport surveillance (domestic),0,0,0,0,0,0,0,1085,0,1085,1084,1
18-11-2021,railway surveillance,0,0,0,0,0,0,0,428,0,428,428,0
19-11-2021,ariyalur,34,3,2,0,35,16886,3,20,0,16909,16612,262
19-11-2021,chengalpattu,754,59,79,0,734,173068,59,5,0,173132,169872,2526
19-11-2021,chennai,1290,120,104,1,1305,556716,120,47,0,556883,546993,8585
19-11-2021,coimbatore,1180,119,118,2,1179,248723,119,51,0,248893,245269,2445
19-11-2021,cuddalore,138,8,10,0,136,64121,8,203,0,64332,63325,871
19-11-2021,dharmapuri,158,10,14,0,154,28475,10,216,0,28701,28269,278
19-11-2021,dindigul,55,2,3,0,54,33105,2,77,0,33184,32480,650
19-11-2021,erode,784,74,65,1,792,105384,74,94,0,105552,104066,694
19-11-2021,kallakurichi,92,5,6,0,91,31119,5,404,0,31528,31227,210
19-11-2021,kancheepuram,263,16,29,0,250,75372,16,4,0,75392,73880,1262
19-11-2021,kanyakumari,172,12,16,0,168,62539,12,124,0,62675,61453,1054
19-11-2021,karur,186,15,18,0,183,24371,15,47,0,24433,23889,361
19-11-2021,krishnagiri,98,12,13,0,97,43508,12,238,0,43758,43310,351
19-11-2021,madurai,130,11,15,0,126,75240,11,173,0,75424,74119,1179
19-11-2021,mayiladuthurai,29,3,3,0,29,23297,3,39,0,23339,22994,316
19-11-2021,nagapattinam,87,10,5,0,92,21176,10,53,0,21239,20793,354
19-11-2021,namakkal,438,40,49,1,428,52855,40,112,0,53007,52074,505
19-11-2021,nilgiris,184,20,17,0,187,33841,20,44,0,33905,33505,213
19-11-2021,perambalur,18,0,1,0,17,12090,0,3,0,12093,11832,244
19-11-2021,pudukottai,74,2,7,0,69,30262,2,35,0,30299,29813,417
19-11-2021,ramanathapuram,24,2,2,0,24,20468,2,135,0,20605,20222,359
19-11-2021,ranipet,37,2,4,0,35,43468,2,49,0,43519,42709,775
19-11-2021,salem,525,42,59,1,507,100348,42,438,0,100828,98626,1695
19-11-2021,sivagangai,80,6,8,0,78,20232,6,108,0,20346,20060,208
19-11-2021,tenkasi,14,2,1,0,15,27322,2,58,0,27382,26882,485
19-11-2021,thanjavur,306,26,34,0,298,75856,26,22,0,75904,74622,984
19-11-2021,theni,11,1,1,0,11,43550,1,45,0,43596,43064,521
19-11-2021,thirupathur,29,1,3,0,27,29246,1,118,0,29365,28712,626
19-11-2021,thiruvallur,298,24,31,2,289,119894,24,10,0,119928,117793,1846
19-11-2021,thiruvannamalai,76,6,12,0,70,54728,6,398,0,55132,54393,669
19-11-2021,thiruvarur,171,10,19,0,162,41728,10,38,0,41776,41157,457
19-11-2021,thoothukudi,74,4,7,0,71,56172,4,275,0,56451,55971,409
19-11-2021,tirunelveli,116,9,6,0,119,49129,9,427,0,49565,49013,433
19-11-2021,tiruppur,583,50,69,0,564,96461,50,11,0,96522,94971,987
19-11-2021,trichy,378,30,30,4,374,78107,30,65,0,78202,76754,1074
19-11-2021,vellore,95,11,11,1,94,48391,11,1664,0,50066,48834,1138
19-11-2021,villupuram,47,5,9,0,43,45791,5,174,0,45970,45571,356
19-11-2021,virudhunagar,46,0,4,0,42,46267,0,104,0,46371,45781,548
19-11-2021,airport surveillance (international),4,0,0,0,4,0,0,1031,0,1031,1026,1
19-11-2021,airport surveillance (domestic),0,0,0,0,0,0,0,1085,0,1085,1084,1
19-11-2021,railway surveillance,0,0,0,0,0,0,0,428,0,428,428,0
20-11-2021,ariyalur,35,2,5,0,32,16889,2,20,0,16911,16617,262
20-11-2021,chengalpattu,736,58,77,3,714,173129,58,5,0,173192,169949,2529
20-11-2021,chennai,1288,118,106,3,1297,556819,118,47,0,556984,547099,8588
20-11-2021,coimbatore,1181,125,102,0,1204,248844,125,51,0,249020,245371,2445
20-11-2021,cuddalore,137,7,13,0,131,64130,7,203,0,64340,63338,871
20-11-2021,dharmapuri,155,9,17,0,147,28486,9,216,0,28711,28286,278
20-11-2021,dindigul,55,6,5,0,56,33108,6,77,0,33191,32485,650
20-11-2021,erode,787,73,62,0,798,105453,73,94,0,105620,104128,694
20-11-2021,kallakurichi,91,3,4,0,90,31124,3,404,0,31531,31231,210
20-11-2021,kancheepuram,256,15,31,0,240,75394,15,4,0,75413,73911,1262
20-11-2021,kanyakumari,168,11,18,0,161,62551,11,124,0,62686,61471,1054
20-11-2021,karur,181,18,20,0,179,24384,18,47,0,24449,23909,361
20-11-2021,krishnagiri,97,9,16,0,90,43520,9,238,0,43767,43326,351
20-11-2021,madurai,127,13,14,1,125,75252,13,173,0,75438,74133,1180
20-11-2021,mayiladuthurai,29,3,7,0,25,23300,3,39,0,23342,23001,316
20-11-2021,nagapattinam,93,14,9,1,97,21187,14,53,0,21254,20802,355
20-11-2021,namakkal,423,39,47,0,415,52890,39,112,0,53041,52121,505
20-11-2021,nilgiris,187,18,12,0,193,33861,18,44,0,33923,33517,213
20-11-2021,perambalur,17,2,3,0,16,12090,2,3,0,12095,11835,244
20-11-2021,pudukottai,71,1,8,0,64,30266,1,35,0,30302,29821,417
20-11-2021,ramanathapuram,24,2,4,0,22,20470,2,135,0,20607,20226,359
20-11-2021,ranipet,36,1,6,0,31,43471,1,49,0,43521,42715,775
20-11-2021,salem,511,41,61,2,489,100394,41,438,0,100873,98687,1697
20-11-2021,sivagangai,78,5,7,0,76,20238,5,108,0,20351,20067,208
20-11-2021,tenkasi,15,1,3,0,13,27324,1,58,0,27383,26885,485
20-11-2021,thanjavur,296,23,29,0,290,75880,23,22,0,75925,74651,984
20-11-2021,theni,11,0,1,0,10,43551,0,45,0,43596,43065,521
20-11-2021,thirupathur,28,1,6,0,23,29248,1,118,0,29367,28718,626
20-11-2021,thiruvallur,289,26,33,0,282,119918,26,10,0,119954,117826,1846
20-11-2021,thiruvannamalai,72,4,10,0,66,54736,4,398,0,55138,54403,669
20-11-2021,thiruvarur,162,11,15,0,158,41738,11,38,0,41787,41172,457
20-11-2021,thoothukudi,71,6,8,0,69,56176,6,275,0,56457,55979,409
20-11-2021,tirunelveli,120,7,9,0,118,49139,7,427,0,49573,49022,433
20-11-2021,tiruppur,567,48,63,1,551,96514,48,11,0,96573,95034,988
20-11-2021,trichy,376,29,27,1,377,78139,29,65,0,78233,76781,1075
20-11-2021,vellore,94,9,7,0,96,48402,9,1664,0,50075,48841,1138
20-11-2021,villupuram,43,4,11,0,36,45796,4,174,0,45974,45582,356
20-11-2021,virudhunagar,42,3,2,0,43,46267,3,104,0,46374,45783,548
20-11-2021,airport surveillance (international),4,0,1,0,3,0,0,1031,0,1031,1027,1
20-11-2021,airport surveillance (domestic),0,0,0,0,0,0,0,1085,0,1085,1084,1
20-11-2021,railway surveillance,0,0,0,0,0,0,0,428,0,428,428,0
21-11-2021,ariyalur,32,2,3,0,31,16891,2,20,0,16913,16620,262
21-11-2021,chengalpattu,713,56,76,0,693,173186,56,5,0,173247,170025,2529
21-11-2021,chennai,1301,112,109,5,1299,556941,112,47,0,557100,547208,8593
21-11-2021,coimbatore,1205,130,104,1,1230,248970,130,51,0,249151,245475,2446
21-11-2021,cuddalore,131,5,17,1,118,64137,5,203,0,64345,63355,872
21-11-2021,dharmapuri,147,10,11,0,146,28495,10,216,0,28721,28297,278
21-11-2021,dindigul,55,4,4,0,55,33113,4,77,0,33194,32489,650
21-11-2021,erode,794,80,64,0,810,105522,80,94,0,105696,104192,694
21-11-2021,kallakurichi,90,4,5,0,89,31127,4,404,0,31535,31236,210
21-11-2021,kancheepuram,238,14,34,0,218,75407,14,4,0,75425,73945,1262
21-11-2021,kanyakumari,161,10,16,0,155,62562,10,124,0,62696,61487,1054
21-11-2021,karur,179,16,19,0,176,24402,16,47,0,24465,23928,361
21-11-2021,krishnagiri,90,7,13,1,83,43529,7,238,0,43774,43339,352
21-11-2021,madurai,124,12,9,1,126,75264,12,173,0,75449,74142,1181
21-11-2021,mayiladuthurai,27,2,6,0,23,23305,2,39,0,23346,23007,316
21-11-2021,nagapattinam,97,10,10,0,97,21201,10,53,0,21264,20812,355
21-11-2021,namakkal,415,42,49,0,408,52929,42,112,0,53083,52170,505
21-11-2021,nilgiris,193,20,8,0,205,33879,20,44,0,33943,33525,213
21-11-2021,perambalur,16,2,2,0,16,12092,2,3,0,12097,11837,244
21-11-2021,pudukottai,64,1,6,0,59,30267,1,35,0,30303,29827,417
21-11-2021,ramanathapuram,22,3,1,0,24,20472,3,135,0,20610,20227,359
21-11-2021,ranipet,31,1,4,0,28,43472,1,49,0,43522,42719,775
21-11-2021,salem,489,44,65,0,468,100435,44,438,0,100917,98752,1697
21-11-2021,sivagangai,77,4,5,0,76,20244,4,108,0,20356,20072,208
21-11-2021,tenkasi,13,0,2,0,11,27325,0,58,0,27383,26887,485
21-11-2021,thanjavur,285,20,25,2,278,75898,20,22,0,75940,74676,986
21-11-2021,theni,10,1,1,0,10,43551,1,45,0,43597,43066,521
21-11-2021,thirupathur,23,0,4,0,19,29249,0,118,0,29367,28722,626
21-11-2021,thiruvallur,282,23,29,0,276,119944,23,10,0,119977,117855,1846
21-11-2021,thiruvannamalai,66,5,7,0,64,54740,5,398,0,55143,54410,669
21-11-2021,thiruvarur,159,9,14,0,154,41750,9,38,0,41797,41186,457
21-11-2021,thoothukudi,69,8,12,0,65,56182,8,275,0,56465,55991,409
21-11-2021,tirunelveli,118,8,15,0,111,49146,8,427,0,49581,49037,433
21-11-2021,tiruppur,553,49,58,2,542,96564,49,11,0,96624,95092,990
21-11-2021,trichy,380,26,24,1,381,78171,26,65,0,78262,76805,1076
21-11-2021,vellore,96,11,5,0,102,48411,11,1664,0,50086,48846,1138
21-11-2021,villupuram,36,3,7,0,32,45800,3,174,0,45977,45589,356
21-11-2021,virudhunagar,43,2,4,0,41,46270,2,104,0,46376,45787,548
21-11-2021,airport surveillance (international),3,0,0,0,3,0,0,1031,0,1031,1027,1
21-11-2021,airport surveillance (domestic),0,0,0,0,0,0,0,1085,0,1085,1084,1
21-11-2021,railway surveillance,0,0,0,0,0,0,0,428,0,428,428,0
22-11-2021,ariyalur,31,2,4,1,28,16893,2,20,0,16915,16624,263
22-11-2021,chengalpattu,694,54,72,0,676,173243,54,5,0,173302,170097,2529
22-11-2021,chennai,1295,110,116,2,1287,557049,110,47,0,557206,547324,8595
22-11-2021,coimbatore,1230,125,107,0,1248,249100,125,51,0,249276,245582,2446
22-11-2021,cuddalore,117,7,15,0,109,64141,7,203,0,64351,63370,872
22-11-2021,dharmapuri,146,11,17,0,140,28505,11,216,0,28732,28314,278
22-11-2021,dindigul,54,6,3,0,57,33116,6,77,0,33199,32492,650
22-11-2021,erode,808,75,68,0,815,105600,75,94,0,105769,104260,694
22-11-2021,kallakurichi,89,3,7,0,85,31131,3,404,0,31538,31243,210
22-11-2021,kancheepuram,220,13,28,0,205,75423,13,4,0,75440,73973,1262
22-11-2021,kanyakumari,156,12,14,1,153,62573,12,124,0,62709,61501,1055
22-11-2021,karur,174,15,20,0,169,24416,15,47,0,24478,23948,361
22-11-2021,krishnagiri,83,8,11,1,79,43536,8,238,0,43782,43350,353
22-11-2021,madurai,126,11,10,1,126,75276,11,173,0,75460,74152,1182
22-11-2021,mayiladuthurai,24,2,5,0,21,23308,2,39,0,23349,23012,316
22-11-2021,nagapattinam,97,9,12,0,94,21211,9,53,0,21273,20824,355
22-11-2021,namakkal,412,41,46,0,407,52975,41,112,0,53128,52216,505
22-11-2021,nilgiris,205,18,13,0,210,33899,18,44,0,33961,33538,213
22-11-2021,perambalur,16,0,4,0,12,12094,0,3,0,12097,11841,244
22-11-2021,pudukottai,59,4,6,0,57,30268,4,35,0,30307,29833,417
22-11-2021,ramanathapuram,24,5,2,0,27,20475,5,135,0,20615,20229,359
22-11-2021,ranipet,28,0,3,0,25,43473,0,49,0,43522,42722,775
22-11-2021,salem,467,42,58,1,450,100478,42,438,0,100958,98810,1698
22-11-2021,sivagangai,75,2,8,0,69,20247,2,108,0,20357,20080,208
22-11-2021,tenkasi,11,1,2,0,10,27325,1,58,0,27384,26889,485
22-11-2021,thanjavur,278,23,23,1,277,75918,23,22,0,75963,74699,987
22-11-2021,theni,10,1,1,0,10,43552,1,45,0,43598,43067,521
22-11-2021,thirupathur,19,0,3,0,16,29249,0,118,0,29367,28725,626
22-11-2021,thiruvallur,276,21,25,0,272,119967,21,10,0,119998,117880,1846
22-11-2021,thiruvannamalai,64,4,5,0,63,54745,4,398,0,55147,54415,669
22-11-2021,thiruvarur,154,10,16,0,148,41759,10,38,0,41807,41202,457
22-11-2021,thoothukudi,64,4,9,1,58,56189,4,275,0,56468,56000,410
22-11-2021,tirunelveli,112,12,18,0,106,49155,12,427,0,49594,49055,433
22-11-2021,tiruppur,544,59,52,3,548,96615,59,11,0,96685,95144,993
22-11-2021,trichy,381,24,27,1,377,78197,24,65,0,78286,76832,1077
22-11-2021,vellore,102,10,4,0,108,48422,10,1664,0,50096,48850,1138
22-11-2021,villupuram,33,2,3,0,32,45804,2,174,0,45980,45592,356
22-11-2021,virudhunagar,41,4,6,0,39,46272,4,104,0,46380,45793,548
22-11-2021,airport surveillance (international),3,0,0,0,3,0,0,1031,0,1031,1027,1
22-11-2021,airport surveillance (domestic),0,0,0,0,0,0,0,1085,0,1085,1084,1
22-11-2021,railway surveillance,0,0,0,0,0,0,0,428,0,428,428,0
23-11-2021,ariyalur,26,2,3,0,25,16893,2,20,0,16915,16627,263
23-11-2021,chengalpattu,678,57,76,0,659,173299,57,5,0,173361,170173,2529
23-11-2021,chennai,1287,114,124,3,1274,557159,114,47,0,557320,547448,8598
23-11-2021,coimbatore,1250,119,108,3,1258,249227,119,51,0,249397,245690,2449
23-11-2021,cuddalore,108,6,12,0,102,64147,6,203,0,64356,63382,872
23-11-2021,dharmapuri,140,8,10,0,138,28516,8,216,0,28740,28324,278
23-11-2021,dindigul,57,1,4,0,54,33122,1,77,0,33200,32496,650
23-11-2021,erode,815,78,63,0,830,105675,78,94,0,105847,104323,694
23-11-2021,kallakurichi,85,2,11,0,76,31134,2,404,0,31540,31254,210
23-11-2021,kancheepuram,205,17,24,1,197,75436,17,4,0,75457,73997,1263
23-11-2021,kanyakumari,153,9,17,0,145,62585,9,124,0,62718,61518,1055
23-11-2021,karur,170,18,15,0,173,24432,18,47,0,24497,23963,361
23-11-2021,krishnagiri,79,5,9,0,75,43544,5,238,0,43787,43359,353
23-11-2021,madurai,125,6,7,0,124,75286,6,173,0,75465,74159,1182
23-11-2021,mayiladuthurai,22,2,2,0,22,23311,2,39,0,23352,23014,316
23-11-2021,nagapattinam,95,8,6,0,97,21221,8,53,0,21282,20830,355
23-11-2021,namakkal,407,43,42,0,408,53016,43,112,0,53171,52258,505
23-11-2021,nilgiris,210,16,18,0,208,33917,16,44,0,33977,33556,213
23-11-2021,perambalur,13,1,2,0,12,12095,1,3,0,12099,11843,244
23-11-2021,pudukottai,57,4,5,0,56,30272,4,35,0,30311,29838,417
23-11-2021,ramanathapuram,27,2,3,0,26,20480,2,135,0,20617,20232,359
23-11-2021,ranipet,25,4,1,0,28,43473,4,49,0,43526,42723,775
23-11-2021,salem,451,39,46,0,444,100521,39,438,0,100998,98856,1698
23-11-2021,sivagangai,68,4,5,1,66,20248,4,108,0,20360,20085,209
23-11-2021,tenkasi,10,1,2,0,9,27326,1,58,0,27385,26891,485
23-11-2021,thanjavur,276,20,26,1,269,75940,20,22,0,75982,74725,988
23-11-2021,theni,10,1,1,0,10,43553,1,45,0,43599,43068,521
23-11-2021,thirupathur,17,2,2,0,17,29250,2,118,0,29370,28727,626
23-11-2021,thiruvallur,269,25,23,0,271,119985,25,10,0,120020,117903,1846
23-11-2021,thiruvannamalai,63,5,8,0,60,54749,5,398,0,55152,54423,669
23-11-2021,thiruvarur,148,8,13,0,143,41769,8,38,0,41815,41215,457
23-11-2021,thoothukudi,58,0,3,0,55,56193,0,275,0,56468,56003,410
23-11-2021,tirunelveli,106,14,14,0,106,49167,14,427,0,49608,49069,433
23-11-2021,tiruppur,548,57,48,2,555,96674,57,11,0,96742,95192,995
23-11-2021,trichy,376,23,36,1,362,78220,23,65,0,78308,76868,1078
23-11-2021,vellore,107,15,8,0,114,48431,15,1664,0,50110,48858,1138
23-11-2021,villupuram,33,3,4,1,31,45807,3,174,0,45984,45596,357
23-11-2021,virudhunagar,39,2,7,0,34,46276,2,104,0,46382,45800,548
23-11-2021,airport surveillance (international),3,0,0,0,3,0,0,1031,0,1031,1027,1
23-11-2021,airport surveillance (domestic),0,0,0,0,0,0,0,1085,0,1085,1084,1
23-11-2021,railway surveillance,0,0,0,0,0,0,0,428,0,428,428,0
24-11-2021,ariyalur,26,2,2,0,26,16896,2,20,0,16918,16629,263
24-11-2021,chengalpattu,657,59,68,0,648,173354,59,5,0,173418,170241,2529
24-11-2021,chennai,1276,115,122,2,1267,557275,115,47,0,557437,547570,8600
24-11-2021,coimbatore,1258,117,110,6,1259,249346,117,51,0,249514,245800,2455
24-11-2021,cuddalore,102,5,11,0,96,64153,5,203,0,64361,63393,872
24-11-2021,dharmapuri,138,9,13,0,134,28524,9,216,0,28749,28337,278
24-11-2021,dindigul,55,4,3,0,56,33124,4,77,0,33205,32499,650
24-11-2021,erode,823,81,65,0,839,105746,81,94,0,105921,104388,694
24-11-2021,kallakurichi,76,2,8,0,70,31136,2,404,0,31542,31262,210
24-11-2021,kancheepuram,197,19,20,0,196,75453,19,4,0,75476,74017,1263
24-11-2021,kanyakumari,145,7,15,0,137,62594,7,124,0,62725,61533,1055
24-11-2021,karur,175,17,17,0,175,24452,17,47,0,24516,23980,361
24-11-2021,krishnagiri,74,4,6,0,72,43548,4,238,0,43790,43365,353
24-11-2021,madurai,123,7,4,0,126,75291,7,173,0,75471,74163,1182
24-11-2021,mayiladuthurai,23,4,1,2,24,23314,4,39,0,23357,23015,318
24-11-2021,nagapattinam,97,5,7,0,95,21229,5,53,0,21287,20837,355
24-11-2021,namakkal,409,47,46,0,410,53060,47,112,0,53219,52304,505
24-11-2021,nilgiris,208,19,16,0,211,33933,19,44,0,33996,33572,213
24-11-2021,perambalur,12,2,1,0,13,12096,2,3,0,12101,11844,244
24-11-2021,pudukottai,57,1,5,0,53,30277,1,35,0,30313,29843,417
24-11-2021,ramanathapuram,26,3,1,0,28,20482,3,135,0,20620,20233,359
24-11-2021,ranipet,28,4,3,0,29,43477,4,49,0,43530,42726,775
24-11-2021,salem,447,38,44,2,439,100563,38,438,0,101039,98900,1700
24-11-2021,sivagangai,66,2,6,0,62,20252,2,108,0,20362,20091,209
24-11-2021,tenkasi,10,1,2,0,9,27328,1,58,0,27387,26893,485
24-11-2021,thanjavur,269,19,23,1,264,75960,19,22,0,76001,74748,989
24-11-2021,theni,9,0,1,0,8,43553,0,45,0,43598,43069,521
24-11-2021,thirupathur,17,4,3,1,17,29252,4,118,0,29374,28730,627
24-11-2021,thiruvallur,271,27,27,0,271,120010,27,10,0,120047,117930,1846
24-11-2021,thiruvannamalai,60,2,5,0,57,54754,2,398,0,55154,54428,669
24-11-2021,thiruvarur,142,7,14,0,135,41776,7,38,0,41821,41229,457
24-11-2021,thoothukudi,58,1,4,0,55,56196,1,275,0,56472,56007,410
24-11-2021,tirunelveli,100,6,10,0,96,49175,6,427,0,49608,49079,433
24-11-2021,tiruppur,557,62,45,0,574,96733,62,11,0,96806,95237,995
24-11-2021,trichy,361,25,38,0,348,78242,25,65,0,78332,76906,1078
24-11-2021,vellore,115,11,9,0,117,48447,11,1664,0,50122,48867,1138
24-11-2021,villupuram,31,3,4,0,30,45810,3,174,0,45987,45600,357
24-11-2021,virudhunagar,35,3,3,0,35,46279,3,104,0,46386,45803,548
24-11-2021,airport surveillance (international),3,0,0,0,3,0,0,1031,0,1031,1027,1
24-11-2021,airport surveillance (domestic),0,0,0,0,0,0,0,1085,0,1085,1084,1
24-11-2021,railway surveillance,0,0,0,0,0,0,0,428,0,428,428,0
25-11-2021,ariyalur,25,0,4,1,20,16897,0,20,0,16917,16633,264
25-11-2021,chengalpattu,651,69,65,2,653,173416,69,5,0,173490,170306,2531
25-11-2021,chennai,1251,107,120,3,1235,557374,107,47,0,557528,547690,8603
25-11-2021,coimbatore,1260,112,116,3,1253,249464,112,51,0,249627,245916,2458
25-11-2021,cuddalore,96,6,8,0,94,64158,6,203,0,64367,63401,872
25-11-2021,dharmapuri,134,8,12,0,130,28533,8,216,0,28757,28349,278
25-11-2021,dindigul,55,5,3,0,57,33127,5,77,0,33209,32502,650
25-11-2021,erode,841,76,67,1,849,105829,76,94,0,105999,104455,695
25-11-2021,kallakurichi,70,4,9,0,65,31138,4,404,0,31546,31271,210
25-11-2021,kancheepuram,201,18,22,0,197,75477,18,4,0,75499,74039,1263
25-11-2021,kanyakumari,137,8,13,0,132,62601,8,124,0,62733,61546,1055
25-11-2021,karur,175,16,15,0,176,24469,16,47,0,24532,23995,361
25-11-2021,krishnagiri,72,5,2,0,75,43552,5,238,0,43795,43367,353
25-11-2021,madurai,126,6,7,0,125,75298,6,173,0,75477,74170,1182
25-11-2021,mayiladuthurai,24,5,1,0,28,23318,5,39,0,23362,23016,318
25-11-2021,nagapattinam,95,6,7,0,94,21234,6,53,0,21293,20844,355
25-11-2021,namakkal,407,48,42,0,413,53104,48,112,0,53264,52346,505
25-11-2021,nilgiris,212,16,19,0,209,33953,16,44,0,34013,33591,213
25-11-2021,perambalur,13,0,2,0,11,12098,0,3,0,12101,11846,244
25-11-2021,pudukottai,53,2,4,1,50,30278,2,35,0,30315,29847,418
25-11-2021,ramanathapuram,28,1,1,0,28,20485,1,135,0,20621,20234,359
25-11-2021,ranipet,29,3,2,0,30,43481,3,49,0,43533,42728,775
25-11-2021,salem,442,43,34,0,451,100604,43,438,0,101085,98934,1700
25-11-2021,sivagangai,62,4,7,0,59,20254,4,108,0,20366,20098,209
25-11-2021,tenkasi,9,1,1,0,9,27329,1,58,0,27388,26894,485
25-11-2021,thanjavur,265,18,24,2,257,75980,18,22,0,76020,74772,991
25-11-2021,theni,8,1,0,0,9,43553,1,45,0,43599,43069,521
25-11-2021,thirupathur,18,1,2,0,17,29257,1,118,0,29376,28732,627
25-11-2021,thiruvallur,273,24,29,0,268,120039,24,10,0,120073,117959,1846
25-11-2021,thiruvannamalai,60,5,3,1,61,54759,5,398,0,55162,54431,670
25-11-2021,thiruvarur,135,8,11,1,131,41783,8,38,0,41829,41240,458
25-11-2021,thoothukudi,56,2,5,0,53,56198,2,275,0,56475,56012,410
25-11-2021,tirunelveli,97,7,8,0,96,49182,7,427,0,49616,49087,433
25-11-2021,tiruppur,574,65,48,1,590,96795,65,11,0,96871,95285,996
25-11-2021,trichy,350,20,37,0,333,78269,20,65,0,78354,76943,1078
25-11-2021,vellore,111,13,6,1,117,48452,13,1664,0,50129,48873,1139
25-11-2021,villupuram,31,4,3,0,32,45814,4,174,0,45992,45603,357
25-11-2021,virudhunagar,35,2,5,0,32,46282,2,104,0,46388,45808,548
25-11-2021,airport surveillance (international),3,0,0,0,3,0,0,1031,0,1031,1027,1
25-11-2021,airport surveillance (domestic),0,0,0,0,0,0,0,1085,0,1085,1084,1
25-11-2021,railway surveillance,0,0,0,0,0,0,0,428,0,428,428,0
26-11-2021,ariyalur,20,1,1,0,20,16897,1,20,0,16918,16634,264
26-11-2021,chengalpattu,660,59,60,2,657,173492,59,5,0,173556,170366,2533
26-11-2021,chennai,1221,103,115,0,1209,557467,103,47,0,557617,547805,8603
26-11-2021,coimbatore,1255,113,111,3,1254,249578,113,51,0,249742,246027,2461
26-11-2021,cuddalore,91,10,9,0,92,64161,10,203,0,64374,63410,872
26-11-2021,dharmapuri,131,9,13,0,127,28542,9,216,0,28767,28362,278
26-11-2021,dindigul,58,6,5,0,59,33133,6,77,0,33216,32507,650
26-11-2021,erode,842,70,69,1,842,105898,70,94,0,106062,104524,696
26-11-2021,kallakurichi,65,1,9,0,57,31142,1,404,0,31547,31280,210
26-11-2021,kancheepuram,194,23,19,0,198,75492,23,4,0,75519,74058,1263
26-11-2021,kanyakumari,132,9,14,0,127,62609,9,124,0,62742,61560,1055
26-11-2021,karur,179,19,17,0,181,24488,19,47,0,24554,24012,361
26-11-2021,krishnagiri,74,10,3,0,81,43556,10,238,0,43804,43370,353
26-11-2021,madurai,125,10,10,0,125,75304,10,173,0,75487,74180,1182
26-11-2021,mayiladuthurai,28,4,1,0,31,23323,4,39,0,23366,23017,318
26-11-2021,nagapattinam,97,7,6,0,98,21243,7,53,0,21303,20850,355
26-11-2021,namakkal,409,45,37,1,416,53148,45,112,0,53305,52383,506
26-11-2021,nilgiris,211,15,22,0,204,33971,15,44,0,34030,33613,213
26-11-2021,perambalur,11,0,0,0,11,12098,0,3,0,12101,11846,244
26-11-2021,pudukottai,51,1,6,0,46,30281,1,35,0,30317,29853,418
26-11-2021,ramanathapuram,30,0,2,0,28,20488,0,135,0,20623,20236,359
26-11-2021,ranipet,34,2,4,0,32,43488,2,49,0,43539,42732,775
26-11-2021,salem,455,56,38,0,473,100651,56,438,0,101145,98972,1700
26-11-2021,sivagangai,59,5,5,0,59,20258,5,108,0,20371,20103,209
26-11-2021,tenkasi,10,1,1,1,9,27331,1,58,0,27390,26895,486
26-11-2021,thanjavur,256,15,23,1,247,75997,15,22,0,76034,74795,992
26-11-2021,theni,9,2,0,0,11,43554,2,45,0,43601,43069,521
26-11-2021,thirupathur,18,3,2,0,19,29259,3,118,0,29380,28734,627
26-11-2021,thiruvallur,269,28,27,0,270,120064,28,10,0,120102,117986,1846
26-11-2021,thiruvannamalai,62,4,4,0,62,54765,4,398,0,55167,54435,670
26-11-2021,thiruvarur,131,9,12,0,128,41791,9,38,0,41838,41252,458
26-11-2021,thoothukudi,56,4,7,0,53,56203,4,275,0,56482,56019,410
26-11-2021,tirunelveli,97,6,6,0,97,49190,6,427,0,49623,49093,433
26-11-2021,tiruppur,591,56,51,1,595,96861,56,11,0,96928,95336,997
26-11-2021,trichy,333,22,39,1,315,78289,22,65,0,78376,76982,1079
26-11-2021,vellore,111,12,5,0,118,48459,12,1664,0,50135,48878,1139
26-11-2021,villupuram,32,5,2,0,35,45818,5,174,0,45997,45605,357
26-11-2021,virudhunagar,32,1,4,0,29,46284,1,104,0,46389,45812,548
26-11-2021,airport surveillance (international),3,0,0,0,3,0,0,1031,0,1031,1027,1
26-11-2021,airport surveillance (domestic),0,0,0,0,0,0,0,1085,0,1085,1084,1
26-11-2021,railway surveillance,0,0,0,0,0,0,0,428,0,428,428,0
27-11-2021,ariyalur,19,1,1,0,19,16897,1,20,0,16918,16635,264
27-11-2021,chengalpattu,655,56,62,0,649,173549,56,5,0,173610,170428,2533
27-11-2021,chennai,1211,105,108,1,1207,557572,105,47,0,557724,547913,8604
27-11-2021,coimbatore,1254,112,115,0,1251,249691,112,51,0,249854,246142,2461
27-11-2021,cuddalore,88,9,11,0,86,64167,9,203,0,64379,63421,872
27-11-2021,dharmapuri,127,7,14,0,120,28551,7,216,0,28774,28376,278
27-11-2021,dindigul,59,2,6,0,55,33139,2,77,0,33218,32513,650
27-11-2021,erode,832,68,71,0,829,105958,68,94,0,106120,104595,696
27-11-2021,kallakurichi,58,2,7,0,53,31144,2,404,0,31550,31287,210
27-11-2021,kancheepuram,197,21,21,0,197,75514,21,4,0,75539,74079,1263
27-11-2021,kanyakumari,127,8,12,1,122,62618,8,124,0,62750,61572,1056
27-11-2021,karur,183,18,14,1,186,24509,18,47,0,24574,24026,362
27-11-2021,krishnagiri,81,9,5,0,85,43566,9,238,0,43813,43375,353
27-11-2021,madurai,127,9,13,1,122,75316,9,173,0,75498,74193,1183
27-11-2021,mayiladuthurai,31,2,2,0,31,23327,2,39,0,23368,23019,318
27-11-2021,nagapattinam,99,6,8,0,97,21251,6,53,0,21310,20858,355
27-11-2021,namakkal,421,47,31,0,437,53198,47,112,0,53357,52414,506
27-11-2021,nilgiris,205,16,23,1,197,33987,16,44,0,34047,33636,214
27-11-2021,perambalur,11,1,0,0,12,12098,1,3,0,12102,11846,244
27-11-2021,pudukottai,47,5,8,0,44,30283,5,35,0,30323,29861,418
27-11-2021,ramanathapuram,28,1,1,0,28,20488,1,135,0,20624,20237,359
27-11-2021,ranipet,32,1,3,0,30,43490,1,49,0,43540,42735,775
27-11-2021,salem,475,53,39,1,488,100709,53,438,0,101200,99011,1701
27-11-2021,sivagangai,59,6,7,0,58,20263,6,108,0,20377,20110,209
27-11-2021,tenkasi,9,1,0,0,10,27332,1,58,0,27391,26895,486
27-11-2021,thanjavur,247,18,19,1,245,76012,18,22,0,76052,74814,993
27-11-2021,theni,11,3,1,0,13,43556,3,45,0,43604,43070,521
27-11-2021,thirupathur,19,6,3,0,22,29262,6,118,0,29386,28737,627
27-11-2021,thiruvallur,270,27,25,1,271,120092,27,10,0,120129,118011,1847
27-11-2021,thiruvannamalai,64,3,6,0,61,54771,3,398,0,55172,54441,670
27-11-2021,thiruvarur,130,8,15,0,123,41802,8,38,0,41848,41267,458
27-11-2021,thoothukudi,53,2,9,0,46,56207,2,275,0,56484,56028,410
27-11-2021,tirunelveli,97,7,7,0,97,49196,7,427,0,49630,49100,433
27-11-2021,tiruppur,597,54,53,0,598,96919,54,11,0,96984,95389,997
27-11-2021,trichy,310,18,34,1,293,78306,18,65,0,78389,77016,1080
27-11-2021,vellore,118,17,6,2,127,48471,17,1664,0,50152,48884,1141
27-11-2021,villupuram,35,9,2,0,42,45823,9,174,0,46006,45607,357
27-11-2021,virudhunagar,29,2,3,0,28,46285,2,104,0,46391,45815,548
27-11-2021,airport surveillance (international),3,0,0,0,3,0,0,1031,0,1031,1027,1
27-11-2021,airport surveillance (domestic),0,0,0,0,0,0,0,1085,0,1085,1084,1
27-11-2021,railway surveillance,0,0,0,0,0,0,0,428,0,428,428,0
28-11-2021,ariyalur,19,3,1,0,21,16898,3,20,0,16921,16636,264
28-11-2021,chengalpattu,649,53,61,0,641,173605,53,5,0,173663,170489,2533
28-11-2021,chennai,1198,107,110,1,1194,557668,107,47,0,557822,548023,8605
28-11-2021,coimbatore,1251,109,117,1,1242,249803,109,51,0,249963,246259,2462
28-11-2021,cuddalore,86,8,13,0,81,64176,8,203,0,64387,63434,872
28-11-2021,dharmapuri,121,13,10,0,124,28559,13,216,0,28788,28386,278
28-11-2021,dindigul,55,4,7,0,52,33141,4,77,0,33222,32520,650
28-11-2021,erode,825,72,73,0,824,106022,72,94,0,106188,104668,696
28-11-2021,kallakurichi,53,1,8,0,46,31146,1,404,0,31551,31295,210
28-11-2021,kancheepuram,202,20,23,0,199,75540,20,4,0,75564,74102,1263
28-11-2021,kanyakumari,124,9,14,1,118,62628,9,124,0,62761,61586,1057
28-11-2021,karur,184,17,11,0,190,24525,17,47,0,24589,24037,362
28-11-2021,krishnagiri,85,11,7,0,89,43575,11,238,0,43824,43382,353
28-11-2021,madurai,121,8,15,0,114,75324,8,173,0,75505,74208,1183
28-11-2021,mayiladuthurai,31,3,3,0,31,23329,3,39,0,23371,23022,318
28-11-2021,nagapattinam,97,8,9,1,95,21257,8,53,0,21318,20867,356
28-11-2021,namakkal,439,45,33,0,451,53247,45,112,0,53404,52447,506
28-11-2021,nilgiris,197,17,20,0,194,34003,17,44,0,34064,33656,214
28-11-2021,perambalur,12,0,1,0,11,12099,0,3,0,12102,11847,244
28-11-2021,pudukottai,44,2,10,0,36,30288,2,35,0,30325,29871,418
28-11-2021,ramanathapuram,28,0,2,0,26,20489,0,135,0,20624,20239,359
28-11-2021,ranipet,31,10,4,0,37,43492,10,49,0,43551,42739,775
28-11-2021,salem,488,50,41,1,496,100762,50,438,0,101250,99052,1702
28-11-2021,sivagangai,58,5,8,0,55,20269,5,108,0,20382,20118,209
28-11-2021,tenkasi,11,2,0,0,13,27334,2,58,0,27394,26895,486
28-11-2021,thanjavur,245,17,21,2,239,76030,17,22,0,76069,74835,995
28-11-2021,theni,13,1,2,0,12,43559,1,45,0,43605,43072,521
28-11-2021,thirupathur,22,3,1,0,24,29268,3,118,0,29389,28738,627
28-11-2021,thiruvallur,268,28,19,0,277,120116,28,10,0,120154,118030,1847
28-11-2021,thiruvannamalai,62,3,8,0,57,54775,3,398,0,55176,54449,670
28-11-2021,thiruvarur,123,4,12,0,115,41810,4,38,0,41852,41279,458
28-11-2021,thoothukudi,47,3,6,0,44,56210,3,275,0,56488,56034,410
28-11-2021,tirunelveli,97,8,5,0,100,49203,8,427,0,49638,49105,433
28-11-2021,tiruppur,603,53,56,1,599,96978,53,11,0,97042,95445,998
28-11-2021,trichy,295,19,29,1,284,78326,19,65,0,78410,77045,1081
28-11-2021,vellore,125,16,5,0,136,48486,16,1664,0,50166,48889,1141
28-11-2021,villupuram,42,4,3,0,43,45832,4,174,0,46010,45610,357
28-11-2021,virudhunagar,28,0,4,0,24,46287,0,104,0,46391,45819,548
28-11-2021,airport surveillance (international),3,0,0,0,3,0,0,1031,0,1031,1027,1
28-11-2021,airport surveillance (domestic),0,0,0,0,0,0,0,1085,0,1085,1084,1
28-11-2021,railway surveillance,0,0,0,0,0,0,0,428,0,428,428,0
29-11-2021,ariyalur,21,2,2,0,21,16901,2,20,0,16923,16638,264
29-11-2021,chengalpattu,645,51,65,0,631,173662,51,5,0,173718,170554,2533
29-11-2021,chennai,1188,105,108,3,1182,557769,105,47,0,557921,548131,8608
29-11-2021,coimbatore,1243,106,114,1,1234,249913,106,51,0,250070,246373,2463
29-11-2021,cuddalore,81,7,9,0,79,64184,7,203,0,64394,63443,872
29-11-2021,dharmapuri,124,12,11,0,125,28572,12,216,0,28800,28397,278
29-11-2021,dindigul,52,5,6,0,51,33145,5,77,0,33227,32526,650
29-11-2021,erode,818,70,75,0,813,106088,70,94,0,106252,104743,696
29-11-2021,kallakurichi,46,5,7,0,44,31147,5,404,0,31556,31302,210
29-11-2021,kancheepuram,200,19,22,1,196,75561,19,4,0,75584,74124,1264
29-11-2021,kanyakumari,118,11,12,0,117,62637,11,124,0,62772,61598,1057
29-11-2021,karur,190,16,15,0,191,24542,16,47,0,24605,24052,362
29-11-2021,krishnagiri,88,10,10,0,88,43585,10,238,0,43833,43392,353
29-11-2021,madurai,113,7,16,0,104,75331,7,173,0,75511,74224,1183
29-11-2021,mayiladuthurai,31,1,2,0,30,23332,1,39,0,23372,23024,318
29-11-2021,nagapattinam,96,7,8,1,94,21266,7,53,0,21326,20875,357
29-11-2021,namakkal,454,44,31,0,467,53295,44,112,0,53451,52478,506
29-11-2021,nilgiris,194,16,17,0,193,34020,16,44,0,34080,33673,214
29-11-2021,perambalur,11,1,1,0,11,12099,1,3,0,12103,11848,244
29-11-2021,pudukottai,35,1,7,0,29,30289,1,35,0,30325,29878,418
29-11-2021,ramanathapuram,26,3,1,0,28,20489,3,135,0,20627,20240,359
29-11-2021,ranipet,37,3,5,0,35,43502,3,49,0,43554,42744,775
29-11-2021,salem,497,49,45,0,501,100813,49,438,0,101300,99097,1702
29-11-2021,sivagangai,55,6,9,1,51,20274,6,108,0,20388,20127,210
29-11-2021,tenkasi,13,0,1,0,12,27336,0,58,0,27394,26896,486
29-11-2021,thanjavur,239,16,18,0,237,76047,16,22,0,76085,74853,995
29-11-2021,theni,12,0,1,0,11,43560,0,45,0,43605,43073,521
29-11-2021,thirupathur,25,2,2,0,25,29272,2,118,0,29392,28740,627
29-11-2021,thiruvallur,278,26,21,0,283,120145,26,10,0,120181,118051,1847
29-11-2021,thiruvannamalai,57,6,5,0,58,54778,6,398,0,55182,54454,670
29-11-2021,thiruvarur,115,10,13,0,112,41814,10,38,0,41862,41292,458
29-11-2021,thoothukudi,44,4,7,0,41,56213,4,275,0,56492,56041,410
29-11-2021,tirunelveli,100,7,4,0,103,49211,7,427,0,49645,49109,433
29-11-2021,tiruppur,601,62,58,1,604,97033,62,11,0,97106,95503,999
29-11-2021,trichy,285,18,28,1,274,78346,18,65,0,78429,77073,1082
29-11-2021,vellore,135,14,6,0,143,48501,14,1664,0,50179,48895,1141
29-11-2021,villupuram,43,5,3,0,45,45836,5,174,0,46015,45613,357
29-11-2021,virudhunagar,24,3,2,0,25,46287,3,104,0,46394,45821,548
29-11-2021,airport surveillance (international),3,0,0,0,3,0,0,1031,0,1031,1027,1
29-11-2021,airport surveillance (domestic),0,0,0,0,0,0,0,1085,0,1085,1084,1
29-11-2021,railway surveillance,0,0,0,0,0,0,0,428,0,428,428,0
30-11-2021,ariyalur,22,1,3,0,20,16904,1,20,0,16925,16641,264
30-11-2021,chengalpattu,635,53,58,0,630,173717,53,5,0,173775,170612,2533
30-11-2021,chennai,1180,115,112,1,1182,557872,115,47,0,558034,548243,8609
30-11-2021,coimbatore,1234,109,109,1,1233,250019,109,51,0,250179,246482,2464
30-11-2021,cuddalore,79,5,6,0,78,64191,5,203,0,64399,63449,872
30-11-2021,dharmapuri,126,10,12,0,124,28585,10,216,0,28811,28409,278
30-11-2021,dindigul,51,6,7,0,50,33150,6,77,0,33233,32533,650
30-11-2021,erode,807,69,72,0,804,106152,69,94,0,106315,104815,696
30-11-2021,kallakurichi,44,3,8,0,39,31152,3,404,0,31559,31310,210
30-11-2021,kancheepuram,195,18,17,0,196,75579,18,4,0,75601,74141,1264
30-11-2021,kanyakumari,117,8,13,0,112,62648,8,124,0,62780,61611,1057
30-11-2021,karur,191,15,16,0,190,24558,15,47,0,24620,24068,362
30-11-2021,krishnagiri,88,7,9,0,86,43595,7,238,0,43840,43401,353
30-11-2021,madurai,104,8,11,0,101,75338,8,173,0,75519,74235,1183
30-11-2021,mayiladuthurai,30,1,1,0,30,23333,1,39,0,23373,23025,318
30-11-2021,nagapattinam,94,8,7,0,95,21273,8,53,0,21334,20882,357
30-11-2021,namakkal,468,42,34,0,476,53340,42,112,0,53494,52512,506
30-11-2021,nilgiris,193,13,19,0,187,34036,13,44,0,34093,33692,214
30-11-2021,perambalur,11,1,0,1,11,12100,1,3,0,12104,11848,245
30-11-2021,pudukottai,29,2,4,0,27,30290,2,35,0,30327,29882,418
30-11-2021,ramanathapuram,28,2,3,0,27,20492,2,135,0,20629,20243,359
30-11-2021,ranipet,35,4,5,0,34,43505,4,49,0,43558,42749,775
30-11-2021,salem,501,47,47,2,499,100862,47,438,0,101347,99144,1704
30-11-2021,sivagangai,51,4,5,0,50,20280,4,108,0,20392,20132,210
30-11-2021,tenkasi,12,0,1,0,11,27336,0,58,0,27394,26897,486
30-11-2021,thanjavur,240,14,21,0,233,76066,14,22,0,76102,74874,995
30-11-2021,theni,11,1,0,0,12,43560,1,45,0,43606,43073,521
30-11-2021,thirupathur,25,1,1,0,25,29274,1,118,0,29393,28741,627
30-11-2021,thiruvallur,281,28,22,3,284,120169,28,10,0,120207,118073,1850
30-11-2021,thiruvannamalai,58,5,8,0,55,54784,5,398,0,55187,54462,670
30-11-2021,thiruvarur,109,7,14,0,102,41821,7,38,0,41866,41306,458
30-11-2021,thoothukudi,40,2,6,0,36,56216,2,275,0,56493,56047,410
30-11-2021,tirunelveli,104,9,10,0,103,49219,9,427,0,49655,49119,433
30-11-2021,tiruppur,608,61,61,0,608,97099,61,11,0,97171,95564,999
30-11-2021,trichy,274,21,26,1,268,78364,21,65,0,78450,77099,1083
30-11-2021,vellore,143,15,7,0,151,48515,13,1664,2,50194,48902,1141
30-11-2021,villupuram,45,3,2,0,46,45841,3,174,0,46018,45615,357
30-11-2021,virudhunagar,25,2,1,0,26,46290,2,104,0,46396,45822,548
30-11-2021,airport surveillance (international),3,0,0,0,3,0,0,1031,0,1031,1027,1
30-11-2021,airport surveillance (domestic),0,0,0,0,0,0,0,1085,0,1085,1084,1
30-11-2021,railway surveillance,0,0,0,0,0,0,0,428,0,428,428,0
01-12-2021,ariyalur,20,1,2,0,19,16905,1,20,0,16926,16643,264
01-12-2021,chengalpattu,632,64,61,1,634,173772,64,5,0,173841,170673,2534
01-12-2021,chennai,1179,117,114,2,1180,557984,117,47,0,558148,548357,8611
01-12-2021,coimbatore,1233,118,112,2,1237,250128,118,51,0,250297,246594,2466
01-12-2021,cuddalore,79,6,8,0,77,64197,6,203,0,64406,63457,872
01-12-2021,dharmapuri,124,9,14,0,119,28595,9,216,0,28820,28423,278
01-12-2021,dindigul,51,5,6,1,49,33157,5,77,0,33239,32539,651
01-12-2021,erode,801,64,68,0,797,106218,64,94,0,106376,104883,696
01-12-2021,kallakurichi,39,2,5,0,36,31155,2,404,0,31561,31315,210
01-12-2021,kancheepuram,196,17,13,0,200,75597,17,4,0,75618,74154,1264
01-12-2021,kanyakumari,112,9,11,0,110,62656,9,124,0,62789,61622,1057
01-12-2021,karur,191,14,18,0,187,24574,14,47,0,24635,24086,362
01-12-2021,krishnagiri,86,8,7,0,87,43602,8,238,0,43848,43408,353
01-12-2021,madurai,99,7,9,0,97,75344,7,173,0,75524,74244,1183
01-12-2021,mayiladuthurai,30,2,2,0,30,23334,2,39,0,23375,23027,318
01-12-2021,nagapattinam,95,6,10,0,91,21281,6,53,0,21340,20892,357
01-12-2021,namakkal,476,40,32,0,484,53382,40,112,0,53534,52544,506
01-12-2021,nilgiris,187,15,16,0,186,34049,15,44,0,34108,33708,214
01-12-2021,perambalur,11,1,0,0,12,12101,1,3,0,12105,11848,245
01-12-2021,pudukottai,27,3,2,0,28,30292,3,35,0,30330,29884,418
01-12-2021,ramanathapuram,27,4,4,0,27,20494,4,135,0,20633,20247,359
01-12-2021,ranipet,34,3,2,0,35,43509,3,49,0,43561,42751,775
01-12-2021,salem,499,45,43,2,499,100909,45,438,0,101392,99187,1706
01-12-2021,sivagangai,50,5,3,0,52,20284,5,108,0,20397,20135,210
01-12-2021,tenkasi,11,0,1,0,10,27336,0,58,0,27394,26898,486
01-12-2021,thanjavur,233,13,26,1,219,76080,13,22,0,76115,74900,996
01-12-2021,theni,12,0,0,0,12,43561,0,45,0,43606,43073,521
01-12-2021,thirupathur,25,1,1,0,25,29275,1,118,0,29394,28742,627
01-12-2021,thiruvallur,282,26,22,0,286,120195,26,10,0,120231,118095,1850
01-12-2021,thiruvannamalai,56,4,7,0,53,54790,4,398,0,55192,54469,670
01-12-2021,thiruvarur,103,6,15,0,94,41829,6,38,0,41873,41321,458
01-12-2021,thoothukudi,36,3,4,0,35,56218,3,275,0,56496,56051,410
01-12-2021,tirunelveli,103,6,12,0,97,49228,6,427,0,49661,49131,433
01-12-2021,tiruppur,610,57,57,1,609,97162,57,11,0,97230,95621,1000
01-12-2021,trichy,268,16,29,1,254,78385,16,65,0,78466,77128,1084
01-12-2021,vellore,151,16,9,0,158,48528,7,1666,9,50210,48911,1141
01-12-2021,villupuram,47,4,2,0,49,45845,4,174,0,46023,45617,357
01-12-2021,virudhunagar,26,1,3,0,24,46292,1,104,0,46397,45825,548
01-12-2021,airport surveillance (international),3,0,1,0,2,0,0,1031,0,1031,1028,1
01-12-2021,airport surveillance (domestic),0,0,0,0,0,0,0,1085,0,1085,1084,1
01-12-2021,railway surveillance,0,0,0,0,0,0,0,428,0,428,428,0
02-12-2021,ariyalur,19,1,1,0,19,16906,1,20,0,16927,16644,264
02-12-2021,chengalpattu,636,58,65,0,629,173838,58,5,0,173901,170738,2534
02-12-2021,chennai,1169,123,119,2,1171,558090,123,47,0,558260,548476,8613
02-12-2021,coimbatore,1239,121,108,3,1249,250248,121,51,0,250420,246702,2469
02-12-2021,cuddalore,76,5,7,0,74,64202,5,203,0,64410,63464,872
02-12-2021,dharmapuri,119,8,16,1,110,28604,8,216,0,28828,28439,279
02-12-2021,dindigul,50,4,5,0,49,33163,4,77,0,33244,32544,651
02-12-2021,erode,796,65,71,2,788,106281,65,94,0,106440,104954,698
02-12-2021,kallakurichi,36,3,4,0,35,31157,3,404,0,31564,31319,210
02-12-2021,kancheepuram,200,20,15,0,205,75614,20,4,0,75638,74169,1264
02-12-2021,kanyakumari,111,8,12,0,107,62666,8,124,0,62798,61634,1057
02-12-2021,karur,184,13,17,0,180,24585,13,47,0,24645,24103,362
02-12-2021,krishnagiri,87,12,9,0,90,43610,12,238,0,43860,43417,353
02-12-2021,madurai,96,6,8,0,94,75350,6,173,0,75529,74252,1183
02-12-2021,mayiladuthurai,30,3,1,0,32,23336,3,39,0,23378,23028,318
02-12-2021,nagapattinam,91,5,11,0,85,21287,5,53,0,21345,20903,357
02-12-2021,namakkal,487,45,36,2,494,53425,45,112,0,53582,52580,508
02-12-2021,nilgiris,186,13,14,0,185,34064,13,44,0,34121,33722,214
02-12-2021,perambalur,12,1,0,0,13,12102,1,3,0,12106,11848,245
02-12-2021,pudukottai,28,4,2,0,30,30295,4,35,0,30334,29886,418
02-12-2021,ramanathapuram,27,1,3,0,25,20498,1,135,0,20634,20250,359
02-12-2021,ranipet,37,4,1,0,40,43514,4,49,0,43567,42752,775
02-12-2021,salem,500,44,41,0,503,100955,44,438,0,101437,99228,1706
02-12-2021,sivagangai,52,6,4,0,54,20289,6,108,0,20403,20139,210
02-12-2021,tenkasi,10,0,0,0,10,27336,0,58,0,27394,26898,486
02-12-2021,thanjavur,221,11,22,1,209,76095,11,22,0,76128,74922,997
02-12-2021,theni,12,1,0,0,13,43561,1,45,0,43607,43073,521
02-12-2021,thirupathur,25,2,1,0,26,29276,2,118,0,29396,28743,627
02-12-2021,thiruvallur,288,25,23,0,290,120223,25,10,0,120258,118118,1850
02-12-2021,thiruvannamalai,55,3,6,0,52,54796,3,398,0,55197,54475,670
02-12-2021,thiruvarur,94,5,13,0,86,41835,5,38,0,41878,41334,458
02-12-2021,thoothukudi,36,2,3,0,35,56222,2,275,0,56499,56054,410
02-12-2021,tirunelveli,96,5,10,0,91,49233,5,427,0,49665,49141,433
02-12-2021,tiruppur,610,53,59,0,604,97220,53,11,0,97284,95680,1000
02-12-2021,trichy,253,15,25,0,243,78400,15,65,0,78480,77153,1084
02-12-2021,vellore,156,15,11,0,160,48533,11,1675,4,50223,48922,1141
02-12-2021,villupuram,49,2,3,0,48,45849,2,174,0,46025,45620,357
02-12-2021,virudhunagar,25,3,2,1,25,46294,3,104,0,46401,45827,549
02-12-2021,airport surveillance (international),2,0,0,0,2,0,0,1031,0,1031,1028,1
02-12-2021,airport surveillance (domestic),0,0,0,0,0,0,0,1085,0,1085,1084,1
02-12-2021,railway surveillance,0,0,0,0,0,0,0,428,0,428,428,0
03-12-2021,ariyalur,19,1,3,0,17,16907,1,20,0,16928,16647,264
03-12-2021,chengalpattu,634,56,57,0,633,173901,56,5,0,173962,170795,2534
03-12-2021,chennai,1165,128,122,1,1170,558207,128,47,0,558382,548598,8614
03-12-2021,coimbatore,1252,127,111,1,1267,250372,127,51,0,250550,246813,2470
03-12-2021,cuddalore,74,6,5,0,75,64207,6,203,0,64416,63469,872
03-12-2021,dharmapuri,110,9,14,0,105,28612,9,216,0,28837,28453,279
03-12-2021,dindigul,49,5,6,0,48,33167,5,77,0,33249,32550,651
03-12-2021,erode,781,59,64,0,776,106339,59,94,0,106492,105018,698
03-12-2021,kallakurichi,35,0,7,0,28,31160,0,404,0,31564,31326,210
03-12-2021,kancheepuram,200,22,16,1,205,75629,22,4,0,75655,74185,1265
03-12-2021,kanyakumari,107,10,13,0,104,62674,10,124,0,62808,61647,1057
03-12-2021,karur,180,12,15,0,177,24598,12,47,0,24657,24118,362
03-12-2021,krishnagiri,91,10,10,0,91,43623,10,238,0,43871,43427,353
03-12-2021,madurai,95,8,12,0,91,75357,8,173,0,75538,74264,1183
03-12-2021,mayiladuthurai,32,1,2,0,31,23339,1,39,0,23379,23030,318
03-12-2021,nagapattinam,85,6,8,0,83,21292,6,53,0,21351,20911,357
03-12-2021,namakkal,498,43,42,0,499,53474,43,112,0,53629,52622,508
03-12-2021,nilgiris,185,10,17,1,177,34077,10,44,0,34131,33739,215
03-12-2021,perambalur,13,1,2,0,12,12103,1,3,0,12107,11850,245
03-12-2021,pudukottai,30,3,4,0,29,30299,3,35,0,30337,29890,418
03-12-2021,ramanathapuram,25,3,6,0,22,20499,3,135,0,20637,20256,359
03-12-2021,ranipet,43,5,1,0,47,43521,5,49,0,43575,42753,775
03-12-2021,salem,504,41,35,3,507,101000,41,438,0,101479,99263,1709
03-12-2021,sivagangai,54,5,5,0,54,20295,5,108,0,20408,20144,210
03-12-2021,tenkasi,10,0,1,0,9,27336,0,58,0,27394,26899,486
03-12-2021,thanjavur,210,12,23,0,199,76107,12,22,0,76141,74945,997
03-12-2021,theni,13,1,2,0,12,43562,1,45,0,43608,43075,521
03-12-2021,thirupathur,24,1,1,0,24,29276,1,118,0,29395,28744,627
03-12-2021,thiruvallur,291,27,25,0,293,120249,27,10,0,120286,118143,1850
03-12-2021,thiruvannamalai,57,4,9,0,52,54804,4,398,0,55206,54484,670
03-12-2021,thiruvarur,85,6,7,1,83,41839,6,38,0,41883,41341,459
03-12-2021,thoothukudi,35,1,5,1,30,56224,1,275,0,56500,56059,411
03-12-2021,tirunelveli,91,3,11,0,83,49238,3,427,0,49668,49152,433
03-12-2021,tiruppur,606,52,54,0,604,97275,52,11,0,97338,95734,1000
03-12-2021,trichy,242,16,27,0,231,78414,16,65,0,78495,77180,1084
03-12-2021,vellore,155,12,10,0,157,48539,6,1679,6,50230,48932,1141
03-12-2021,villupuram,48,4,4,0,48,45851,4,174,0,46029,45624,357
03-12-2021,virudhunagar,25,0,3,0,22,46297,0,104,0,46401,45830,549
03-12-2021,airport surveillance (international),2,1,0,0,3,0,0,1031,1,1032,1028,1
03-12-2021,airport surveillance (domestic),0,0,0,0,0,0,0,1085,0,1085,1084,1
03-12-2021,railway surveillance,0,0,0,0,0,0,0,428,0,428,428,0
04-12-2021,ariyalur,17,1,2,0,16,16908,1,20,0,16929,16649,264
04-12-2021,chengalpattu,639,54,61,0,632,173963,54,5,0,174022,170856,2534
04-12-2021,chennai,1163,136,124,0,1175,558328,136,47,0,558511,548722,8614
04-12-2021,coimbatore,1268,130,113,1,1284,250500,130,51,0,250681,246926,2471
04-12-2021,cuddalore,75,5,6,0,74,64213,5,203,0,64421,63475,872
04-12-2021,dharmapuri,106,7,10,0,103,28622,7,216,0,28845,28463,279
04-12-2021,dindigul,48,4,3,0,49,33172,4,77,0,33253,32553,651
04-12-2021,erode,776,57,62,1,770,106398,57,94,0,106549,105080,699
04-12-2021,kallakurichi,28,2,4,0,26,31160,2,404,0,31566,31330,210
04-12-2021,kancheepuram,205,19,11,0,213,75651,19,4,0,75674,74196,1265
04-12-2021,kanyakumari,104,12,14,0,102,62684,12,124,0,62820,61661,1057
04-12-2021,karur,177,15,16,0,176,24610,15,47,0,24672,24134,362
04-12-2021,krishnagiri,90,9,7,0,92,43632,9,238,0,43879,43434,353
04-12-2021,madurai,89,10,9,0,90,75363,10,173,0,75546,74273,1183
04-12-2021,mayiladuthurai,30,1,2,0,29,23339,1,39,0,23379,23032,318
04-12-2021,nagapattinam,83,5,13,0,75,21298,5,53,0,21356,20924,357
04-12-2021,namakkal,499,45,48,1,495,53517,45,112,0,53674,52670,509
04-12-2021,nilgiris,177,11,19,1,168,34087,11,44,0,34142,33758,216
04-12-2021,perambalur,12,2,1,0,13,12104,2,3,0,12109,11851,245
04-12-2021,pudukottai,29,2,3,0,28,30302,2,35,0,30339,29893,418
04-12-2021,ramanathapuram,22,0,2,0,20,20502,0,135,0,20637,20258,359
04-12-2021,ranipet,47,4,5,0,46,43526,4,49,0,43579,42758,775
04-12-2021,salem,509,39,37,1,510,101043,39,438,0,101520,99300,1710
04-12-2021,sivagangai,54,7,4,0,57,20300,7,108,0,20415,20148,210
04-12-2021,tenkasi,9,0,2,0,7,27336,0,58,0,27394,26901,486
04-12-2021,thanjavur,199,13,25,1,186,76119,13,22,0,76154,74970,998
04-12-2021,theni,12,1,1,0,12,43563,1,45,0,43609,43076,521
04-12-2021,thirupathur,24,1,2,0,23,29277,1,118,0,29396,28746,627
04-12-2021,thiruvallur,290,29,21,0,298,120273,29,10,0,120312,118164,1850
04-12-2021,thiruvannamalai,52,3,8,0,47,54808,3,398,0,55209,54492,670
04-12-2021,thiruvarur,85,8,10,0,83,41847,8,38,0,41893,41351,459
04-12-2021,thoothukudi,31,3,3,0,31,56226,3,275,0,56504,56062,411
04-12-2021,tirunelveli,84,1,12,0,73,49242,1,427,0,49670,49164,433
04-12-2021,tiruppur,604,50,49,0,605,97327,50,11,0,97388,95783,1000
04-12-2021,trichy,231,25,24,0,232,78430,25,65,0,78520,77204,1084
04-12-2021,vellore,157,14,15,0,156,48545,10,1685,4,50244,48947,1141
04-12-2021,villupuram,48,3,3,0,48,45855,3,174,0,46032,45627,357
04-12-2021,virudhunagar,22,2,1,0,23,46297,2,104,0,46403,45831,549
04-12-2021,airport surveillance (international),3,1,1,0,3,0,0,1032,1,1033,1029,1
04-12-2021,airport surveillance (domestic),0,0,0,0,0,0,0,1085,0,1085,1084,1
04-12-2021,railway surveillance,0,0,0,0,0,0,0,428,0,428,428,0
05-12-2021,ariyalur,15,1,0,0,16,16908,1,20,0,16929,16649,264
05-12-2021,chengalpattu,633,61,59,0,635,174018,61,5,0,174084,170915,2534
05-12-2021,chennai,1170,131,116,2,1183,558459,131,47,0,558637,548838,8616
05-12-2021,coimbatore,1284,124,129,0,1279,250630,124,51,0,250805,247055,2471
05-12-2021,cuddalore,75,9,5,0,79,64219,9,203,0,64431,63480,872
05-12-2021,dharmapuri,103,6,8,0,101,28629,6,216,0,28851,28471,279
05-12-2021,dindigul,49,5,2,0,52,33176,5,77,0,33258,32555,651
05-12-2021,erode,762,59,67,0,754,106447,59,94,0,106600,105147,699
05-12-2021,kallakurichi,26,4,1,0,29,31162,4,404,0,31570,31331,210
05-12-2021,kancheepuram,216,18,14,0,220,75673,18,4,0,75695,74210,1265
05-12-2021,kanyakumari,102,11,10,0,103,62696,11,124,0,62831,61671,1057
05-12-2021,karur,175,14,17,0,172,24624,14,47,0,24685,24151,362
05-12-2021,krishnagiri,92,8,4,1,95,43641,8,238,0,43887,43438,354
05-12-2021,madurai,89,7,8,0,88,75372,7,173,0,75552,74281,1183
05-12-2021,mayiladuthurai,29,2,3,0,28,23340,2,39,0,23381,23035,318
05-12-2021,nagapattinam,76,4,9,0,71,21304,4,53,0,21361,20933,357
05-12-2021,namakkal,499,41,51,1,488,53566,41,112,0,53719,52721,510
05-12-2021,nilgiris,168,10,16,0,162,34098,10,44,0,34152,33774,216
05-12-2021,perambalur,13,0,0,0,13,12106,0,3,0,12109,11851,245
05-12-2021,pudukottai,28,1,2,1,26,30304,1,35,0,30340,29895,419
05-12-2021,ramanathapuram,20,0,1,0,19,20502,0,135,0,20637,20259,359
05-12-2021,ranipet,49,3,6,0,46,43533,3,49,0,43585,42764,775
05-12-2021,salem,513,37,42,2,506,101085,37,438,0,101560,99342,1712
05-12-2021,sivagangai,57,5,3,0,59,20307,5,108,0,20420,20151,210
05-12-2021,tenkasi,7,1,2,0,6,27336,1,58,0,27395,26903,486
05-12-2021,thanjavur,187,11,27,0,171,76133,11,22,0,76166,74997,998
05-12-2021,theni,12,0,0,0,12,43564,0,45,0,43609,43076,521
05-12-2021,thirupathur,23,3,1,0,25,29278,3,118,0,29399,28747,627
05-12-2021,thiruvallur,297,28,26,0,299,120301,28,10,0,120339,118190,1850
05-12-2021,thiruvannamalai,49,4,5,0,48,54813,4,398,0,55215,54497,670
05-12-2021,thiruvarur,81,7,9,1,78,41853,7,38,0,41898,41360,460
05-12-2021,thoothukudi,31,6,2,0,35,56229,6,275,0,56510,56064,411
05-12-2021,tirunelveli,72,4,7,0,69,49242,4,427,0,49673,49171,433
05-12-2021,tiruppur,608,65,46,1,626,97380,65,11,0,97456,95829,1001
05-12-2021,trichy,233,20,28,0,225,78456,20,65,0,78541,77232,1084
05-12-2021,vellore,153,11,11,1,152,48552,11,1689,0,50252,48958,1142
05-12-2021,villupuram,48,2,2,0,48,45858,2,174,0,46034,45629,357
05-12-2021,virudhunagar,23,1,4,0,20,46299,1,104,0,46404,45835,549
05-12-2021,airport surveillance (international),3,0,0,0,3,0,0,1033,0,1033,1029,1
05-12-2021,airport surveillance (domestic),0,0,0,0,0,0,0,1085,0,1085,1084,1
05-12-2021,railway surveillance,0,0,0,0,0,0,0,428,0,428,428,0
06-12-2021,ariyalur,16,2,1,0,17,16909,2,20,0,16931,16650,264
06-12-2021,chengalpattu,635,59,62,2,630,174079,59,5,0,174143,170977,2536
06-12-2021,chennai,1175,128,113,1,1189,558582,128,47,0,558757,548951,8617
06-12-2021,coimbatore,1281,120,127,2,1272,250756,120,51,0,250927,247182,2473
06-12-2021,cuddalore,76,8,6,0,78,64225,8,203,0,64436,63486,872
06-12-2021,dharmapuri,103,5,9,0,99,28637,5,216,0,28858,28480,279
06-12-2021,dindigul,52,4,4,0,52,33181,4,77,0,33262,32559,651
06-12-2021,erode,746,58,65,0,739,106498,58,94,0,106650,105212,699
06-12-2021,kallakurichi,29,2,2,0,29,31166,2,404,0,31572,31333,210
06-12-2021,kancheepuram,221,19,15,0,225,75692,19,4,0,75715,74225,1265
06-12-2021,kanyakumari,103,10,11,1,101,62707,10,124,0,62841,61682,1058
06-12-2021,karur,172,16,16,0,172,24638,16,47,0,24701,24167,362
06-12-2021,krishnagiri,94,11,5,0,100,43648,11,238,0,43897,43443,354
06-12-2021,madurai,88,6,7,1,86,75379,6,173,0,75558,74288,1184
06-12-2021,mayiladuthurai,31,4,2,0,33,23345,4,39,0,23388,23037,318
06-12-2021,nagapattinam,70,5,8,0,67,21307,5,53,0,21365,20941,357
06-12-2021,namakkal,486,40,49,1,476,53605,40,112,0,53757,52770,511
06-12-2021,nilgiris,163,12,13,0,162,34109,12,44,0,34165,33787,216
06-12-2021,perambalur,13,0,0,0,13,12106,0,3,0,12109,11851,245
06-12-2021,pudukottai,26,1,1,0,26,30305,1,35,0,30341,29896,419
06-12-2021,ramanathapuram,19,1,0,0,20,20502,1,135,0,20638,20259,359
06-12-2021,ranipet,45,8,4,1,48,43536,8,49,0,43593,42768,777
06-12-2021,salem,509,39,39,0,509,101125,39,438,0,101602,99381,1712
06-12-2021,sivagangai,59,4,3,0,60,20312,4,108,0,20424,20154,210
06-12-2021,tenkasi,6,1,1,0,6,27337,1,58,0,27396,26904,486
06-12-2021,thanjavur,172,10,23,0,159,76145,10,22,0,76177,75020,998
06-12-2021,theni,12,1,0,0,13,43564,1,45,0,43610,43076,521
06-12-2021,thirupathur,25,4,1,0,28,29281,4,118,0,29403,28748,627
06-12-2021,thiruvallur,300,27,29,0,298,120330,27,10,0,120367,118219,1850
06-12-2021,thiruvannamalai,48,6,6,0,48,54817,6,398,0,55221,54503,670
06-12-2021,thiruvarur,78,9,10,0,77,41860,9,38,0,41907,41370,460
06-12-2021,thoothukudi,36,5,3,0,38,56236,5,275,0,56516,56067,411
06-12-2021,tirunelveli,69,5,8,0,66,49246,5,427,0,49678,49179,433
06-12-2021,tiruppur,632,59,48,0,643,97451,59,11,0,97521,95877,1001
06-12-2021,trichy,226,19,27,0,218,78477,19,65,0,78561,77259,1084
06-12-2021,vellore,154,10,12,0,152,48564,10,1689,0,50263,48970,1141
06-12-2021,villupuram,48,1,3,1,45,45860,1,174,0,46035,45632,358
06-12-2021,virudhunagar,20,0,4,0,16,46300,0,104,0,46404,45839,549
06-12-2021,airport surveillance (international),3,0,0,0,3,0,0,1033,0,1033,1029,1
06-12-2021,airport surveillance (domestic),0,0,0,0,0,0,0,1085,0,1085,1084,1
06-12-2021,railway surveillance,0,0,0,0,0,0,0,428,0,428,428,0
07-12-2021,ariyalur,17,0,2,0,15,16911,0,20,0,16931,16652,264
07-12-2021,chengalpattu,630,57,64,1,622,174138,57,5,0,174200,171041,2537
07-12-2021,chennai,1185,126,97,2,1212,558706,126,47,0,558879,549048,8619
07-12-2021,coimbatore,1273,122,129,1,1265,250877,122,51,0,251050,247311,2474
07-12-2021,cuddalore,77,7,7,1,76,64232,7,203,0,64442,63493,873
07-12-2021,dharmapuri,99,4,8,0,95,28642,4,216,0,28862,28488,279
07-12-2021,dindigul,52,4,6,0,50,33185,4,77,0,33266,32565,651
07-12-2021,erode,733,56,67,0,722,106550,56,94,0,106700,105279,699
07-12-2021,kallakurichi,29,1,3,0,27,31168,1,404,0,31573,31336,210
07-12-2021,kancheepuram,226,23,17,0,232,75712,23,4,0,75739,74242,1265
07-12-2021,kanyakumari,101,9,6,1,103,62717,9,124,0,62850,61688,1059
07-12-2021,karur,172,14,18,0,168,24654,14,47,0,24715,24185,362
07-12-2021,krishnagiri,99,13,3,0,109,43658,13,238,0,43909,43446,354
07-12-2021,madurai,87,7,9,1,84,75386,7,173,0,75566,74297,1185
07-12-2021,mayiladuthurai,34,3,7,0,30,23350,3,39,0,23392,23044,318
07-12-2021,nagapattinam,68,3,5,0,66,21313,3,53,0,21369,20946,357
07-12-2021,namakkal,481,38,53,0,466,53650,38,112,0,53800,52823,511
07-12-2021,nilgiris,162,11,15,0,158,34121,11,44,0,34176,33802,216
07-12-2021,perambalur,13,1,1,0,13,12106,1,3,0,12110,11852,245
07-12-2021,pudukottai,26,0,1,0,25,30306,0,35,0,30341,29897,419
07-12-2021,ramanathapuram,20,1,3,0,18,20503,1,135,0,20639,20262,359
07-12-2021,ranipet,49,6,4,1,50,43545,6,49,0,43600,42772,778
07-12-2021,salem,509,43,43,1,508,101164,43,438,0,101645,99424,1713
07-12-2021,sivagangai,59,5,2,0,62,20315,5,108,0,20428,20156,210
07-12-2021,tenkasi,6,1,1,0,6,27338,1,58,0,27397,26905,486
07-12-2021,thanjavur,157,14,21,0,150,76153,14,22,0,76189,75041,998
07-12-2021,theni,14,1,2,0,13,43566,1,45,0,43612,43078,521
07-12-2021,thirupathur,28,5,3,0,30,29285,5,118,0,29408,28751,627
07-12-2021,thiruvallur,298,26,24,0,300,120357,26,10,0,120393,118243,1850
07-12-2021,thiruvannamalai,48,8,4,1,51,54823,8,398,0,55229,54507,671
07-12-2021,thiruvarur,77,8,6,0,79,41869,8,38,0,41915,41376,460
07-12-2021,thoothukudi,39,3,5,0,37,56242,3,275,0,56520,56072,411
07-12-2021,tirunelveli,65,4,7,0,62,49250,4,427,0,49681,49186,433
07-12-2021,tiruppur,646,52,52,0,646,97513,52,11,0,97576,95929,1001
07-12-2021,trichy,218,17,23,0,212,78496,17,65,0,78578,77282,1084
07-12-2021,vellore,151,13,7,0,157,48573,11,1689,2,50275,48977,1141
07-12-2021,villupuram,46,4,4,0,46,45862,4,174,0,46040,45636,358
07-12-2021,virudhunagar,16,0,2,0,14,46300,0,104,0,46404,45841,549
07-12-2021,airport surveillance (international),3,0,0,0,3,0,0,1033,0,1033,1029,1
07-12-2021,airport surveillance (domestic),0,0,0,0,0,0,0,1085,0,1085,1084,1
07-12-2021,railway surveillance,0,0,0,0,0,0,0,428,0,428,428,0
08-12-2021,ariyalur,15,1,1,0,15,16911,1,20,0,16932,16653,264
08-12-2021,chengalpattu,623,56,58,0,621,174196,56,5,0,174257,171099,2537
08-12-2021,chennai,1208,122,92,3,1235,558828,122,47,0,558997,549140,8622
08-12-2021,coimbatore,1265,117,131,4,1247,250999,117,51,0,251167,247442,2478
08-12-2021,cuddalore,76,5,9,0,72,64239,5,203,0,64447,63502,873
08-12-2021,dharmapuri,95,7,6,0,96,28646,7,216,0,28869,28494,279
08-12-2021,dindigul,50,3,3,0,50,33189,3,77,0,33269,32568,651
08-12-2021,erode,722,58,69,0,711,106606,58,94,0,106758,105348,699
08-12-2021,kallakurichi,27,5,1,0,31,31169,5,404,0,31578,31337,210
08-12-2021,kancheepuram,232,22,22,0,232,75735,22,4,0,75761,74264,1265
08-12-2021,kanyakumari,104,10,5,0,109,62727,10,124,0,62861,61693,1059
08-12-2021,karur,167,16,19,1,163,24667,16,47,0,24730,24204,363
08-12-2021,krishnagiri,109,11,10,0,110,43671,11,238,0,43920,43456,354
08-12-2021,madurai,84,6,7,0,83,75393,6,173,0,75572,74304,1185
08-12-2021,mayiladuthurai,30,3,5,0,28,23353,3,39,0,23395,23049,318
08-12-2021,nagapattinam,66,3,3,0,66,21316,3,53,0,21372,20949,357
08-12-2021,namakkal,466,39,41,0,464,53688,39,112,0,53839,52864,511
08-12-2021,nilgiris,158,10,18,0,150,34132,10,44,0,34186,33820,216
08-12-2021,perambalur,13,0,3,0,10,12107,0,3,0,12110,11855,245
08-12-2021,pudukottai,26,2,4,0,24,30307,2,35,0,30344,29901,419
08-12-2021,ramanathapuram,18,2,2,0,18,20504,2,135,0,20641,20264,359
08-12-2021,ranipet,51,5,3,0,53,43552,5,49,0,43606,42775,778
08-12-2021,salem,508,44,46,1,505,101207,44,438,0,101689,99470,1714
08-12-2021,sivagangai,62,4,4,0,62,20320,4,108,0,20432,20160,210
08-12-2021,tenkasi,5,1,0,0,6,27338,1,58,0,27397,26905,486
08-12-2021,thanjavur,149,13,16,0,146,76166,13,22,0,76201,75057,998
08-12-2021,theni,13,0,4,0,9,43567,0,45,0,43612,43082,521
08-12-2021,thirupathur,31,4,5,0,30,29291,4,118,0,29413,28756,627
08-12-2021,thiruvallur,299,25,21,0,303,120382,25,10,0,120417,118264,1850
08-12-2021,thiruvannamalai,51,6,3,0,54,54831,6,398,0,55235,54510,671
08-12-2021,thiruvarur,80,9,7,0,82,41878,9,38,0,41925,41383,460
08-12-2021,thoothukudi,37,4,2,0,39,56245,4,275,0,56524,56074,411
08-12-2021,tirunelveli,62,5,6,1,60,49254,5,427,0,49686,49192,434
08-12-2021,tiruppur,646,50,56,0,640,97565,50,11,0,97626,95985,1001
08-12-2021,trichy,214,19,20,1,212,78515,19,65,0,78599,77302,1085
08-12-2021,vellore,157,11,17,0,151,48584,11,1691,0,50286,48994,1141
08-12-2021,villupuram,46,3,8,0,41,45866,3,174,0,46043,45644,358
08-12-2021,virudhunagar,14,2,1,0,15,46300,2,104,0,46406,45842,549
08-12-2021,airport surveillance (international),3,0,0,0,3,0,0,1033,0,1033,1029,1
08-12-2021,airport surveillance (domestic),0,0,0,0,0,0,0,1085,0,1085,1084,1
08-12-2021,railway surveillance,0,0,0,0,0,0,0,428,0,428,428,0
09-12-2021,ariyalur,14,0,2,0,12,16911,0,20,0,16931,16655,264
09-12-2021,chengalpattu,621,53,63,1,610,174252,53,5,0,174310,171162,2538
09-12-2021,chennai,1232,125,91,1,1265,558947,125,47,0,559119,549231,8623
09-12-2021,coimbatore,1248,112,123,2,1235,251117,112,51,0,251280,247565,2480
09-12-2021,cuddalore,72,6,7,0,71,64244,6,203,0,64453,63509,873
09-12-2021,dharmapuri,95,6,11,0,90,28652,6,216,0,28874,28505,279
09-12-2021,dindigul,49,4,2,0,51,33191,4,77,0,33272,32570,651
09-12-2021,erode,712,60,66,1,705,106665,60,94,0,106819,105414,700
09-12-2021,kallakurichi,31,3,2,0,32,31174,3,404,0,31581,31339,210
09-12-2021,kancheepuram,232,21,25,0,228,75757,21,4,0,75782,74289,1265
09-12-2021,kanyakumari,109,16,6,0,119,62737,16,124,0,62877,61699,1059
09-12-2021,karur,164,14,18,1,159,24684,14,47,0,24745,24222,364
09-12-2021,krishnagiri,110,10,8,1,111,43682,10,238,0,43930,43464,355
09-12-2021,madurai,83,5,9,0,79,75399,5,173,0,75577,74313,1185
09-12-2021,mayiladuthurai,28,2,6,0,24,23356,2,39,0,23397,23055,318
09-12-2021,nagapattinam,66,5,10,0,61,21319,5,53,0,21377,20959,357
09-12-2021,namakkal,464,38,43,2,457,53727,38,112,0,53877,52907,513
09-12-2021,nilgiris,150,15,16,1,148,34142,15,44,0,34201,33836,217
09-12-2021,perambalur,11,0,2,0,9,12108,0,3,0,12111,11857,245
09-12-2021,pudukottai,24,2,3,0,23,30309,2,35,0,30346,29904,419
09-12-2021,ramanathapuram,18,3,1,0,20,20506,3,135,0,20644,20265,359
09-12-2021,ranipet,54,4,6,0,52,43558,4,49,0,43611,42781,778
09-12-2021,salem,505,42,48,0,499,101251,42,438,0,101731,99518,1714
09-12-2021,sivagangai,62,5,7,0,60,20324,5,108,0,20437,20167,210
09-12-2021,tenkasi,6,0,1,0,5,27339,0,58,0,27397,26906,486
09-12-2021,thanjavur,146,15,17,0,144,76179,15,22,0,76216,75074,998
09-12-2021,theni,9,2,2,0,9,43567,2,45,0,43614,43084,521
09-12-2021,thirupathur,31,3,6,0,28,29296,3,118,0,29417,28762,627
09-12-2021,thiruvallur,304,24,24,1,303,120408,24,10,0,120442,118288,1851
09-12-2021,thiruvannamalai,55,7,4,1,57,54838,7,398,0,55243,54514,672
09-12-2021,thiruvarur,82,8,5,0,85,41887,8,38,0,41933,41388,460
09-12-2021,thoothukudi,39,3,4,0,38,56250,3,275,0,56528,56078,412
09-12-2021,tirunelveli,60,4,8,0,56,49258,4,427,0,49689,49200,433
09-12-2021,tiruppur,640,47,55,2,630,97615,47,11,0,97673,96040,1003
09-12-2021,trichy,212,21,23,1,209,78534,21,65,0,78620,77325,1086
09-12-2021,vellore,149,10,14,0,145,48593,8,1691,2,50294,49008,1141
09-12-2021,villupuram,41,2,7,0,36,45869,2,174,0,46045,45651,358
09-12-2021,virudhunagar,15,1,1,0,15,46302,1,104,0,46407,45843,549
09-12-2021,airport surveillance (international),3,0,0,0,3,0,0,1033,0,1033,1029,1
09-12-2021,airport surveillance (domestic),0,0,0,0,0,0,0,1085,0,1085,1084,1
09-12-2021,railway surveillance,0,0,0,0,0,0,0,428,0,428,428,0
10-12-2021,ariyalur,12,0,1,0,11,16911,0,20,0,16931,16656,264
10-12-2021,chengalpattu,610,52,56,0,606,174305,52,5,0,174362,171218,2538
10-12-2021,chennai,1266,123,92,2,1295,559073,123,47,0,559243,549323,8625
10-12-2021,coimbatore,1236,110,127,3,1216,251230,110,51,0,251391,247692,2483
10-12-2021,cuddalore,71,7,8,0,70,64250,7,203,0,64460,63517,873
10-12-2021,dharmapuri,90,5,12,0,83,28658,5,216,0,28879,28517,279
10-12-2021,dindigul,52,3,5,0,50,33196,3,77,0,33276,32575,651
10-12-2021,erode,696,59,68,0,687,106716,59,94,0,106869,105482,700
10-12-2021,kallakurichi,32,2,4,0,30,31177,2,404,0,31583,31343,210
10-12-2021,kancheepuram,228,20,24,0,224,75778,20,4,0,75802,74313,1265
10-12-2021,kanyakumari,119,14,11,0,122,62753,14,124,0,62891,61710,1059
10-12-2021,karur,159,15,13,0,161,24698,15,47,0,24760,24235,364
10-12-2021,krishnagiri,111,14,10,0,115,43692,14,238,0,43944,43474,355
10-12-2021,madurai,79,4,6,0,77,75404,4,173,0,75581,74319,1185
10-12-2021,mayiladuthurai,25,1,2,0,24,23359,1,39,0,23399,23057,318
10-12-2021,nagapattinam,61,7,7,0,61,21324,7,53,0,21384,20966,357
10-12-2021,namakkal,460,40,45,1,454,53768,40,112,0,53920,52952,514
10-12-2021,nilgiris,148,14,19,1,142,34157,14,44,0,34215,33855,218
10-12-2021,perambalur,9,0,0,0,9,12108,0,3,0,12111,11857,245
10-12-2021,pudukottai,23,3,2,0,24,30311,3,35,0,30349,29906,419
10-12-2021,ramanathapuram,20,2,1,0,21,20509,2,135,0,20646,20266,359
10-12-2021,ranipet,52,5,3,0,54,43562,5,49,0,43616,42784,778
10-12-2021,salem,500,45,46,1,498,101294,45,438,0,101777,99564,1715
10-12-2021,sivagangai,59,4,8,0,55,20328,4,108,0,20440,20175,210
10-12-2021,tenkasi,5,0,0,0,5,27339,0,58,0,27397,26906,486
10-12-2021,thanjavur,140,14,14,0,140,76190,14,22,0,76226,75088,998
10-12-2021,theni,9,0,1,0,8,43569,0,45,0,43614,43085,521
10-12-2021,thirupathur,29,2,3,0,28,29300,2,118,0,29420,28765,627
10-12-2021,thiruvallur,303,23,28,1,297,120432,23,10,0,120465,118316,1852
10-12-2021,thiruvannamalai,57,8,6,0,59,54845,8,398,0,55251,54520,672
10-12-2021,thiruvarur,88,7,9,1,85,41898,7,38,0,41943,41397,461
10-12-2021,thoothukudi,38,2,3,0,37,56253,2,275,0,56530,56081,412
10-12-2021,tirunelveli,56,3,6,0,53,49262,3,427,0,49692,49206,433
10-12-2021,tiruppur,634,49,59,0,624,97666,49,11,0,97726,96099,1003
10-12-2021,trichy,208,19,21,1,205,78554,19,65,0,78638,77346,1087
10-12-2021,vellore,144,11,12,0,143,48600,10,1693,1,50304,49020,1141
10-12-2021,villupuram,36,1,5,0,32,45871,1,174,0,46046,45656,358
10-12-2021,virudhunagar,15,0,2,0,13,46303,0,104,0,46407,45845,549
10-12-2021,airport surveillance (international),3,0,0,0,3,0,0,1033,0,1033,1029,1
10-12-2021,airport surveillance (domestic),0,0,0,0,0,0,0,1085,0,1085,1084,1
10-12-2021,railway surveillance,0,0,0,0,0,0,0,428,0,428,428,0
11-12-2021,ariyalur,11,1,1,0,11,16911,1,20,0,16932,16657,264
11-12-2021,chengalpattu,609,50,57,0,602,174360,50,5,0,174415,171275,2538
11-12-2021,chennai,1291,120,102,2,1307,559192,120,47,0,559359,549425,8627
11-12-2021,coimbatore,1217,108,121,4,1200,251341,108,51,0,251500,247813,2487
11-12-2021,cuddalore,70,6,7,0,69,64257,6,203,0,64466,63524,873
11-12-2021,dharmapuri,83,4,8,0,79,28663,4,216,0,28883,28525,279
11-12-2021,dindigul,50,4,5,0,49,33199,4,77,0,33280,32580,651
11-12-2021,erode,687,54,69,2,670,106775,54,94,0,106923,105551,702
11-12-2021,kallakurichi,30,0,3,0,27,31179,0,404,0,31583,31346,210
11-12-2021,kancheepuram,224,16,20,0,220,75798,16,4,0,75818,74333,1265
11-12-2021,kanyakumari,122,13,12,0,123,62767,13,124,0,62904,61722,1059
11-12-2021,karur,161,14,15,0,160,24713,14,47,0,24774,24250,364
11-12-2021,krishnagiri,115,17,10,0,122,43706,17,238,0,43961,43484,355
11-12-2021,madurai,78,5,7,1,75,75409,5,173,0,75587,74326,1186
11-12-2021,mayiladuthurai,25,2,1,0,26,23361,2,39,0,23402,23058,318
11-12-2021,nagapattinam,60,5,6,0,59,21330,5,53,0,21388,20972,357
11-12-2021,namakkal,454,49,43,0,460,53808,49,112,0,53969,52995,514
11-12-2021,nilgiris,142,19,14,0,147,34171,19,44,0,34234,33869,218
11-12-2021,perambalur,9,0,1,0,8,12108,0,3,0,12111,11858,245
11-12-2021,pudukottai,24,4,2,1,25,30314,4,35,0,30353,29908,420
11-12-2021,ramanathapuram,21,1,2,0,20,20511,1,135,0,20647,20268,359
11-12-2021,ranipet,54,4,5,0,53,43567,4,49,0,43620,42789,778
11-12-2021,salem,499,43,54,0,488,101340,43,438,0,101821,99618,1715
11-12-2021,sivagangai,55,3,5,0,53,20332,3,108,0,20443,20180,210
11-12-2021,tenkasi,5,1,0,0,6,27339,1,58,0,27398,26906,486
11-12-2021,thanjavur,139,13,12,0,140,76203,13,22,0,76238,75100,998
11-12-2021,theni,8,0,0,0,8,43569,0,45,0,43614,43085,521
11-12-2021,thirupathur,29,3,2,0,30,29303,3,118,0,29424,28767,627
11-12-2021,thiruvallur,294,22,24,1,291,120452,22,10,0,120484,118340,1853
11-12-2021,thiruvannamalai,60,7,4,0,63,54854,7,398,0,55259,54524,672
11-12-2021,thiruvarur,86,8,6,0,88,41906,8,38,0,41952,41403,461
11-12-2021,thoothukudi,37,2,3,0,36,56255,2,275,0,56532,56084,412
11-12-2021,tirunelveli,53,5,8,1,49,49265,5,427,0,49697,49214,434
11-12-2021,tiruppur,624,48,58,0,614,97715,48,11,0,97774,96157,1003
11-12-2021,trichy,205,18,18,1,204,78573,18,65,0,78656,77364,1088
11-12-2021,vellore,141,9,11,0,139,48608,9,1694,0,50311,49031,1141
11-12-2021,villupuram,33,2,2,0,33,45873,2,174,0,46049,45658,358
11-12-2021,virudhunagar,13,1,1,0,13,46303,1,104,0,46408,45846,549
11-12-2021,airport surveillance (international),3,0,0,0,3,0,0,1033,0,1033,1029,1
11-12-2021,airport surveillance (domestic),0,0,0,0,0,0,0,1085,0,1085,1084,1
11-12-2021,railway surveillance,0,0,0,0,0,0,0,428,0,428,428,0
13-12-2021,ariyalur,11,1,2,0,10,16913,1,20,0,16934,16660,264
13-12-2021,chengalpattu,598,47,53,1,591,174461,47,5,0,174513,171383,2539
13-12-2021,chennai,1308,114,108,3,1311,559420,114,47,0,559581,549639,8631
13-12-2021,coimbatore,1179,101,120,0,1160,251552,101,51,0,251704,248056,2488
13-12-2021,cuddalore,67,7,5,0,69,64268,7,203,0,64478,63535,874
13-12-2021,dharmapuri,84,9,9,0,84,28679,9,216,0,28904,28541,279
13-12-2021,dindigul,48,2,3,1,46,33206,2,77,0,33285,32587,652
13-12-2021,erode,639,53,68,3,621,106869,53,94,0,107016,105690,705
13-12-2021,kallakurichi,27,1,1,0,27,31181,1,404,0,31586,31349,210
13-12-2021,kancheepuram,218,17,20,1,214,75833,17,4,0,75854,74374,1266
13-12-2021,kanyakumari,126,12,12,0,126,62794,12,124,0,62930,61745,1059
13-12-2021,karur,160,15,14,0,161,24740,15,47,0,24802,24277,364
13-12-2021,krishnagiri,126,13,10,0,129,43736,13,238,0,43987,43503,355
13-12-2021,madurai,73,7,7,0,73,75420,7,173,0,75600,74341,1186
13-12-2021,mayiladuthurai,27,1,1,0,27,23365,1,39,0,23405,23060,318
13-12-2021,nagapattinam,59,3,4,0,58,21340,3,53,0,21396,20981,357
13-12-2021,namakkal,461,47,42,0,466,53905,47,112,0,54064,53082,516
13-12-2021,nilgiris,152,19,18,0,153,34211,19,44,0,34274,33903,218
13-12-2021,perambalur,10,1,0,0,11,12110,1,3,0,12114,11858,245
13-12-2021,pudukottai,28,3,4,1,26,30324,3,35,0,30362,29915,421
13-12-2021,ramanathapuram,19,0,1,0,18,20512,0,135,0,20647,20270,359
13-12-2021,ranipet,58,6,5,0,59,43580,6,49,0,43635,42798,778
13-12-2021,salem,483,43,48,0,478,101431,43,438,0,101912,99717,1717
13-12-2021,sivagangai,54,4,4,0,54,20339,4,108,0,20451,20187,210
13-12-2021,tenkasi,6,2,0,0,8,27340,2,58,0,27400,26906,486
13-12-2021,thanjavur,139,15,15,0,139,76231,15,22,0,76268,75129,1000
13-12-2021,theni,9,0,0,0,9,43570,0,45,0,43615,43085,521
13-12-2021,thirupathur,34,3,2,0,35,29311,3,118,0,29432,28770,627
13-12-2021,thiruvallur,285,20,23,0,282,120495,20,10,0,120525,118389,1854
13-12-2021,thiruvannamalai,67,7,4,0,70,54868,7,398,0,55273,54531,672
13-12-2021,thiruvarur,89,5,6,0,88,41920,5,38,0,41963,41414,461
13-12-2021,thoothukudi,35,2,3,0,34,56258,2,275,0,56535,56089,412
13-12-2021,tirunelveli,48,3,6,0,45,49276,3,427,0,49706,49227,434
13-12-2021,tiruppur,609,46,51,1,603,97812,46,11,0,97869,96261,1005
13-12-2021,trichy,200,15,16,1,198,78606,15,65,0,78686,77397,1091
13-12-2021,vellore,134,7,11,0,130,48622,7,1694,0,50323,49052,1141
13-12-2021,villupuram,35,3,4,0,34,45880,3,174,0,46057,45665,358
13-12-2021,virudhunagar,15,2,2,0,15,46307,2,104,0,46413,45849,549
13-12-2021,airport surveillance (international),3,1,0,0,4,0,0,1033,1,1034,1029,1
13-12-2021,airport surveillance (domestic),0,0,0,0,0,0,0,1085,0,1085,1084,1
13-12-2021,railway surveillance,0,0,0,0,0,0,0,428,0,428,428,0
14-12-2021,ariyalur,9,0,0,0,9,16913,0,20,0,16933,16660,264
14-12-2021,chengalpattu,588,49,54,1,582,174506,49,5,0,174560,171437,2541
14-12-2021,chennai,1312,123,103,3,1329,559535,123,47,0,559705,549742,8634
14-12-2021,coimbatore,1160,107,117,1,1149,251653,107,51,0,251811,248173,2489
14-12-2021,cuddalore,69,6,6,0,69,64275,6,203,0,64484,63541,874
14-12-2021,dharmapuri,84,8,11,0,81,28688,8,216,0,28912,28552,279
14-12-2021,dindigul,48,3,4,0,47,33210,3,77,0,33290,32591,652
14-12-2021,erode,619,51,65,0,605,106920,51,94,0,107065,105755,705
14-12-2021,kallakurichi,27,0,1,0,26,31182,0,404,0,31586,31350,210
14-12-2021,kancheepuram,215,16,19,0,212,75850,16,4,0,75870,74393,1265
14-12-2021,kanyakumari,126,11,13,0,124,62806,11,124,0,62941,61758,1059
14-12-2021,karur,156,14,15,0,155,24750,14,47,0,24811,24292,364
14-12-2021,krishnagiri,129,10,12,0,127,43749,10,238,0,43997,43515,355
14-12-2021,madurai,73,6,9,0,70,75427,6,173,0,75606,74350,1186
14-12-2021,mayiladuthurai,27,3,1,1,28,23366,3,39,0,23408,23061,319
14-12-2021,nagapattinam,59,4,5,0,58,21344,4,53,0,21401,20986,357
14-12-2021,namakkal,464,42,44,0,462,53950,42,112,0,54104,53126,516
14-12-2021,nilgiris,153,18,17,0,154,34230,18,44,0,34292,33920,218
14-12-2021,perambalur,11,1,0,0,12,12111,1,3,0,12115,11858,245
14-12-2021,pudukottai,27,2,2,0,27,30328,2,35,0,30365,29917,421
14-12-2021,ramanathapuram,18,1,0,0,19,20512,1,135,0,20648,20270,359
14-12-2021,ranipet,60,5,7,0,58,43587,5,49,0,43641,42805,778
14-12-2021,salem,479,42,50,1,470,101475,42,438,0,101955,99767,1718
14-12-2021,sivagangai,56,5,3,0,58,20345,5,108,0,20458,20190,210
14-12-2021,tenkasi,8,2,0,0,10,27342,2,58,0,27402,26906,486
14-12-2021,thanjavur,138,14,16,1,135,76245,14,22,0,76281,75145,1001
14-12-2021,theni,8,0,0,0,8,43569,0,45,0,43614,43085,521
14-12-2021,thirupathur,33,1,1,0,33,29312,1,118,0,29431,28771,627
14-12-2021,thiruvallur,283,19,24,0,278,120516,19,10,0,120545,118413,1854
14-12-2021,thiruvannamalai,70,6,5,1,70,54875,6,398,0,55279,54536,673
14-12-2021,thiruvarur,88,4,8,0,84,41925,4,38,0,41967,41422,461
14-12-2021,thoothukudi,34,1,2,0,33,56260,1,275,0,56536,56091,412
14-12-2021,tirunelveli,45,4,3,0,46,49279,4,427,0,49710,49230,434
14-12-2021,tiruppur,608,44,49,0,603,97863,44,11,0,97918,96310,1005
14-12-2021,trichy,198,14,15,0,197,78621,14,65,0,78700,77412,1091
14-12-2021,vellore,131,11,10,0,132,48630,9,1694,2,50335,49062,1141
14-12-2021,villupuram,34,1,3,0,32,45883,1,174,0,46058,45668,358
14-12-2021,virudhunagar,15,1,1,0,15,46309,1,104,0,46414,45850,549
14-12-2021,airport surveillance (international),4,0,0,0,4,0,0,1034,0,1034,1029,1
14-12-2021,airport surveillance (domestic),0,0,0,0,0,0,0,1085,0,1085,1084,1
14-12-2021,railway surveillance,0,0,0,0,0,0,0,428,0,428,428,0
15-12-2021,ariyalur,9,3,1,0,11,16913,3,20,0,16936,16661,264
15-12-2021,chengalpattu,582,48,52,0,578,174555,48,5,0,174608,171489,2541
15-12-2021,chennai,1330,126,111,2,1343,559659,126,47,0,559832,549853,8636
15-12-2021,coimbatore,1152,106,107,3,1148,251763,106,51,0,251920,248280,2492
15-12-2021,cuddalore,69,5,7,0,67,64281,5,203,0,64489,63548,874
15-12-2021,dharmapuri,80,7,13,0,74,28695,7,216,0,28918,28565,279
15-12-2021,dindigul,45,2,6,0,41,33211,2,77,0,33290,32597,652
15-12-2021,erode,599,49,58,0,590,106965,49,94,0,107108,105813,705
15-12-2021,kallakurichi,26,0,4,0,22,31182,0,404,0,31586,31354,210
15-12-2021,kancheepuram,212,15,18,0,209,75866,15,4,0,75885,74411,1265
15-12-2021,kanyakumari,124,10,10,1,123,62817,10,124,0,62951,61768,1060
15-12-2021,karur,156,13,12,0,157,24765,13,47,0,24825,24304,364
15-12-2021,krishnagiri,127,8,8,1,126,43759,8,238,0,44005,43523,356
15-12-2021,madurai,68,5,6,0,67,75431,5,173,0,75609,74356,1186
15-12-2021,mayiladuthurai,28,1,3,0,26,23369,1,39,0,23409,23064,319
15-12-2021,nagapattinam,58,3,9,1,51,21348,3,53,0,21404,20995,358
15-12-2021,namakkal,462,39,45,0,456,53992,39,112,0,54143,53171,516
15-12-2021,nilgiris,155,17,14,0,158,34249,17,44,0,34310,33934,218
15-12-2021,perambalur,13,3,3,0,13,12113,3,3,0,12119,11861,245
15-12-2021,pudukottai,27,3,2,0,28,30330,3,35,0,30368,29919,421
15-12-2021,ramanathapuram,19,2,3,0,18,20513,2,135,0,20650,20273,359
15-12-2021,ranipet,58,4,5,0,57,43592,4,49,0,43645,42810,778
15-12-2021,salem,471,41,46,0,466,101518,41,438,0,101997,99813,1718
15-12-2021,sivagangai,56,4,7,0,53,20348,4,108,0,20460,20197,210
15-12-2021,tenkasi,10,3,0,0,13,27344,3,58,0,27405,26906,486
15-12-2021,thanjavur,135,12,11,1,135,76259,12,22,0,76293,75156,1002
15-12-2021,theni,8,0,2,0,6,43569,0,45,0,43614,43087,521
15-12-2021,thirupathur,33,3,1,0,35,29313,3,118,0,29434,28772,627
15-12-2021,thiruvallur,281,18,26,0,273,120538,18,10,0,120566,118439,1854
15-12-2021,thiruvannamalai,70,4,4,0,70,54881,4,398,0,55283,54540,673
15-12-2021,thiruvarur,84,5,7,0,82,41929,5,38,0,41972,41429,461
15-12-2021,thoothukudi,33,2,2,0,33,56261,2,275,0,56538,56093,412
15-12-2021,tirunelveli,46,5,3,0,48,49283,5,427,0,49715,49233,434
15-12-2021,tiruppur,607,45,51,2,599,97911,45,11,0,97967,96361,1007
15-12-2021,trichy,197,12,12,0,197,78635,12,65,0,78712,77424,1091
15-12-2021,vellore,130,14,16,0,128,48637,14,1696,0,50347,49078,1141
15-12-2021,villupuram,32,3,4,0,31,45884,3,174,0,46061,45672,358
15-12-2021,virudhunagar,15,0,2,0,13,46310,0,104,0,46414,45852,549
15-12-2021,airport surveillance (international),4,0,1,0,3,0,0,1034,0,1034,1030,1
15-12-2021,airport surveillance (domestic),0,0,0,0,0,0,0,1085,0,1085,1084,1
15-12-2021,railway surveillance,0,0,0,0,0,0,0,428,0,428,428,0
16-12-2021,ariyalur,11,2,1,0,12,16916,2,20,0,16938,16662,264
16-12-2021,chengalpattu,578,45,54,2,567,174603,45,5,0,174653,171543,2543
16-12-2021,chennai,1342,124,121,2,1343,559784,124,47,0,559955,549974,8638
16-12-2021,coimbatore,1150,104,113,1,1140,251871,104,51,0,252026,248393,2493
16-12-2021,cuddalore,70,6,6,0,70,64289,6,203,0,64498,63554,874
16-12-2021,dharmapuri,75,6,9,0,72,28703,6,216,0,28925,28574,279
16-12-2021,dindigul,41,5,5,0,41,33213,5,77,0,33295,32602,652
16-12-2021,erode,586,47,51,0,582,107010,47,94,0,107151,105864,705
16-12-2021,kallakurichi,22,1,3,0,20,31182,1,404,0,31587,31357,210
16-12-2021,kancheepuram,212,14,19,0,207,75884,14,4,0,75902,74430,1265
16-12-2021,kanyakumari,123,15,7,0,131,62827,15,124,0,62966,61775,1060
16-12-2021,karur,157,12,10,0,159,24778,12,47,0,24837,24314,364
16-12-2021,krishnagiri,125,7,4,0,128,43766,7,238,0,44011,43527,356
16-12-2021,madurai,68,4,8,0,64,75437,4,173,0,75614,74364,1186
16-12-2021,mayiladuthurai,26,3,2,0,27,23370,3,39,0,23412,23066,319
16-12-2021,nagapattinam,51,4,6,0,49,21351,4,53,0,21408,21001,358
16-12-2021,namakkal,456,36,41,0,451,54031,36,112,0,54179,53212,516
16-12-2021,nilgiris,158,15,12,0,161,34266,15,44,0,34325,33946,218
16-12-2021,perambalur,13,2,2,0,13,12116,2,3,0,12121,11863,245
16-12-2021,pudukottai,27,1,0,0,28,30332,1,35,0,30368,29919,421
16-12-2021,ramanathapuram,18,3,3,0,18,20515,3,135,0,20653,20276,359
16-12-2021,ranipet,58,2,2,0,58,43597,2,49,0,43648,42812,778
16-12-2021,salem,466,39,44,3,458,101559,39,438,0,102036,99857,1721
16-12-2021,sivagangai,53,3,6,0,50,20352,3,108,0,20463,20203,210
16-12-2021,tenkasi,13,2,0,0,15,27347,2,58,0,27407,26906,486
16-12-2021,thanjavur,136,11,8,0,139,76272,11,22,0,76305,75164,1002
16-12-2021,theni,6,1,0,0,7,43569,1,45,0,43615,43087,521
16-12-2021,thirupathur,34,4,2,0,36,29315,4,118,0,29437,28774,627
16-12-2021,thiruvallur,272,17,29,2,258,120555,17,10,0,120582,118468,1856
16-12-2021,thiruvannamalai,70,6,5,0,71,54885,6,398,0,55289,54545,673
16-12-2021,thiruvarur,82,4,8,0,78,41934,4,38,0,41976,41437,461
16-12-2021,thoothukudi,34,1,6,0,29,56264,1,275,0,56540,56099,412
16-12-2021,tirunelveli,48,7,4,0,51,49288,7,427,0,49722,49237,434
16-12-2021,tiruppur,600,43,59,1,583,97957,43,11,0,98011,96420,1008
16-12-2021,trichy,193,15,15,1,192,78643,15,65,0,78723,77439,1092
16-12-2021,vellore,127,13,17,0,123,48650,13,1696,0,50359,49095,1141
16-12-2021,villupuram,31,2,3,0,30,45887,2,174,0,46063,45675,358
16-12-2021,virudhunagar,13,1,2,0,12,46310,1,104,0,46415,45854,549
16-12-2021,airport surveillance (international),3,0,0,0,3,0,0,1034,0,1034,1030,1
16-12-2021,airport surveillance (domestic),0,0,0,0,0,0,0,1085,0,1085,1084,1
16-12-2021,railway surveillance,0,0,0,0,0,0,0,428,0,428,428,0
17-12-2021,ariyalur,12,2,1,0,13,16918,2,20,0,16940,16663,264
17-12-2021,chengalpattu,567,44,52,1,558,174648,44,5,0,174697,171595,2544
17-12-2021,chennai,1341,127,126,0,1342,559906,127,47,0,560080,550100,8638
17-12-2021,coimbatore,1141,102,107,0,1136,251976,102,51,0,252129,248500,2493
17-12-2021,cuddalore,69,5,7,0,67,64294,5,203,0,64502,63561,874
17-12-2021,dharmapuri,72,5,6,0,71,28709,5,216,0,28930,28580,279
17-12-2021,dindigul,42,4,8,0,38,33219,4,77,0,33300,32610,652
17-12-2021,erode,582,48,47,1,582,107057,48,94,0,107199,105911,706
17-12-2021,kallakurichi,20,4,3,0,21,31183,4,404,0,31591,31360,210
17-12-2021,kancheepuram,211,13,22,0,202,75902,13,4,0,75919,74452,1265
17-12-2021,kanyakumari,131,13,9,1,134,62842,13,124,0,62979,61784,1061
17-12-2021,karur,159,11,12,0,158,24790,11,47,0,24848,24326,364
17-12-2021,krishnagiri,128,12,8,0,132,43773,12,238,0,44023,43535,356
17-12-2021,madurai,64,6,5,0,65,75441,6,173,0,75620,74369,1186
17-12-2021,mayiladuthurai,30,1,4,0,27,23376,1,39,0,23416,23070,319
17-12-2021,nagapattinam,46,3,3,0,46,21352,3,53,0,21408,21004,358
17-12-2021,namakkal,450,34,38,0,446,54066,34,112,0,54212,53250,516
17-12-2021,nilgiris,161,13,10,0,164,34281,13,44,0,34338,33956,218
17-12-2021,perambalur,13,2,3,0,12,12118,2,3,0,12123,11866,245
17-12-2021,pudukottai,28,1,1,0,28,30333,1,35,0,30369,29920,421
17-12-2021,ramanathapuram,18,1,2,0,17,20518,1,135,0,20654,20278,359
17-12-2021,ranipet,59,2,6,0,55,43600,2,49,0,43651,42818,778
17-12-2021,salem,459,37,41,0,455,101599,37,438,0,102074,99898,1721
17-12-2021,sivagangai,50,2,4,0,48,20355,2,108,0,20465,20207,210
17-12-2021,tenkasi,15,1,1,0,15,27349,1,58,0,27408,26907,486
17-12-2021,thanjavur,138,9,7,1,139,76282,9,22,0,76313,75171,1003
17-12-2021,theni,7,1,1,0,7,43570,1,45,0,43616,43088,521
17-12-2021,thirupathur,36,5,3,0,38,29319,5,118,0,29442,28777,627
17-12-2021,thiruvallur,256,19,26,0,249,120570,19,10,0,120599,118494,1856
17-12-2021,thiruvannamalai,71,5,4,0,72,54891,5,398,0,55294,54549,673
17-12-2021,thiruvarur,78,3,11,1,69,41938,3,38,0,41979,41448,462
17-12-2021,thoothukudi,29,4,5,0,28,56265,4,275,0,56544,56104,412
17-12-2021,tirunelveli,50,5,3,0,52,49294,5,427,0,49726,49240,434
17-12-2021,tiruppur,583,45,57,6,565,98000,45,11,0,98056,96477,1014
17-12-2021,trichy,192,12,19,0,185,78658,12,65,0,78735,77458,1092
17-12-2021,vellore,122,11,14,0,119,48662,11,1696,0,50369,49109,1141
17-12-2021,villupuram,31,6,2,0,35,45890,6,174,0,46070,45677,358
17-12-2021,virudhunagar,12,2,1,0,13,46311,2,104,0,46417,45855,549
17-12-2021,airport surveillance (international),3,1,0,0,4,0,0,1034,1,1035,1030,1
17-12-2021,airport surveillance (domestic),0,0,0,0,0,0,0,1085,0,1085,1084,1
17-12-2021,railway surveillance,0,0,0,0,0,0,0,428,0,428,428,0
18-12-2021,ariyalur,14,1,1,0,14,16921,1,20,0,16942,16664,264
18-12-2021,chengalpattu,558,46,51,1,552,174692,46,5,0,174743,171646,2545
18-12-2021,chennai,1337,125,124,2,1336,560028,125,47,0,560200,550224,8640
18-12-2021,coimbatore,1136,101,104,1,1132,252078,101,51,0,252230,248604,2494
18-12-2021,cuddalore,67,7,6,0,68,64299,7,203,0,64509,63567,874
18-12-2021,dharmapuri,71,3,4,0,70,28714,3,216,0,28933,28584,279
18-12-2021,dindigul,38,5,7,0,36,33223,5,77,0,33305,32617,652
18-12-2021,erode,577,46,46,1,576,107100,46,94,0,107240,105957,707
18-12-2021,kallakurichi,21,2,2,0,21,31187,2,404,0,31593,31362,210
18-12-2021,kancheepuram,203,11,20,0,194,75916,11,4,0,75931,74472,1265
18-12-2021,kanyakumari,134,11,8,0,137,62855,11,124,0,62990,61792,1061
18-12-2021,karur,158,10,15,0,153,24801,10,47,0,24858,24341,364
18-12-2021,krishnagiri,132,11,10,0,133,43785,11,238,0,44034,43545,356
18-12-2021,madurai,65,5,5,0,65,75447,5,173,0,75625,74374,1186
18-12-2021,mayiladuthurai,27,3,3,0,27,23377,3,39,0,23419,23073,319
18-12-2021,nagapattinam,46,2,2,1,45,21355,2,53,0,21410,21006,359
18-12-2021,namakkal,446,39,37,0,448,54100,39,112,0,54251,53287,516
18-12-2021,nilgiris,164,14,11,0,167,34294,14,44,0,34352,33967,218
18-12-2021,perambalur,12,2,2,0,12,12120,2,3,0,12125,11868,245
18-12-2021,pudukottai,28,1,1,0,28,30334,1,35,0,30370,29921,421
18-12-2021,ramanathapuram,17,3,1,0,19,20519,3,135,0,20657,20279,359
18-12-2021,ranipet,55,1,5,0,51,43602,1,49,0,43652,42823,778
18-12-2021,salem,457,36,39,0,454,101638,36,438,0,102112,99937,1721
18-12-2021,sivagangai,49,8,3,0,54,20358,8,108,0,20474,20210,210
18-12-2021,tenkasi,15,2,1,0,16,27350,2,58,0,27410,26908,486
18-12-2021,thanjavur,138,16,8,0,146,76289,16,22,0,76327,75179,1002
18-12-2021,theni,7,1,0,0,8,43571,1,45,0,43617,43088,521
18-12-2021,thirupathur,38,2,4,0,36,29324,2,118,0,29444,28781,627
18-12-2021,thiruvallur,250,17,24,0,243,120590,17,10,0,120617,118518,1856
18-12-2021,thiruvannamalai,73,6,6,0,73,54897,6,398,0,55301,54555,673
18-12-2021,thiruvarur,69,1,9,0,61,41941,1,38,0,41980,41457,462
18-12-2021,thoothukudi,28,3,4,0,27,56269,3,275,0,56547,56108,412
18-12-2021,tirunelveli,52,2,5,0,49,49299,2,427,0,49728,49245,434
18-12-2021,tiruppur,568,44,58,2,552,98048,44,11,0,98103,96535,1016
18-12-2021,trichy,186,13,18,1,180,78672,13,65,0,78750,77476,1094
18-12-2021,vellore,119,10,16,0,113,48673,10,1696,0,50379,49125,1141
18-12-2021,villupuram,35,3,3,0,35,45896,3,174,0,46073,45680,358
18-12-2021,virudhunagar,13,0,2,0,11,46313,0,104,0,46417,45857,549
18-12-2021,airport surveillance (international),4,0,0,0,4,0,0,1035,0,1035,1030,1
18-12-2021,airport surveillance (domestic),0,0,0,0,0,0,0,1085,0,1085,1084,1
18-12-2021,railway surveillance,0,0,0,0,0,0,0,428,0,428,428,0
19-12-2021,ariyalur,15,1,1,0,15,16924,1,20,0,16945,16666,264
19-12-2021,chengalpattu,540,43,56,0,527,174783,43,5,0,174831,171759,2545
19-12-2021,chennai,1340,126,131,0,1335,560286,126,47,0,560459,550484,8640
19-12-2021,coimbatore,1124,97,109,2,1110,252277,97,51,0,252425,248818,2497
19-12-2021,cuddalore,65,4,5,0,64,64310,4,203,0,64517,63579,874
19-12-2021,dharmapuri,73,6,8,0,71,28725,6,216,0,28947,28597,279
19-12-2021,dindigul,36,6,2,0,40,33231,6,77,0,33314,32622,652
19-12-2021,erode,578,51,51,0,578,107196,51,94,0,107341,106056,707
19-12-2021,kallakurichi,18,1,3,0,16,31190,1,404,0,31595,31369,210
19-12-2021,kancheepuram,184,11,21,0,174,75936,11,4,0,75951,74512,1265
19-12-2021,kanyakumari,137,18,9,0,146,62873,18,124,0,63015,61808,1061
19-12-2021,karur,158,15,15,0,158,24829,15,47,0,24891,24369,364
19-12-2021,krishnagiri,128,9,10,1,126,43805,9,238,0,44052,43569,357
19-12-2021,madurai,63,4,6,0,61,75458,4,173,0,75635,74388,1186
19-12-2021,mayiladuthurai,23,0,3,0,20,23381,0,39,0,23420,23081,319
19-12-2021,nagapattinam,43,0,5,1,37,21358,0,53,0,21411,21014,360
19-12-2021,namakkal,445,35,42,0,438,54175,35,112,0,54322,53368,516
19-12-2021,nilgiris,171,13,6,0,178,34320,13,44,0,34377,33981,218
19-12-2021,perambalur,13,1,0,0,14,12123,1,3,0,12127,11868,245
19-12-2021,pudukottai,29,1,2,0,28,30338,1,35,0,30374,29925,421
19-12-2021,ramanathapuram,19,3,3,0,19,20523,3,135,0,20661,20283,359
19-12-2021,ranipet,49,1,7,0,43,43607,1,49,0,43657,42836,778
19-12-2021,salem,448,33,45,1,435,101712,33,438,0,102183,100025,1723
19-12-2021,sivagangai,52,4,5,0,51,20368,4,108,0,20480,20219,210
19-12-2021,tenkasi,16,0,1,0,15,27353,0,58,0,27411,26910,486
19-12-2021,thanjavur,150,14,9,0,155,76317,14,22,0,76353,75195,1003
19-12-2021,theni,8,1,1,0,8,43574,1,45,0,43620,43090,522
19-12-2021,thirupathur,34,2,4,0,32,29327,2,118,0,29447,28788,627
19-12-2021,thiruvallur,232,15,28,0,219,120622,15,10,0,120647,118572,1856
19-12-2021,thiruvannamalai,73,6,11,0,68,54912,6,398,0,55316,54575,673
19-12-2021,thiruvarur,57,2,8,0,51,41944,2,38,0,41984,41471,462
19-12-2021,thoothukudi,29,3,5,0,27,56276,3,275,0,56554,56115,412
19-12-2021,tirunelveli,47,7,3,0,51,49303,7,427,0,49737,49252,434
19-12-2021,tiruppur,536,42,52,1,525,98136,42,11,0,98189,96647,1017
19-12-2021,trichy,174,10,18,0,166,78695,10,65,0,78770,77510,1094
19-12-2021,vellore,107,7,7,0,107,48688,7,1696,0,50391,49143,1141
19-12-2021,villupuram,34,5,3,0,36,45903,5,174,0,46082,45688,358
19-12-2021,virudhunagar,11,3,0,0,14,46313,3,104,0,46420,45857,549
19-12-2021,airport surveillance (international),11,5,2,0,14,0,0,1042,5,1047,1032,1
19-12-2021,airport surveillance (domestic),0,0,0,0,0,0,0,1085,0,1085,1084,1
19-12-2021,railway surveillance,0,0,0,0,0,0,0,428,0,428,428,0
20-12-2021,ariyalur,15,1,1,0,15,16924,1,20,0,16945,16666,264
20-12-2021,chengalpattu,540,43,56,0,527,174783,43,5,0,174831,171759,2545
20-12-2021,chennai,1340,126,131,0,1335,560286,126,47,0,560459,550484,8640
20-12-2021,coimbatore,1124,97,109,2,1110,252277,97,51,0,252425,248818,2497
20-12-2021,cuddalore,65,4,5,0,64,64310,4,203,0,64517,63579,874
20-12-2021,dharmapuri,73,6,8,0,71,28725,6,216,0,28947,28597,279
20-12-2021,dindigul,36,6,2,0,40,33231,6,77,0,33314,32622,652
20-12-2021,erode,578,51,51,0,578,107196,51,94,0,107341,106056,707
20-12-2021,kallakurichi,18,1,3,0,16,31190,1,404,0,31595,31369,210
20-12-2021,kancheepuram,184,11,21,0,174,75936,11,4,0,75951,74512,1265
20-12-2021,kanyakumari,137,18,9,0,146,62873,18,124,0,63015,61808,1061
20-12-2021,karur,158,15,15,0,158,24829,15,47,0,24891,24369,364
20-12-2021,krishnagiri,128,9,10,1,126,43805,9,238,0,44052,43569,357
20-12-2021,madurai,63,4,6,0,61,75458,4,173,0,75635,74388,1186
20-12-2021,mayiladuthurai,23,0,3,0,20,23381,0,39,0,23420,23081,319
20-12-2021,nagapattinam,43,0,5,1,37,21358,0,53,0,21411,21014,360
20-12-2021,namakkal,445,35,42,0,438,54175,35,112,0,54322,53368,516
20-12-2021,nilgiris,171,13,6,0,178,34320,13,44,0,34377,33981,218
20-12-2021,perambalur,13,1,0,0,14,12123,1,3,0,12127,11868,245
20-12-2021,pudukottai,29,1,2,0,28,30338,1,35,0,30374,29925,421
20-12-2021,ramanathapuram,19,3,3,0,19,20523,3,135,0,20661,20283,359
20-12-2021,ranipet,49,1,7,0,43,43607,1,49,0,43657,42836,778
20-12-2021,salem,448,33,45,1,435,101712,33,438,0,102183,100025,1723
20-12-2021,sivagangai,52,4,5,0,51,20368,4,108,0,20480,20219,210
20-12-2021,tenkasi,16,0,1,0,15,27353,0,58,0,27411,26910,486
20-12-2021,thanjavur,150,14,9,0,155,76317,14,22,0,76353,75195,1003
20-12-2021,theni,8,1,1,0,8,43574,1,45,0,43620,43090,522
20-12-2021,thirupathur,34,2,4,0,32,29327,2,118,0,29447,28788,627
20-12-2021,thiruvallur,232,15,28,0,219,120622,15,10,0,120647,118572,1856
20-12-2021,thiruvannamalai,73,6,11,0,68,54912,6,398,0,55316,54575,673
20-12-2021,thiruvarur,57,2,8,0,51,41944,2,38,0,41984,41471,462
20-12-2021,thoothukudi,29,3,5,0,27,56276,3,275,0,56554,56115,412
20-12-2021,tirunelveli,47,7,3,0,51,49303,7,427,0,49737,49252,434
20-12-2021,tiruppur,536,42,52,1,525,98136,42,11,0,98189,96647,1017
20-12-2021,trichy,174,10,18,0,166,78695,10,65,0,78770,77510,1094
20-12-2021,vellore,107,7,7,0,107,48688,7,1696,0,50391,49143,1141
20-12-2021,villupuram,34,5,3,0,36,45903,5,174,0,46082,45688,358
20-12-2021,virudhunagar,11,3,0,0,14,46313,3,104,0,46420,45857,549
20-12-2021,airport surveillance (international),11,5,2,0,14,0,0,1042,5,1047,1032,1
20-12-2021,airport surveillance (domestic),0,0,0,0,0,0,0,1085,0,1085,1084,1
20-12-2021,railway surveillance,0,0,0,0,0,0,0,428,0,428,428,0
21-12-2021,ariyalur,14,2,0,0,16,16924,2,20,0,16946,16666,264
21-12-2021,chengalpattu,527,42,59,0,510,174826,42,5,0,174873,171818,2545
21-12-2021,chennai,1334,132,134,0,1332,560411,132,47,0,560590,550618,8640
21-12-2021,coimbatore,1110,95,107,2,1096,252374,95,51,0,252520,248925,2499
21-12-2021,cuddalore,64,3,6,0,61,64314,3,203,0,64520,63585,874
21-12-2021,dharmapuri,71,7,4,0,74,28731,7,216,0,28954,28601,279
21-12-2021,dindigul,40,6,2,0,44,33237,6,77,0,33320,32624,652
21-12-2021,erode,577,50,54,1,572,107246,50,94,0,107390,106110,708
21-12-2021,kallakurichi,16,2,2,0,16,31191,2,404,0,31597,31371,210
21-12-2021,kancheepuram,174,14,19,1,168,75947,14,4,0,75965,74531,1266
21-12-2021,kanyakumari,147,15,12,0,150,62892,15,124,0,63031,61820,1061
21-12-2021,karur,157,14,16,0,155,24843,14,47,0,24904,24385,364
21-12-2021,krishnagiri,127,7,11,0,123,43815,7,238,0,44060,43580,357
21-12-2021,madurai,59,5,3,0,61,75460,5,173,0,75638,74391,1186
21-12-2021,mayiladuthurai,20,0,1,0,19,23381,0,39,0,23420,23082,319
21-12-2021,nagapattinam,37,0,4,0,33,21358,0,53,0,21411,21018,360
21-12-2021,namakkal,439,32,39,0,432,54211,32,112,0,54355,53407,516
21-12-2021,nilgiris,178,12,10,0,180,34333,12,44,0,34389,33991,218
21-12-2021,perambalur,14,0,0,0,14,12124,0,3,0,12127,11868,245
21-12-2021,pudukottai,28,1,3,0,26,30339,1,35,0,30375,29928,421
21-12-2021,ramanathapuram,19,1,2,0,18,20526,1,135,0,20662,20285,359
21-12-2021,ranipet,44,2,5,0,41,43609,2,49,0,43660,42841,778
21-12-2021,salem,435,34,43,0,426,101745,34,438,0,102217,100068,1723
21-12-2021,sivagangai,51,3,4,0,50,20372,3,108,0,20483,20223,210
21-12-2021,tenkasi,15,0,0,0,15,27353,0,58,0,27411,26910,486
21-12-2021,thanjavur,154,13,13,0,154,76330,13,22,0,76365,75208,1003
21-12-2021,theni,8,0,0,0,8,43575,0,45,0,43620,43090,522
21-12-2021,thirupathur,31,3,2,0,32,29328,3,118,0,29449,28790,627
21-12-2021,thiruvallur,217,18,26,1,208,120635,18,10,0,120663,118598,1857
21-12-2021,thiruvannamalai,68,5,7,0,66,54918,5,398,0,55321,54582,673
21-12-2021,thiruvarur,52,4,9,0,47,41947,4,38,0,41989,41480,462
21-12-2021,thoothukudi,27,5,4,0,28,56279,5,275,0,56559,56119,412
21-12-2021,tirunelveli,51,6,6,0,51,49310,6,427,0,49743,49258,434
21-12-2021,tiruppur,525,44,57,0,512,98178,44,11,0,98233,96704,1017
21-12-2021,trichy,167,9,17,0,159,78706,9,65,0,78780,77527,1094
21-12-2021,vellore,106,8,5,0,109,48694,8,1696,0,50398,49148,1141
21-12-2021,villupuram,36,4,2,0,38,45908,4,174,0,46086,45690,358
21-12-2021,virudhunagar,14,2,0,0,16,46316,2,104,0,46422,45857,549
21-12-2021,airport surveillance (international),19,1,3,0,17,0,0,1052,1,1053,1035,1
21-12-2021,airport surveillance (domestic),0,1,0,0,1,0,0,1085,1,1086,1084,1
21-12-2021,railway surveillance,0,0,0,0,0,0,0,428,0,428,428,0
22-12-2021,ariyalur,15,0,1,0,14,16925,0,20,0,16945,16667,264
22-12-2021,chengalpattu,508,43,56,0,495,174866,43,5,0,174914,171874,2545
22-12-2021,chennai,1326,136,137,0,1325,560537,136,47,0,560720,550755,8640
22-12-2021,coimbatore,1097,94,105,2,1084,252470,94,51,0,252615,249030,2501
22-12-2021,cuddalore,62,4,4,0,62,64318,4,203,0,64525,63589,874
22-12-2021,dharmapuri,74,6,6,0,74,28738,6,216,0,28960,28607,279
22-12-2021,dindigul,43,4,4,0,43,33242,4,77,0,33323,32628,652
22-12-2021,erode,572,47,59,1,559,107296,47,94,0,107437,106169,709
22-12-2021,kallakurichi,16,3,3,0,16,31193,3,404,0,31600,31374,210
22-12-2021,kancheepuram,168,15,21,0,162,75961,15,4,0,75980,74552,1266
22-12-2021,kanyakumari,150,14,18,0,146,62907,14,124,0,63045,61838,1061
22-12-2021,karur,154,12,17,0,149,24856,12,47,0,24915,24402,364
22-12-2021,krishnagiri,123,9,9,1,122,43822,9,238,0,44069,43589,358
22-12-2021,madurai,59,6,4,0,61,75463,6,173,0,75642,74395,1186
22-12-2021,mayiladuthurai,20,0,1,0,19,23382,0,39,0,23421,23083,319
22-12-2021,nagapattinam,33,2,3,0,32,21358,2,53,0,21413,21021,360
22-12-2021,namakkal,432,29,42,1,418,54243,29,112,0,54384,53449,517
22-12-2021,nilgiris,180,8,12,0,176,34345,8,44,0,34397,34003,218
22-12-2021,perambalur,14,0,0,0,14,12124,0,3,0,12127,11868,245
22-12-2021,pudukottai,26,3,2,0,27,30340,3,35,0,30378,29930,421
22-12-2021,ramanathapuram,19,1,1,0,19,20528,1,135,0,20664,20286,359
22-12-2021,ranipet,41,0,4,0,37,43611,0,49,0,43660,42845,778
22-12-2021,salem,426,33,41,0,418,101779,33,438,0,102250,100109,1723
22-12-2021,sivagangai,50,5,5,0,50,20375,5,108,0,20488,20228,210
22-12-2021,tenkasi,15,0,0,0,15,27353,0,58,0,27411,26910,486
22-12-2021,thanjavur,153,11,15,0,149,76342,11,22,0,76375,75223,1003
22-12-2021,theni,8,0,0,0,8,43575,0,45,0,43620,43090,522
22-12-2021,thirupathur,32,2,2,0,32,29331,2,118,0,29451,28792,627
22-12-2021,thiruvallur,214,20,23,1,210,120659,20,10,0,120689,118621,1858
22-12-2021,thiruvannamalai,66,4,4,0,66,54923,4,398,0,55325,54586,673
22-12-2021,thiruvarur,47,6,5,0,48,41951,6,38,0,41995,41485,462
22-12-2021,thoothukudi,27,6,3,0,30,56283,6,275,0,56564,56122,412
22-12-2021,tirunelveli,51,5,7,0,49,49316,5,427,0,49748,49265,434
22-12-2021,tiruppur,513,48,53,2,506,98223,48,11,0,98282,96757,1019
22-12-2021,trichy,159,11,14,0,156,78715,11,65,0,78791,77541,1094
22-12-2021,vellore,108,9,6,0,111,48701,8,1696,1,50406,49154,1141
22-12-2021,villupuram,38,3,3,0,38,45912,3,174,0,46089,45693,358
22-12-2021,virudhunagar,16,1,1,0,16,46318,1,104,0,46423,45858,549
22-12-2021,airport surveillance (international),22,4,4,0,22,0,0,1058,4,1062,1039,1
22-12-2021,airport surveillance (domestic),1,0,0,0,1,0,0,1086,0,1086,1084,1
22-12-2021,railway surveillance,0,0,0,0,0,0,0,428,0,428,428,0
23-12-2021,ariyalur,14,0,1,0,13,16925,0,20,0,16945,16668,264
23-12-2021,chengalpattu,494,56,52,0,498,174908,56,5,0,174969,171926,2545
23-12-2021,chennai,1321,145,139,2,1325,560669,145,47,0,560861,550894,8642
23-12-2021,coimbatore,1084,92,102,1,1073,252564,92,51,0,252707,249132,2502
23-12-2021,cuddalore,62,10,7,0,65,64322,10,203,0,64535,63596,874
23-12-2021,dharmapuri,74,7,5,1,75,28744,7,216,0,28967,28612,280
23-12-2021,dindigul,43,3,3,0,43,33246,3,77,0,33326,32631,652
23-12-2021,erode,557,45,54,1,547,107341,45,94,0,107480,106223,710
23-12-2021,kallakurichi,16,2,0,0,18,31196,2,404,0,31602,31374,210
23-12-2021,kancheepuram,162,14,19,0,157,75976,14,4,0,75994,74571,1266
23-12-2021,kanyakumari,146,12,17,0,141,62921,12,124,0,63057,61855,1061
23-12-2021,karur,148,10,15,0,143,24867,10,47,0,24924,24417,364
23-12-2021,krishnagiri,122,6,12,0,116,43831,6,238,0,44075,43601,358
23-12-2021,madurai,61,4,6,0,59,75469,4,173,0,75646,74401,1186
23-12-2021,mayiladuthurai,19,1,3,0,17,23382,1,39,0,23422,23086,319
23-12-2021,nagapattinam,32,1,5,0,28,21360,1,53,0,21414,21026,360
23-12-2021,namakkal,416,27,34,0,409,54270,27,112,0,54409,53483,517
23-12-2021,nilgiris,176,7,14,0,169,34353,7,44,0,34404,34017,218
23-12-2021,perambalur,13,1,0,0,14,12123,1,3,0,12127,11868,245
23-12-2021,pudukottai,26,1,3,0,24,30342,1,35,0,30378,29933,421
23-12-2021,ramanathapuram,19,2,2,0,19,20529,2,135,0,20666,20288,359
23-12-2021,ranipet,37,4,3,0,38,43611,4,49,0,43664,42848,778
23-12-2021,salem,420,30,36,1,413,101814,30,438,0,102282,100145,1724
23-12-2021,sivagangai,50,6,2,0,54,20380,6,108,0,20494,20230,210
23-12-2021,tenkasi,15,1,1,0,15,27353,1,58,0,27412,26911,486
23-12-2021,thanjavur,148,10,13,0,145,76352,10,22,0,76384,75236,1003
23-12-2021,theni,8,1,1,0,8,43575,1,45,0,43621,43091,522
23-12-2021,thirupathur,33,3,4,0,32,29334,3,118,0,29455,28796,627
23-12-2021,thiruvallur,210,18,26,0,202,120679,18,10,0,120707,118647,1858
23-12-2021,thiruvannamalai,66,3,5,0,64,54927,3,398,0,55328,54591,673
23-12-2021,thiruvarur,49,5,8,0,46,41958,5,38,0,42001,41493,462
23-12-2021,thoothukudi,30,7,2,0,35,56289,7,275,0,56571,56124,412
23-12-2021,tirunelveli,49,4,4,1,48,49321,4,427,0,49752,49269,435
23-12-2021,tiruppur,509,43,55,0,497,98274,43,11,0,98328,96812,1019
23-12-2021,trichy,156,9,16,1,148,78726,9,65,0,78800,77557,1095
23-12-2021,vellore,111,8,10,0,109,48709,3,1697,5,50414,49164,1141
23-12-2021,villupuram,38,1,1,0,38,45915,1,174,0,46090,45694,358
23-12-2021,virudhunagar,16,2,2,0,16,46319,2,104,0,46425,45860,549
23-12-2021,airport surveillance (international),28,6,7,0,27,0,0,1068,6,1074,1046,1
23-12-2021,airport surveillance (domestic),1,0,0,0,1,0,0,1086,0,1086,1084,1
23-12-2021,railway surveillance,0,0,0,0,0,0,0,428,0,428,428,0
24-12-2021,ariyalur,13,0,0,0,13,16925,0,20,0,16945,16668,264
24-12-2021,chengalpattu,501,53,54,0,500,174967,53,5,0,175025,171980,2545
24-12-2021,chennai,1320,146,141,1,1324,560809,146,47,0,561002,551035,8643
24-12-2021,coimbatore,1075,90,105,2,1058,252658,90,51,0,252799,249237,2504
24-12-2021,cuddalore,65,12,8,0,69,64332,12,203,0,64547,63604,874
24-12-2021,dharmapuri,75,6,7,0,74,28751,6,216,0,28973,28619,280
24-12-2021,dindigul,43,2,2,0,43,33249,2,77,0,33328,32633,652
24-12-2021,erode,546,42,52,0,536,107385,42,94,0,107521,106275,710
24-12-2021,kallakurichi,18,3,1,0,20,31198,3,404,0,31605,31375,210
24-12-2021,kancheepuram,158,15,18,0,155,75991,15,4,0,76010,74589,1266
24-12-2021,kanyakumari,141,11,14,0,138,62933,11,124,0,63068,61869,1061
24-12-2021,karur,143,8,12,0,139,24877,8,47,0,24932,24429,364
24-12-2021,krishnagiri,117,4,13,0,108,43838,4,238,0,44080,43614,358
24-12-2021,madurai,58,3,5,0,56,75472,3,173,0,75648,74406,1186
24-12-2021,mayiladuthurai,18,2,2,0,18,23384,2,39,0,23425,23088,319
24-12-2021,nagapattinam,28,4,4,0,28,21361,4,53,0,21418,21030,360
24-12-2021,namakkal,408,24,36,0,396,54296,24,112,0,54432,53519,517
24-12-2021,nilgiris,169,6,15,0,160,34360,6,44,0,34410,34032,218
24-12-2021,perambalur,14,1,0,0,15,12124,1,3,0,12128,11868,245
24-12-2021,pudukottai,24,3,2,0,25,30343,3,35,0,30381,29935,421
24-12-2021,ramanathapuram,19,3,1,0,21,20531,3,135,0,20669,20289,359
24-12-2021,ranipet,38,3,4,0,37,43615,3,49,0,43667,42852,778
24-12-2021,salem,413,29,37,0,405,101844,29,438,0,102311,100182,1724
24-12-2021,sivagangai,54,4,3,1,54,20386,4,108,0,20498,20233,211
24-12-2021,tenkasi,15,2,1,0,16,27354,2,58,0,27414,26912,486
24-12-2021,thanjavur,145,13,11,1,146,76362,13,22,0,76397,75247,1004
24-12-2021,theni,8,0,1,0,7,43576,0,45,0,43621,43092,522
24-12-2021,thirupathur,31,1,4,0,28,29336,1,118,0,29455,28800,627
24-12-2021,thiruvallur,204,16,24,0,196,120699,16,10,0,120725,118671,1858
24-12-2021,thiruvannamalai,65,4,6,0,63,54931,4,398,0,55333,54597,673
24-12-2021,thiruvarur,45,4,5,0,44,41962,4,38,0,42004,41498,462
24-12-2021,thoothukudi,35,5,3,0,37,56296,5,275,0,56576,56127,412
24-12-2021,tirunelveli,48,5,4,0,49,49325,5,427,0,49757,49273,435
24-12-2021,tiruppur,497,41,57,1,480,98317,41,11,0,98369,96869,1020
24-12-2021,trichy,147,10,17,1,139,78734,10,65,0,78809,77574,1096
24-12-2021,vellore,109,10,9,0,110,48712,9,1702,1,50424,49173,1141
24-12-2021,villupuram,38,3,2,0,39,45916,3,174,0,46093,45696,358
24-12-2021,virudhunagar,16,3,1,0,18,46321,3,104,0,46428,45861,549
24-12-2021,airport surveillance (international),27,6,0,0,33,0,0,1074,6,1080,1046,1
24-12-2021,airport surveillance (domestic),1,0,0,0,1,0,0,1086,0,1086,1084,1
24-12-2021,railway surveillance,0,0,0,0,0,0,0,428,0,428,428,0
25-12-2021,ariyalur,13,1,1,0,13,16925,1,20,0,16946,16669,264
25-12-2021,chengalpattu,500,50,57,1,492,175020,50,5,0,175075,172037,2546
25-12-2021,chennai,1326,165,132,1,1358,560957,165,47,0,561169,551167,8644
25-12-2021,coimbatore,1058,87,106,2,1037,252748,87,51,0,252886,249343,2506
25-12-2021,cuddalore,69,14,5,1,77,64344,14,203,0,64561,63609,875
25-12-2021,dharmapuri,74,5,9,0,70,28757,5,216,0,28978,28628,280
25-12-2021,dindigul,44,5,2,0,47,33252,5,77,0,33334,32635,652
25-12-2021,erode,537,41,54,0,524,107428,41,94,0,107563,106329,710
25-12-2021,kallakurichi,20,1,0,0,21,31201,1,404,0,31606,31375,210
25-12-2021,kancheepuram,155,16,19,0,152,76006,16,4,0,76026,74608,1266
25-12-2021,kanyakumari,138,9,10,0,137,62944,9,124,0,63077,61879,1061
25-12-2021,karur,139,10,14,0,135,24885,10,47,0,24942,24443,364
25-12-2021,krishnagiri,108,5,12,0,101,43842,5,238,0,44085,43626,358
25-12-2021,madurai,56,8,6,0,58,75475,8,173,0,75656,74412,1186
25-12-2021,mayiladuthurai,19,0,4,0,15,23387,0,39,0,23426,23092,319
25-12-2021,nagapattinam,28,0,5,0,23,21365,0,53,0,21418,21035,360
25-12-2021,namakkal,393,23,34,0,382,54317,23,112,0,54452,53553,517
25-12-2021,nilgiris,160,5,18,0,147,34366,5,44,0,34415,34050,218
25-12-2021,perambalur,15,2,0,0,17,12125,2,3,0,12130,11868,245
25-12-2021,pudukottai,25,2,4,0,23,30346,2,35,0,30383,29939,421
25-12-2021,ramanathapuram,21,2,0,0,23,20534,2,135,0,20671,20289,359
25-12-2021,ranipet,37,0,7,0,30,43618,0,49,0,43667,42859,778
25-12-2021,salem,407,27,38,1,395,101875,27,438,0,102340,100220,1725
25-12-2021,sivagangai,53,2,5,1,49,20389,2,108,0,20499,20238,212
25-12-2021,tenkasi,16,3,2,0,17,27356,3,58,0,27417,26914,486
25-12-2021,thanjavur,147,10,17,2,138,76376,10,22,0,76408,75264,1006
25-12-2021,theni,7,1,0,0,8,43576,1,45,0,43622,43092,522
25-12-2021,thirupathur,28,3,2,0,29,29337,3,118,0,29458,28802,627
25-12-2021,thiruvallur,196,17,18,0,195,120715,17,10,0,120742,118689,1858
25-12-2021,thiruvannamalai,63,3,8,0,58,54935,3,398,0,55336,54605,673
25-12-2021,thiruvarur,42,3,3,0,42,41964,3,38,0,42005,41501,462
25-12-2021,thoothukudi,38,7,1,0,44,56302,7,275,0,56584,56128,412
25-12-2021,tirunelveli,47,4,2,0,49,49328,4,427,0,49759,49275,435
25-12-2021,tiruppur,480,42,52,1,469,98358,42,11,0,98411,96921,1021
25-12-2021,trichy,137,11,15,1,132,78742,11,65,0,78818,77589,1097
25-12-2021,vellore,110,13,11,0,112,48721,13,1703,0,50437,49184,1141
25-12-2021,villupuram,39,2,4,0,37,45919,2,174,0,46095,45700,358
25-12-2021,virudhunagar,19,4,2,0,21,46325,4,104,0,46433,45863,549
25-12-2021,airport surveillance (international),33,3,6,0,30,0,0,1080,3,1083,1052,1
25-12-2021,airport surveillance (domestic),1,0,0,0,1,0,0,1086,0,1086,1084,1
25-12-2021,railway surveillance,0,0,0,0,0,0,0,428,0,428,428,0
26-12-2021,ariyalur,13,1,2,0,12,16926,1,20,0,16947,16671,264
26-12-2021,chengalpattu,494,48,58,0,484,175072,48,5,0,175125,172095,2546
26-12-2021,chennai,1358,171,129,1,1399,561122,171,47,0,561340,551296,8645
26-12-2021,coimbatore,1037,89,103,2,1021,252835,89,51,0,252975,249446,2508
26-12-2021,cuddalore,77,12,6,1,82,64358,12,203,0,64573,63615,876
26-12-2021,dharmapuri,70,3,10,0,63,28762,3,216,0,28981,28638,280
26-12-2021,dindigul,47,3,3,0,47,33257,3,77,0,33337,32638,652
26-12-2021,erode,524,45,56,0,513,107469,45,94,0,107608,106385,710
26-12-2021,kallakurichi,21,1,1,0,21,31202,1,404,0,31607,31376,210
26-12-2021,kancheepuram,155,15,18,0,152,76025,15,4,0,76044,74626,1266
26-12-2021,kanyakumari,137,12,11,0,138,62953,12,124,0,63089,61890,1061
26-12-2021,karur,135,9,15,0,129,24895,9,47,0,24951,24458,364
26-12-2021,krishnagiri,101,6,13,0,94,43847,6,238,0,44091,43639,358
26-12-2021,madurai,57,7,7,0,57,75482,7,173,0,75662,74419,1186
26-12-2021,mayiladuthurai,15,0,2,0,13,23387,0,39,0,23426,23094,319
26-12-2021,nagapattinam,23,2,4,1,20,21365,2,53,0,21420,21039,361
26-12-2021,namakkal,381,22,33,0,370,54339,22,112,0,54473,53586,517
26-12-2021,nilgiris,147,2,21,0,128,34371,2,44,0,34417,34071,218
26-12-2021,perambalur,17,3,1,0,19,12127,3,3,0,12133,11869,245
26-12-2021,pudukottai,23,1,3,0,21,30348,1,35,0,30384,29942,421
26-12-2021,ramanathapuram,23,1,1,0,23,20536,1,135,0,20672,20290,359
26-12-2021,ranipet,30,2,5,0,27,43618,2,49,0,43669,42864,778
26-12-2021,salem,395,26,36,0,385,101902,26,438,0,102366,100256,1725
26-12-2021,sivagangai,47,3,4,0,46,20389,3,108,0,20500,20242,212
26-12-2021,tenkasi,17,1,1,0,17,27359,1,58,0,27418,26915,486
26-12-2021,thanjavur,138,8,14,0,132,76386,8,22,0,76416,75278,1006
26-12-2021,theni,8,0,0,1,7,43577,0,45,0,43622,43092,523
26-12-2021,thirupathur,30,4,3,0,31,29341,4,118,0,29463,28805,627
26-12-2021,thiruvallur,191,16,16,1,190,120728,16,10,0,120754,118705,1859
26-12-2021,thiruvannamalai,60,1,9,0,52,54940,1,398,0,55339,54614,673
26-12-2021,thiruvarur,42,4,4,0,42,41967,4,38,0,42009,41505,462
26-12-2021,thoothukudi,44,5,2,0,47,56309,5,275,0,56589,56130,412
26-12-2021,tirunelveli,49,5,3,0,51,49332,5,427,0,49764,49278,435
26-12-2021,tiruppur,470,40,51,2,457,98401,40,11,0,98452,96972,1023
26-12-2021,trichy,133,10,17,1,125,78754,10,65,0,78829,77606,1098
26-12-2021,vellore,109,11,12,0,108,48731,11,1703,0,50445,49196,1141
26-12-2021,villupuram,38,7,3,0,42,45922,7,174,0,46103,45703,358
26-12-2021,virudhunagar,21,6,2,0,25,46329,6,104,0,46439,45865,549
26-12-2021,airport surveillance (international),30,8,0,0,38,0,0,1083,8,1091,1052,1
26-12-2021,airport surveillance (domestic),1,0,0,0,1,0,0,1086,0,1086,1084,1
26-12-2021,railway surveillance,0,0,0,0,0,0,0,428,0,428,428,0
27-12-2021,ariyalur,12,0,3,0,9,16927,0,20,0,16947,16674,264
27-12-2021,chengalpattu,481,50,52,0,479,175117,50,5,0,175172,172147,2546
27-12-2021,chennai,1400,172,124,2,1446,561294,172,47,0,561513,551420,8647
27-12-2021,coimbatore,1022,88,98,0,1012,252925,88,51,0,253064,249544,2508
27-12-2021,cuddalore,81,10,4,0,87,64369,10,203,0,64582,63619,876
27-12-2021,dharmapuri,63,4,7,0,60,28765,4,216,0,28985,28645,280
27-12-2021,dindigul,47,4,5,0,46,33260,4,77,0,33341,32643,652
27-12-2021,erode,500,42,58,0,484,107501,42,94,0,107637,106443,710
27-12-2021,kallakurichi,21,1,1,0,21,31203,1,404,0,31608,31377,210
27-12-2021,kancheepuram,153,17,19,0,151,76041,17,4,0,76062,74645,1266
27-12-2021,kanyakumari,138,11,13,1,135,62965,11,124,0,63100,61903,1062
27-12-2021,karur,131,8,11,0,128,24906,8,47,0,24961,24469,364
27-12-2021,krishnagiri,95,5,9,0,91,43854,5,238,0,44097,43648,358
27-12-2021,madurai,57,6,5,0,58,75489,6,173,0,75668,74424,1186
27-12-2021,mayiladuthurai,13,0,3,0,10,23387,0,39,0,23426,23097,319
27-12-2021,nagapattinam,20,1,2,0,19,21367,1,53,0,21421,21041,361
27-12-2021,namakkal,371,20,38,0,353,54362,20,112,0,54494,53624,517
27-12-2021,nilgiris,128,3,17,1,113,34373,3,44,0,34420,34088,219
27-12-2021,perambalur,19,2,4,0,17,12130,2,3,0,12135,11873,245
27-12-2021,pudukottai,21,0,2,0,19,30349,0,35,0,30384,29944,421
27-12-2021,ramanathapuram,23,1,3,0,21,20537,1,135,0,20673,20293,359
27-12-2021,ranipet,27,1,6,1,21,43620,1,49,0,43670,42870,779
27-12-2021,salem,385,25,43,1,366,101928,25,438,0,102391,100299,1726
27-12-2021,sivagangai,45,5,2,0,48,20391,5,108,0,20504,20244,212
27-12-2021,tenkasi,17,0,4,0,13,27360,0,58,0,27418,26919,486
27-12-2021,thanjavur,132,7,11,1,127,76394,7,22,0,76423,75289,1007
27-12-2021,theni,7,0,0,0,7,43577,0,45,0,43622,43092,523
27-12-2021,thirupathur,33,3,5,0,31,29347,3,118,0,29468,28810,627
27-12-2021,thiruvallur,192,15,18,0,189,120746,15,10,0,120771,118723,1859
27-12-2021,thiruvannamalai,52,2,5,0,49,54941,2,398,0,55341,54619,673
27-12-2021,thiruvarur,43,3,6,0,40,41972,3,38,0,42013,41511,462
27-12-2021,thoothukudi,47,4,2,0,49,56314,4,275,0,56593,56132,412
27-12-2021,tirunelveli,51,4,4,0,51,49337,4,427,0,49768,49282,435
27-12-2021,tiruppur,466,39,48,1,456,98450,39,11,0,98500,97020,1024
27-12-2021,trichy,124,17,15,1,125,78763,17,65,0,78845,77621,1099
27-12-2021,vellore,106,17,10,0,113,48740,16,1703,1,50460,49206,1141
27-12-2021,villupuram,42,6,4,0,44,45929,6,174,0,46109,45707,358
27-12-2021,virudhunagar,25,7,0,0,32,46335,7,104,0,46446,45865,549
27-12-2021,airport surveillance (international),38,5,2,0,41,0,0,1091,5,1096,1054,1
27-12-2021,airport surveillance (domestic),1,0,0,0,1,0,0,1086,0,1086,1084,1
27-12-2021,railway surveillance,0,0,0,0,0,0,0,428,0,428,428,0
28-12-2021,ariyalur,9,1,1,0,9,16927,1,20,0,16948,16675,264
28-12-2021,chengalpattu,479,59,46,1,491,175167,59,5,0,175231,172193,2547
28-12-2021,chennai,1448,194,122,1,1519,561468,194,47,0,561709,551542,8648
28-12-2021,coimbatore,1012,84,107,1,988,253013,84,51,0,253148,249651,2509
28-12-2021,cuddalore,86,7,3,0,90,64378,7,203,0,64588,63622,876
28-12-2021,dharmapuri,60,2,4,1,57,28769,2,216,0,28987,28649,281
28-12-2021,dindigul,46,2,5,0,43,33264,2,77,0,33343,32648,652
28-12-2021,erode,483,40,52,1,470,107542,40,94,0,107676,106495,711
28-12-2021,kallakurichi,21,0,2,0,19,31204,0,404,0,31608,31379,210
28-12-2021,kancheepuram,152,18,11,0,159,76059,18,4,0,76081,74656,1266
28-12-2021,kanyakumari,136,9,12,0,133,62977,9,124,0,63110,61915,1062
28-12-2021,karur,128,9,10,0,127,24914,9,47,0,24970,24479,364
28-12-2021,krishnagiri,90,2,14,0,78,43858,2,238,0,44098,43662,358
28-12-2021,madurai,58,7,3,0,62,75495,7,173,0,75675,74427,1186
28-12-2021,mayiladuthurai,10,0,2,0,8,23387,0,39,0,23426,23099,319
28-12-2021,nagapattinam,19,2,4,0,17,21368,2,53,0,21423,21045,361
28-12-2021,namakkal,353,16,42,0,327,54382,16,112,0,54510,53666,517
28-12-2021,nilgiris,113,4,15,0,102,34376,4,44,0,34424,34103,219
28-12-2021,perambalur,17,3,2,0,18,12132,3,3,0,12138,11875,245
28-12-2021,pudukottai,19,0,1,0,18,30349,0,35,0,30384,29945,421
28-12-2021,ramanathapuram,21,1,2,0,20,20538,1,135,0,20674,20295,359
28-12-2021,ranipet,22,4,4,0,22,43622,4,49,0,43675,42874,779
28-12-2021,salem,367,29,47,0,349,101954,29,438,0,102421,100346,1726
28-12-2021,sivagangai,47,4,2,1,48,20395,4,108,0,20507,20246,213
28-12-2021,tenkasi,13,1,1,0,13,27360,1,58,0,27419,26920,486
28-12-2021,thanjavur,127,8,10,0,125,76401,8,22,0,76431,75299,1007
28-12-2021,theni,7,0,1,0,6,43577,0,45,0,43622,43093,523
28-12-2021,thirupathur,29,1,3,0,27,29348,1,118,0,29467,28813,627
28-12-2021,thiruvallur,189,22,19,0,192,120761,22,10,0,120793,118742,1859
28-12-2021,thiruvannamalai,51,5,6,0,50,54945,5,398,0,55348,54625,673
28-12-2021,thiruvarur,40,9,4,0,45,41975,9,38,0,42022,41515,462
28-12-2021,thoothukudi,48,3,1,0,50,56317,3,275,0,56595,56133,412
28-12-2021,tirunelveli,51,4,5,0,50,49341,4,427,0,49772,49287,435
28-12-2021,tiruppur,457,33,45,0,445,98490,33,11,0,98534,97065,1024
28-12-2021,trichy,125,16,13,0,128,78780,16,65,0,78861,77634,1099
28-12-2021,vellore,111,12,11,0,112,48754,10,1704,2,50470,49217,1141
28-12-2021,villupuram,44,0,3,0,41,45935,0,174,0,46109,45710,358
28-12-2021,virudhunagar,32,3,2,0,33,46342,3,104,0,46449,45867,549
28-12-2021,airport surveillance (international),41,4,1,0,44,0,0,1096,4,1100,1055,1
28-12-2021,airport surveillance (domestic),1,1,0,0,2,0,0,1086,1,1087,1084,1
28-12-2021,railway surveillance,0,0,0,0,0,0,0,428,0,428,428,0
29-12-2021,ariyalur,9,1,2,0,8,16928,1,20,0,16949,16677,264
29-12-2021,chengalpattu,491,64,44,0,511,175226,64,5,0,175295,172237,2547
29-12-2021,chennai,1524,294,126,3,1689,561667,294,47,0,562008,551668,8651
29-12-2021,coimbatore,988,78,104,0,962,253097,78,51,0,253226,249755,2509
29-12-2021,cuddalore,89,6,4,0,91,64384,6,203,0,64593,63626,876
29-12-2021,dharmapuri,57,2,6,0,53,28771,2,216,0,28989,28655,281
29-12-2021,dindigul,41,1,5,0,37,33264,1,77,0,33342,32653,652
29-12-2021,erode,470,34,47,0,457,107582,34,94,0,107710,106542,711
29-12-2021,kallakurichi,19,0,2,0,17,31204,0,404,0,31608,31381,210
29-12-2021,kancheepuram,159,31,10,1,179,76077,31,4,0,76112,74666,1267
29-12-2021,kanyakumari,133,11,14,0,130,62986,11,124,0,63121,61929,1062
29-12-2021,karur,127,4,13,0,118,24923,4,47,0,24974,24492,364
29-12-2021,krishnagiri,78,3,11,0,70,43860,3,238,0,44101,43673,358
29-12-2021,madurai,63,3,3,1,62,75503,3,173,0,75679,74430,1187
29-12-2021,mayiladuthurai,11,0,5,0,6,23390,0,39,0,23429,23104,319
29-12-2021,nagapattinam,17,1,4,0,14,21370,1,53,0,21424,21049,361
29-12-2021,namakkal,327,19,37,0,309,54398,19,112,0,54529,53703,517
29-12-2021,nilgiris,102,3,16,0,89,34380,3,44,0,34427,34119,219
29-12-2021,perambalur,18,2,1,0,19,12135,2,3,0,12140,11876,245
29-12-2021,pudukottai,18,1,3,0,16,30349,1,35,0,30385,29948,421
29-12-2021,ramanathapuram,20,5,2,0,23,20539,5,135,0,20679,20297,359
29-12-2021,ranipet,22,13,2,0,33,43626,13,49,0,43688,42876,779
29-12-2021,salem,349,28,43,1,333,101983,28,438,0,102449,100389,1727
29-12-2021,sivagangai,48,2,3,0,47,20399,2,108,0,20509,20249,213
29-12-2021,tenkasi,14,0,1,0,13,27362,0,58,0,27420,26921,486
29-12-2021,thanjavur,125,7,12,0,120,76409,7,22,0,76438,75311,1007
29-12-2021,theni,6,1,1,0,6,43577,1,45,0,43623,43094,523
29-12-2021,thirupathur,28,2,4,0,26,29350,2,118,0,29470,28817,627
29-12-2021,thiruvallur,187,33,15,0,205,120778,33,10,0,120821,118757,1859
29-12-2021,thiruvannamalai,50,4,7,0,47,54950,3,398,1,55352,54632,673
29-12-2021,thiruvarur,42,5,2,0,45,41981,5,38,0,42024,41517,462
29-12-2021,thoothukudi,50,10,1,0,59,56320,10,275,0,56605,56134,412
29-12-2021,tirunelveli,50,5,3,0,52,49345,5,427,0,49777,49290,435
29-12-2021,tiruppur,446,24,38,1,431,98524,24,11,0,98559,97103,1025
29-12-2021,trichy,127,12,9,1,129,78795,12,65,0,78872,77643,1100
29-12-2021,vellore,112,13,8,0,117,48764,8,1706,5,50483,49225,1141
29-12-2021,villupuram,41,5,5,0,41,45935,5,174,0,46114,45715,358
29-12-2021,virudhunagar,33,7,1,0,39,46345,7,104,0,46456,45868,549
29-12-2021,airport surveillance (international),44,5,0,0,49,0,0,1100,5,1105,1055,1
29-12-2021,airport surveillance (domestic),2,0,0,0,2,0,0,1087,0,1087,1084,1
29-12-2021,railway surveillance,0,0,0,0,0,0,0,428,0,428,428,0
30-12-2021,ariyalur,8,1,1,1,7,16929,1,20,0,16950,16678,265
30-12-2021,chengalpattu,513,103,47,0,569,175292,103,5,0,175400,172284,2547
30-12-2021,chennai,1687,397,131,1,1952,561959,397,47,0,562403,551799,8652
30-12-2021,coimbatore,962,73,102,2,931,253175,73,51,0,253299,249857,2511
30-12-2021,cuddalore,91,5,5,0,91,64390,5,203,0,64598,63631,876
30-12-2021,dharmapuri,53,3,3,0,53,28773,3,216,0,28992,28658,281
30-12-2021,dindigul,36,4,2,0,38,33264,4,77,0,33345,32655,652
30-12-2021,erode,457,27,42,0,442,107616,27,94,0,107737,106584,711
30-12-2021,kallakurichi,17,6,1,0,22,31204,6,404,0,31614,31382,210
30-12-2021,kancheepuram,180,24,12,1,191,76109,24,4,0,76137,74678,1268
30-12-2021,kanyakumari,130,13,9,0,134,62997,13,124,0,63134,61938,1062
30-12-2021,karur,118,6,12,0,112,24927,6,47,0,24980,24504,364
30-12-2021,krishnagiri,71,4,8,0,67,43864,4,238,0,44106,43681,358
30-12-2021,madurai,62,6,5,0,63,75506,6,173,0,75685,74435,1187
30-12-2021,mayiladuthurai,6,1,2,0,5,23390,1,39,0,23430,23106,319
30-12-2021,nagapattinam,14,2,0,0,16,21371,2,53,0,21426,21049,361
30-12-2021,namakkal,309,12,45,0,276,54417,12,112,0,54541,53748,517
30-12-2021,nilgiris,89,4,13,0,80,34383,4,44,0,34431,34132,219
30-12-2021,perambalur,19,5,2,0,22,12137,5,3,0,12145,11878,245
30-12-2021,pudukottai,15,1,1,0,15,30349,1,35,0,30385,29949,421
30-12-2021,ramanathapuram,23,3,3,0,23,20544,3,135,0,20682,20300,359
30-12-2021,ranipet,34,6,1,0,39,43640,6,49,0,43695,42877,779
30-12-2021,salem,334,26,41,0,319,102012,26,438,0,102476,100430,1727
30-12-2021,sivagangai,47,3,4,0,46,20401,3,108,0,20512,20253,213
30-12-2021,tenkasi,13,0,2,0,11,27362,0,58,0,27420,26923,486
30-12-2021,thanjavur,120,10,14,0,116,76416,10,22,0,76448,75325,1007
30-12-2021,theni,6,1,1,0,6,43578,1,45,0,43624,43095,523
30-12-2021,thirupathur,26,4,2,0,28,29352,4,118,0,29474,28819,627
30-12-2021,thiruvallur,202,35,16,1,220,120808,35,10,0,120853,118773,1860
30-12-2021,thiruvannamalai,47,5,6,0,46,54953,5,399,0,55357,54638,673
30-12-2021,thiruvarur,45,4,1,0,48,41986,4,38,0,42028,41518,462
30-12-2021,thoothukudi,57,12,2,0,67,56328,12,275,0,56615,56136,412
30-12-2021,tirunelveli,52,8,4,1,55,49350,8,427,0,49785,49294,436
30-12-2021,tiruppur,432,28,43,0,417,98549,28,11,0,98588,97146,1025
30-12-2021,trichy,129,9,10,0,128,78807,9,65,0,78881,77653,1100
30-12-2021,vellore,117,18,7,0,128,48772,15,1711,3,50501,49232,1141
30-12-2021,villupuram,41,4,5,0,40,45940,4,174,0,46118,45720,358
30-12-2021,virudhunagar,41,11,2,0,50,46354,11,104,0,46469,45870,549
30-12-2021,airport surveillance (international),49,5,1,0,53,0,0,1105,5,1110,1056,1
30-12-2021,airport surveillance (domestic),2,1,0,0,3,0,0,1087,1,1088,1084,1
30-12-2021,railway surveillance,0,0,0,0,0,0,0,428,0,428,428,0
31-12-2021,ariyalur,7,0,0,0,7,16930,0,20,0,16950,16678,265
31-12-2021,chengalpattu,566,137,49,0,654,175392,137,5,0,175534,172333,2547
31-12-2021,chennai,1950,589,136,0,2403,562354,589,47,0,562990,551935,8652
31-12-2021,coimbatore,931,70,93,4,904,253248,70,51,0,253369,249950,2515
31-12-2021,cuddalore,91,1,6,0,86,64395,1,203,0,64599,63637,876
31-12-2021,dharmapuri,54,8,5,0,57,28777,8,216,0,29001,28663,281
31-12-2021,dindigul,38,1,3,0,36,33268,1,77,0,33346,32658,652
31-12-2021,erode,442,22,38,0,426,107643,22,94,0,107759,106622,711
31-12-2021,kallakurichi,23,4,2,0,25,31211,4,404,0,31619,31384,210
31-12-2021,kancheepuram,191,34,15,0,210,76133,34,4,0,76171,74693,1268
31-12-2021,kanyakumari,134,9,11,0,132,63010,9,124,0,63143,61949,1062
31-12-2021,karur,112,4,14,0,102,24933,4,47,0,24984,24518,364
31-12-2021,krishnagiri,67,3,9,0,61,43868,3,238,0,44109,43690,358
31-12-2021,madurai,62,9,6,0,65,75511,9,173,0,75693,74441,1187
31-12-2021,mayiladuthurai,7,0,0,0,7,23393,0,39,0,23432,23106,319
31-12-2021,nagapattinam,15,1,0,0,16,21372,1,53,0,21426,21049,361
31-12-2021,namakkal,276,18,39,0,255,54429,18,112,0,54559,53787,517
31-12-2021,nilgiris,80,2,12,0,70,34387,2,44,0,34433,34144,219
31-12-2021,perambalur,22,3,2,0,23,12142,3,3,0,12148,11880,245
31-12-2021,pudukottai,14,1,1,0,14,30349,1,35,0,30385,29950,421
31-12-2021,ramanathapuram,23,5,2,0,26,20547,5,135,0,20687,20302,359
31-12-2021,ranipet,39,14,2,0,51,43646,14,49,0,43709,42879,779
31-12-2021,salem,319,25,36,2,306,102038,25,438,0,102501,100466,1729
31-12-2021,sivagangai,47,4,6,0,45,20405,4,108,0,20517,20259,213
31-12-2021,tenkasi,10,1,1,0,10,27361,1,58,0,27420,26924,486
31-12-2021,thanjavur,115,8,13,0,110,76425,8,22,0,76455,75338,1007
31-12-2021,theni,6,1,2,0,5,43579,1,45,0,43625,43097,523
31-12-2021,thirupathur,28,2,2,0,28,29356,2,118,0,29476,28821,627
31-12-2021,thiruvallur,224,43,17,2,248,120847,43,10,0,120900,118790,1862
31-12-2021,thiruvannamalai,46,2,7,0,41,54958,2,399,0,55359,54645,673
31-12-2021,thiruvarur,48,3,1,0,50,41990,3,38,0,42031,41519,462
31-12-2021,thoothukudi,67,30,2,0,95,56340,30,275,0,56645,56138,412
31-12-2021,tirunelveli,55,9,4,0,60,49358,9,427,0,49794,49298,436
31-12-2021,tiruppur,417,43,35,1,424,98577,43,11,0,98631,97181,1026
31-12-2021,trichy,129,8,12,2,123,78817,8,65,0,78890,77665,1102
31-12-2021,vellore,127,14,8,0,133,48786,13,1714,1,50514,49240,1141
31-12-2021,villupuram,41,3,4,0,40,45945,3,174,0,46122,45724,358
31-12-2021,virudhunagar,50,14,3,0,61,46365,14,104,0,46483,45873,549
31-12-2021,airport surveillance (international),53,10,5,0,58,0,0,1110,10,1120,1061,1
31-12-2021,airport surveillance (domestic),3,0,0,0,3,0,0,1088,0,1088,1084,1
31-12-2021,railway surveillance,0,0,0,0,0,0,0,428,0,428,428,0
01-01-2022,ariyalur,7,1,2,0,6,16930,1,20,0,16951,16680,265
01-01-2022,chengalpattu,656,168,57,0,767,175531,168,5,0,175704,172390,2547
01-01-2022,chennai,2387,682,148,1,2920,562927,682,47,0,563656,552083,8653
01-01-2022,coimbatore,906,75,91,1,889,253320,75,51,0,253446,250041,2516
01-01-2022,cuddalore,86,5,3,0,88,64396,5,203,0,64604,63640,876
01-01-2022,dharmapuri,57,6,7,0,56,28785,6,216,0,29007,28670,281
01-01-2022,dindigul,37,4,5,0,36,33270,4,77,0,33351,32663,652
01-01-2022,erode,420,35,34,0,421,107659,35,94,0,107788,106656,711
01-01-2022,kallakurichi,24,5,3,0,26,31214,5,404,0,31623,31387,210
01-01-2022,kancheepuram,213,35,14,0,234,76170,35,4,0,76209,74707,1268
01-01-2022,kanyakumari,133,31,16,0,148,63020,31,124,0,63175,61965,1062
01-01-2022,karur,101,5,11,0,95,24936,5,47,0,24988,24529,364
01-01-2022,krishnagiri,62,11,7,1,65,43872,11,238,0,44121,43697,359
01-01-2022,madurai,64,11,4,0,71,75519,11,173,0,75703,74445,1187
01-01-2022,mayiladuthurai,7,0,2,0,5,23393,0,39,0,23432,23108,319
01-01-2022,nagapattinam,16,5,0,0,21,21373,5,53,0,21431,21049,361
01-01-2022,namakkal,258,17,37,0,238,54450,17,112,0,54579,53824,517
01-01-2022,nilgiris,70,4,13,0,61,34389,4,44,0,34437,34157,219
01-01-2022,perambalur,23,3,1,0,25,12145,3,3,0,12151,11881,245
01-01-2022,pudukottai,14,3,1,0,16,30350,3,35,0,30388,29951,421
01-01-2022,ramanathapuram,28,2,2,0,28,20554,2,135,0,20691,20304,359
01-01-2022,ranipet,55,15,6,0,64,43664,15,49,0,43728,42885,779
01-01-2022,salem,307,30,27,0,310,102064,30,438,0,102532,100493,1729
01-01-2022,sivagangai,45,10,5,0,50,20409,10,108,0,20527,20264,213
01-01-2022,tenkasi,10,2,1,0,11,27362,2,58,0,27422,26925,486
01-01-2022,thanjavur,112,13,15,0,110,76435,13,22,0,76470,75353,1007
01-01-2022,theni,5,4,0,0,9,43580,4,45,0,43629,43097,523
01-01-2022,thirupathur,29,6,3,0,32,29359,6,118,0,29483,28824,627
01-01-2022,thiruvallur,255,70,18,1,306,120897,70,10,0,120977,118808,1863
01-01-2022,thiruvannamalai,43,8,8,0,43,54962,8,399,0,55369,54653,673
01-01-2022,thiruvarur,50,4,2,1,51,41993,4,38,0,42035,41521,463
01-01-2022,thoothukudi,96,36,4,0,128,56371,36,275,0,56682,56142,412
01-01-2022,tirunelveli,60,28,3,0,85,49367,28,427,0,49822,49301,436
01-01-2022,tiruppur,424,44,38,1,429,98620,44,11,0,98675,97219,1027
01-01-2022,trichy,124,21,10,0,135,78826,21,65,0,78912,77675,1102
01-01-2022,vellore,123,39,4,2,156,48789,28,1715,11,50543,49244,1143
01-01-2022,villupuram,41,20,6,0,55,45949,20,174,0,46143,45730,358
01-01-2022,virudhunagar,61,23,1,0,83,46379,23,104,0,46506,45874,549
01-01-2022,airport surveillance (international),58,5,2,0,61,0,0,1120,5,1125,1063,1
01-01-2022,airport surveillance (domestic),3,3,0,0,6,0,0,1088,3,1091,1084,1
01-01-2022,railway surveillance,0,0,0,0,0,0,0,428,0,428,428,0
02-01-2022,ariyalur,7,2,3,0,6,16932,2,20,0,16954,16683,265
02-01-2022,chengalpattu,767,146,54,1,858,175699,146,5,0,175850,172444,2548
02-01-2022,chennai,2926,776,151,1,3550,563615,776,47,0,564438,552234,8654
02-01-2022,coimbatore,891,80,90,1,880,253397,80,51,0,253528,250131,2517
02-01-2022,cuddalore,87,9,4,0,92,64400,9,203,0,64612,63644,876
02-01-2022,dharmapuri,56,10,8,0,58,28791,10,216,0,29017,28678,281
02-01-2022,dindigul,35,2,7,0,30,33273,2,77,0,33352,32670,652
02-01-2022,erode,421,33,33,0,421,107694,33,94,0,107821,106689,711
02-01-2022,kallakurichi,26,6,2,0,30,31219,6,404,0,31629,31389,210
02-01-2022,kancheepuram,238,47,16,0,269,76209,47,4,0,76260,74723,1268
02-01-2022,kanyakumari,149,30,14,0,165,63052,29,124,1,63206,61979,1062
02-01-2022,karur,94,9,10,0,93,24940,9,47,0,24996,24539,364
02-01-2022,krishnagiri,66,12,8,0,70,43884,12,238,0,44134,43705,359
02-01-2022,madurai,71,13,6,0,78,75530,13,173,0,75716,74451,1187
02-01-2022,mayiladuthurai,6,1,1,0,6,23394,1,39,0,23434,23109,319
02-01-2022,nagapattinam,20,4,0,0,24,21377,4,53,0,21434,21049,361
02-01-2022,namakkal,238,20,38,0,220,54467,20,112,0,54599,53862,517
02-01-2022,nilgiris,61,6,12,0,55,34393,6,44,0,34443,34169,219
02-01-2022,perambalur,26,2,2,0,26,12149,2,3,0,12154,11883,245
02-01-2022,pudukottai,15,2,1,0,16,30352,2,35,0,30389,29952,421
02-01-2022,ramanathapuram,29,10,1,0,38,20557,10,135,0,20702,20305,359
02-01-2022,ranipet,62,12,4,0,70,43677,12,49,0,43738,42889,779
02-01-2022,salem,310,29,26,2,311,102094,29,438,0,102561,100519,1731
02-01-2022,sivagangai,47,6,7,0,46,20416,6,108,0,20530,20271,213
02-01-2022,tenkasi,12,3,2,0,13,27365,3,58,0,27426,26927,486
02-01-2022,thanjavur,104,16,13,0,107,76442,16,22,0,76480,75366,1007
02-01-2022,theni,9,0,1,0,8,43584,0,45,0,43629,43098,523
02-01-2022,thirupathur,31,5,2,0,34,29364,5,118,0,29487,28826,627
02-01-2022,thiruvallur,292,58,19,0,331,120953,58,10,0,121021,118827,1863
02-01-2022,thiruvannamalai,45,14,9,0,50,54972,14,399,0,55385,54662,673
02-01-2022,thiruvarur,54,7,4,0,57,42000,7,38,0,42045,41525,463
02-01-2022,thoothukudi,131,45,6,0,170,56410,45,275,0,56730,56148,412
02-01-2022,tirunelveli,83,12,4,0,91,49393,12,427,0,49832,49305,436
02-01-2022,tiruppur,430,68,40,0,458,98665,68,11,0,98744,97259,1027
02-01-2022,trichy,136,19,11,0,144,78848,19,65,0,78932,77686,1102
02-01-2022,vellore,157,41,5,1,192,48818,33,1726,8,50585,49249,1144
02-01-2022,villupuram,55,11,7,0,59,45969,11,174,0,46154,45737,358
02-01-2022,virudhunagar,86,18,3,0,101,46405,18,104,0,46527,45877,549
02-01-2022,airport surveillance (international),61,10,0,0,71,0,0,1125,10,1135,1063,1
02-01-2022,airport surveillance (domestic),6,0,0,0,6,0,0,1091,0,1091,1084,1
02-01-2022,railway surveillance,0,0,0,0,0,0,0,428,0,428,428,0
03-01-2022,ariyalur,5,1,1,0,5,16933,1,20,0,16954,16684,265
03-01-2022,chengalpattu,865,158,59,0,964,175852,158,5,0,176015,172503,2548
03-01-2022,chennai,3542,876,157,2,4259,564383,876,47,0,565306,552391,8656
03-01-2022,coimbatore,881,105,86,1,899,253478,105,51,0,253634,250217,2518
03-01-2022,cuddalore,93,5,7,0,91,64410,5,203,0,64618,63651,876
03-01-2022,dharmapuri,59,7,11,0,55,28802,7,216,0,29025,28689,281
03-01-2022,dindigul,31,6,3,0,34,33276,6,77,0,33359,32673,652
03-01-2022,erode,425,40,46,0,419,107731,40,94,0,107865,106735,711
03-01-2022,kallakurichi,30,9,2,0,37,31225,9,404,0,31638,31391,210
03-01-2022,kancheepuram,268,38,19,1,286,76255,38,4,0,76297,74742,1269
03-01-2022,kanyakumari,165,47,17,0,195,63081,47,125,0,63253,61996,1062
03-01-2022,karur,93,10,13,0,90,24949,10,47,0,25006,24552,364
03-01-2022,krishnagiri,70,9,10,2,67,43896,9,238,0,44143,43715,361
03-01-2022,madurai,76,19,5,0,90,75541,19,173,0,75733,74456,1187
03-01-2022,mayiladuthurai,6,2,1,0,7,23395,2,39,0,23436,23110,319
03-01-2022,nagapattinam,25,2,2,0,25,21382,2,53,0,21437,21051,361
03-01-2022,namakkal,220,18,35,0,203,54488,18,112,0,54618,53897,518
03-01-2022,nilgiris,55,11,14,0,52,34399,11,44,0,34454,34183,219
03-01-2022,perambalur,28,4,1,0,31,12153,4,3,0,12160,11884,245
03-01-2022,pudukottai,16,0,2,0,14,30354,0,35,0,30389,29954,421
03-01-2022,ramanathapuram,38,5,4,0,39,20567,5,135,0,20707,20309,359
03-01-2022,ranipet,72,8,2,0,78,43691,8,49,0,43748,42891,779
03-01-2022,salem,312,31,32,0,311,102123,31,438,0,102592,100551,1730
03-01-2022,sivagangai,45,9,3,0,51,20421,9,108,0,20538,20274,213
03-01-2022,tenkasi,13,4,0,0,17,27368,4,58,0,27430,26927,486
03-01-2022,thanjavur,104,17,9,0,112,76455,17,22,0,76494,75375,1007
03-01-2022,theni,8,3,0,0,11,43584,3,45,0,43632,43098,523
03-01-2022,thirupathur,33,2,2,0,33,29368,2,118,0,29488,28828,627
03-01-2022,thiruvallur,332,80,18,0,394,121012,80,10,0,121102,118845,1863
03-01-2022,thiruvannamalai,50,6,6,0,50,54986,6,399,0,55391,54668,673
03-01-2022,thiruvarur,58,8,8,0,58,42008,8,38,0,42054,41533,463
03-01-2022,thoothukudi,170,36,7,0,199,56455,36,275,0,56766,56155,412
03-01-2022,tirunelveli,91,17,5,0,103,49405,17,427,0,49849,49310,436
03-01-2022,tiruppur,458,52,45,0,465,98733,52,11,0,98796,97304,1027
03-01-2022,trichy,139,27,7,0,159,78862,27,65,0,78954,77693,1102
03-01-2022,vellore,191,22,11,0,202,48850,22,1734,0,50606,49260,1144
03-01-2022,villupuram,59,9,4,0,64,45980,9,174,0,46163,45741,358
03-01-2022,virudhunagar,101,24,2,0,123,46423,24,104,0,46551,45879,549
03-01-2022,airport surveillance (international),71,1,6,0,66,0,0,1135,1,1136,1069,1
03-01-2022,airport surveillance (domestic),6,0,0,0,6,0,0,1091,0,1091,1084,1
03-01-2022,railway surveillance,0,0,0,0,0,0,0,428,0,428,428,0
04-01-2022,ariyalur,5,1,0,0,6,16934,1,20,0,16955,16684,265
04-01-2022,chengalpattu,948,290,63,0,1175,175994,290,5,0,176289,172566,2548
04-01-2022,chennai,4265,1489,161,0,5593,565265,1488,47,1,566801,552552,8656
04-01-2022,coimbatore,900,120,94,0,926,253584,120,51,0,253755,250311,2518
04-01-2022,cuddalore,88,8,8,0,88,64412,8,203,0,64623,63659,876
04-01-2022,dharmapuri,55,7,6,0,56,28809,7,216,0,29032,28695,281
04-01-2022,dindigul,33,1,1,0,33,33281,1,77,0,33359,32674,652
04-01-2022,erode,408,41,56,0,393,107760,41,94,0,107895,106791,711
04-01-2022,kallakurichi,37,19,2,0,54,31234,19,404,0,31657,31393,210
04-01-2022,kancheepuram,288,54,13,0,329,76295,54,4,0,76353,74755,1269
04-01-2022,kanyakumari,195,43,11,1,226,63128,43,125,0,63296,62007,1063
04-01-2022,karur,90,8,12,1,85,24959,8,47,0,25014,24564,365
04-01-2022,krishnagiri,67,10,5,0,72,43905,10,238,0,44153,43720,361
04-01-2022,madurai,90,31,3,0,118,75560,31,173,0,75764,74459,1187
04-01-2022,mayiladuthurai,7,0,2,1,4,23397,0,39,0,23436,23112,320
04-01-2022,nagapattinam,25,8,4,0,29,21384,8,53,0,21445,21055,361
04-01-2022,namakkal,207,11,28,0,190,54510,11,112,0,54633,53925,518
04-01-2022,nilgiris,52,12,10,1,53,34410,12,44,0,34466,34193,220
04-01-2022,perambalur,32,7,2,0,37,12158,7,3,0,12168,11886,245
04-01-2022,pudukottai,15,1,4,0,12,30355,1,35,0,30391,29958,421
04-01-2022,ramanathapuram,39,9,3,0,45,20572,9,135,0,20716,20312,359
04-01-2022,ranipet,79,19,0,0,98,43700,19,49,0,43768,42891,779
04-01-2022,salem,312,49,36,0,325,102155,49,438,0,102642,100587,1730
04-01-2022,sivagangai,49,10,2,0,57,20428,10,108,0,20546,20276,213
04-01-2022,tenkasi,18,4,1,0,21,27373,4,58,0,27435,26928,486
04-01-2022,thanjavur,110,16,7,0,119,76470,16,22,0,76508,75382,1007
04-01-2022,theni,11,4,0,0,15,43587,4,45,0,43636,43098,523
04-01-2022,thirupathur,33,9,1,0,41,29370,9,118,0,29497,28829,627
04-01-2022,thiruvallur,394,147,22,2,517,121092,147,10,0,121249,118867,1865
04-01-2022,thiruvannamalai,50,11,3,0,58,54992,11,399,0,55402,54671,673
04-01-2022,thiruvarur,59,6,6,0,59,42017,6,38,0,42061,41539,463
04-01-2022,thoothukudi,199,42,11,0,230,56491,42,275,0,56808,56166,412
04-01-2022,tirunelveli,107,22,9,0,120,49426,22,427,0,49875,49319,436
04-01-2022,tiruppur,472,54,53,0,473,98792,54,11,0,98857,97357,1027
04-01-2022,trichy,161,35,14,2,180,78891,29,65,6,78991,77707,1104
04-01-2022,vellore,202,105,10,1,296,48872,70,1734,35,50711,49270,1145
04-01-2022,villupuram,67,7,2,0,72,45992,7,174,0,46173,45743,358
04-01-2022,virudhunagar,123,15,4,0,134,46447,15,104,0,46566,45883,549
04-01-2022,airport surveillance (international),66,2,5,0,63,0,0,1136,2,1138,1074,1
04-01-2022,airport surveillance (domestic),6,4,0,0,10,0,0,1091,4,1095,1084,1
04-01-2022,railway surveillance,0,0,0,0,0,0,0,428,0,428,428,0
05-01-2022,ariyalur,6,7,0,0,13,16935,7,20,0,16962,16684,265
05-01-2022,chengalpattu,1182,596,67,0,1711,176292,596,5,0,176893,172633,2549
05-01-2022,chennai,5566,2481,165,4,7878,566726,2481,48,0,569255,552717,8660
05-01-2022,coimbatore,930,259,97,3,1089,253708,259,51,0,254018,250408,2521
05-01-2022,cuddalore,85,17,11,0,91,64417,17,203,0,64637,63670,876
05-01-2022,dharmapuri,56,8,3,0,61,28816,8,216,0,29040,28698,281
05-01-2022,dindigul,32,9,2,0,39,33281,9,77,0,33367,32676,652
05-01-2022,erode,388,43,47,0,384,107796,43,94,0,107933,106838,711
05-01-2022,kallakurichi,54,26,3,0,77,31253,26,404,0,31683,31396,210
05-01-2022,kancheepuram,339,127,16,0,450,76358,127,4,0,76489,74771,1268
05-01-2022,kanyakumari,226,97,12,0,311,63171,97,125,0,63393,62019,1063
05-01-2022,karur,85,13,10,0,88,24967,13,47,0,25027,24574,365
05-01-2022,krishnagiri,72,23,6,1,88,43915,23,238,0,44176,43726,362
05-01-2022,madurai,119,52,7,0,164,75592,52,173,0,75817,74466,1187
05-01-2022,mayiladuthurai,7,3,2,0,8,23400,3,39,0,23442,23114,320
05-01-2022,nagapattinam,26,10,0,0,36,21389,10,53,0,21452,21055,361
05-01-2022,namakkal,193,33,21,0,205,54524,33,112,0,54669,53946,518
05-01-2022,nilgiris,53,28,8,0,73,34422,28,44,0,34494,34201,220
05-01-2022,perambalur,37,21,2,0,56,12165,21,3,0,12189,11888,245
05-01-2022,pudukottai,11,8,1,0,18,30355,8,35,0,30398,29959,421
05-01-2022,ramanathapuram,47,13,3,0,57,20583,13,135,0,20731,20315,359
05-01-2022,ranipet,98,68,2,0,164,43719,68,49,0,43836,42893,779
05-01-2022,salem,327,75,31,0,371,102206,75,438,0,102719,100618,1730
05-01-2022,sivagangai,52,17,2,0,67,20433,17,108,0,20558,20278,213
05-01-2022,tenkasi,23,9,4,0,28,27379,9,58,0,27446,26932,486
05-01-2022,thanjavur,119,26,9,0,136,76486,26,22,0,76534,75391,1007
05-01-2022,theni,15,9,1,0,23,43591,9,45,0,43645,43099,523
05-01-2022,thirupathur,41,8,2,0,47,29379,8,118,0,29505,28831,627
05-01-2022,thiruvallur,518,209,26,0,701,121240,209,10,0,121459,118893,1865
05-01-2022,thiruvannamalai,62,22,4,0,80,55007,22,399,0,55428,54675,673
05-01-2022,thiruvarur,59,11,5,0,65,42023,11,38,0,42072,41544,463
05-01-2022,thoothukudi,230,123,13,0,340,56533,123,275,0,56931,56179,412
05-01-2022,tirunelveli,124,21,10,0,135,49452,21,427,0,49900,49329,436
05-01-2022,tiruppur,472,80,56,1,495,98845,79,11,1,98936,97413,1028
05-01-2022,trichy,181,51,11,0,221,78921,51,71,0,79043,77718,1104
05-01-2022,vellore,296,184,12,0,468,48942,156,1769,28,50895,49282,1145
05-01-2022,villupuram,72,23,4,0,91,45999,23,174,0,46196,45747,358
05-01-2022,virudhunagar,136,43,6,0,173,46464,43,104,0,46611,45889,549
05-01-2022,airport surveillance (international),63,9,7,0,65,0,0,1138,9,1147,1081,1
05-01-2022,airport surveillance (domestic),10,0,0,0,10,0,0,1095,0,1095,1084,1
05-01-2022,railway surveillance,0,0,0,0,0,0,0,428,0,428,428,0
